,ID,campeonato,rodata,data,clube_mandante,clube_visitante,qtd_cartao_amarelo_mandante,qtd_cartao_amarelo_visitante,qtd_cartao_vermelho_mandante,qtd_cartao_vermelho_visitante,total_cartoes_mandante,total_cartoes_visitante,total_cartoes_vermelhos,total_cartoes_amarelos,total_cartoes_partida,faltas_mandante,faltas_visitante,total_faltas_partida
0,4987,13,1,9/5/2015,Chapecoense,Coritiba,2,2,0,0,2,2,0,4,4,20,21,41
1,4988,13,1,9/5/2015,Palmeiras,Atletico-MG,2,4,0,0,2,4,0,6,6,20,14,34
2,4989,13,1,9/5/2015,Fluminense,Joinville,2,1,0,1,2,2,1,3,4,9,14,23
3,4990,13,1,10/5/2015,Gremio,Ponte Preta,3,5,0,1,3,6,1,8,9,17,21,38
4,4991,13,1,10/5/2015,Athletico-PR,Internacional,1,2,0,0,1,2,0,3,3,17,17,34
5,4992,13,1,10/5/2015,Sao Paulo,Flamengo,2,1,0,0,2,1,0,3,3,17,12,29
6,4993,13,1,10/5/2015,Cruzeiro,Corinthians,3,1,0,0,3,1,0,4,4,17,15,32
7,4994,13,1,10/5/2015,Sport,Figueirense,1,3,0,1,1,4,1,4,5,17,14,31
8,4995,13,1,10/5/2015,Avai,Santos,2,2,0,1,2,3,1,4,5,10,11,21
9,4996,13,1,10/5/2015,Vasco,Goias,3,5,0,0,3,5,0,8,8,16,27,43
10,4997,13,2,16/5/2015,Goias,Athletico-PR,2,1,0,1,2,2,1,3,4,14,18,32
11,4998,13,2,16/5/2015,Coritiba,Gremio,2,3,0,0,2,3,0,5,5,22,13,35
12,4999,13,2,16/5/2015,Corinthians,Chapecoense,2,4,0,0,2,4,0,6,6,16,13,29
13,5000,13,2,17/5/2015,Figueirense,Vasco,2,6,0,0,2,6,0,8,8,18,13,31
14,5001,13,2,17/5/2015,Atletico-MG,Fluminense,2,1,0,0,2,1,0,3,3,17,9,26
15,5002,13,2,17/5/2015,Flamengo,Sport,2,3,0,0,2,3,0,5,5,10,7,17
16,5003,13,2,17/5/2015,Santos,Cruzeiro,1,4,0,0,1,4,0,5,5,18,13,31
17,5004,13,2,17/5/2015,Joinville,Palmeiras,3,1,0,0,3,1,0,4,4,17,12,29
18,5005,13,2,17/5/2015,Ponte Preta,Sao Paulo,1,3,0,0,1,3,0,4,4,15,14,29
19,5006,13,2,17/5/2015,Internacional,Avai,3,7,0,0,3,7,0,10,10,17,26,43
20,5007,13,3,23/5/2015,Sao Paulo,Joinville,2,0,0,0,2,0,0,2,2,12,11,23
21,5008,13,3,23/5/2015,Vasco,Internacional,6,3,0,1,6,4,1,9,10,15,16,31
22,5009,13,3,23/5/2015,Gremio,Figueirense,6,5,0,0,6,5,0,11,11,16,24,40
23,5010,13,3,24/5/2015,Palmeiras,Goias,6,5,1,1,7,6,2,11,13,13,24,37
24,5011,13,3,24/5/2015,Chapecoense,Santos,5,6,0,0,5,6,0,11,11,13,20,33
25,5012,13,3,24/5/2015,Athletico-PR,Atletico-MG,4,0,1,0,5,0,1,4,5,7,8,15
26,5013,13,3,24/5/2015,Fluminense,Corinthians,2,2,0,0,2,2,0,4,4,19,6,25
27,5014,13,3,24/5/2015,Avai,Flamengo,5,6,0,0,5,6,0,11,11,15,17,32
28,5015,13,3,24/5/2015,Cruzeiro,Ponte Preta,2,2,0,0,2,2,0,4,4,17,11,28
29,5016,13,3,24/5/2015,Sport,Coritiba,1,4,0,0,1,4,0,5,5,13,17,30
30,5017,13,4,30/5/2015,Ponte Preta,Chapecoense,4,2,0,1,4,3,1,6,7,20,15,35
31,5018,13,4,30/5/2015,Coritiba,Avai,4,4,0,0,4,4,0,8,8,17,21,38
32,5019,13,4,30/5/2015,Joinville,Athletico-PR,0,4,0,0,0,4,0,4,4,12,13,25
33,5020,13,4,31/5/2015,Santos,Sport,1,2,0,0,1,2,0,3,3,9,11,20
34,5021,13,4,31/5/2015,Goias,Gremio,1,1,0,0,1,1,0,2,2,14,14,28
35,5022,13,4,31/5/2015,Atletico-MG,Vasco,0,3,0,0,0,3,0,3,3,16,12,28
36,5023,13,4,31/5/2015,Corinthians,Palmeiras,5,5,0,0,5,5,0,10,10,21,21,42
37,5024,13,4,31/5/2015,Internacional,Sao Paulo,3,1,0,1,3,2,1,4,5,19,17,36
38,5025,13,4,31/5/2015,Flamengo,Fluminense,6,3,1,1,7,4,2,9,11,24,23,47
39,5026,13,4,31/5/2015,Figueirense,Cruzeiro,3,6,0,1,3,7,1,9,10,17,11,28
40,5027,13,5,3/6/2015,Athletico-PR,Figueirense,1,4,0,0,1,4,0,5,5,12,8,20
41,5028,13,5,3/6/2015,Vasco,Ponte Preta,2,3,2,0,4,3,2,5,7,15,18,33
42,5029,13,5,3/6/2015,Chapecoense,Joinville,3,5,0,0,3,5,0,8,8,16,12,28
43,5030,13,5,3/6/2015,Sao Paulo,Santos,5,3,0,1,5,4,1,8,9,14,15,29
44,5031,13,5,3/6/2015,Cruzeiro,Flamengo,2,3,0,0,2,3,0,5,5,16,17,33
45,5032,13,5,3/6/2015,Avai,Atletico-MG,3,3,0,0,3,3,0,6,6,12,15,27
46,5033,13,5,3/6/2015,Gremio,Corinthians,2,3,0,0,2,3,0,5,5,22,10,32
47,5034,13,5,4/6/2015,Fluminense,Coritiba,1,4,0,0,1,4,0,5,5,13,24,37
48,5035,13,5,4/6/2015,Sport,Goias,2,4,0,0,2,4,0,6,6,11,13,24
49,5036,13,5,4/6/2015,Palmeiras,Internacional,1,4,0,0,1,4,0,5,5,15,13,28
50,5038,13,6,6/6/2015,Flamengo,Chapecoense,1,0,0,1,1,1,1,1,2,13,12,25
51,5039,13,6,6/6/2015,Santos,Ponte Preta,2,2,0,0,2,2,0,4,4,17,15,32
52,5040,13,6,6/6/2015,Athletico-PR,Vasco,4,3,0,0,4,3,0,7,7,15,7,22
53,5041,13,6,6/6/2015,Joinville,Corinthians,1,1,0,0,1,1,0,2,2,8,9,17
54,5042,13,6,6/6/2015,Sao Paulo,Gremio,3,2,0,0,3,2,0,5,5,19,14,33
55,5043,13,6,7/6/2015,Internacional,Coritiba,4,5,1,0,5,5,1,9,10,5,16,21
56,5044,13,6,7/6/2015,Figueirense,Palmeiras,3,3,0,0,3,3,0,6,6,22,14,36
57,5045,13,6,7/6/2015,Goias,Avai,2,4,0,0,2,4,0,6,6,15,17,32
58,5046,13,6,7/6/2015,Fluminense,Sport,3,2,0,0,3,2,0,5,5,12,10,22
59,5047,13,7,10/6/2015,Atletico-MG,Santos,1,4,0,0,1,4,0,5,5,8,15,23
60,5048,13,7,13/6/2015,Coritiba,Flamengo,2,4,0,1,2,5,1,6,7,17,14,31
61,5049,13,7,13/6/2015,Chapecoense,Sao Paulo,2,4,0,0,2,4,0,6,6,5,29,34
62,5050,13,7,13/6/2015,Corinthians,Internacional,0,2,0,0,0,2,0,2,2,10,9,19
63,5051,13,7,13/6/2015,Sport,Joinville,0,4,0,0,0,4,0,4,4,10,13,23
64,5052,13,7,13/6/2015,Vasco,Cruzeiro,2,4,0,0,2,4,0,6,6,13,25,38
65,5053,13,7,14/6/2015,Ponte Preta,Goias,3,3,0,0,3,3,0,6,6,24,19,43
66,5054,13,7,14/6/2015,Avai,Figueirense,4,3,0,0,4,3,0,7,7,14,26,40
67,5055,13,7,14/6/2015,Palmeiras,Fluminense,0,7,0,2,0,9,2,7,9,6,13,19
68,5056,13,7,14/6/2015,Gremio,Athletico-PR,1,4,0,0,1,4,0,5,5,8,22,30
69,5057,13,8,18/6/2015,Figueirense,Internacional,4,2,0,0,4,2,0,6,6,16,18,34
70,5058,13,8,20/6/2015,Sport,Vasco,2,3,0,0,2,3,0,5,5,10,12,22
71,5059,13,8,20/6/2015,Flamengo,Atletico-MG,0,1,0,1,0,2,1,1,2,8,14,22
72,5060,13,8,20/6/2015,Santos,Corinthians,5,4,1,1,6,5,2,9,11,19,17,36
73,5061,13,8,20/6/2015,Gremio,Palmeiras,4,3,0,0,4,3,0,7,7,11,9,20
74,5062,13,8,21/6/2015,Cruzeiro,Chapecoense,4,3,0,0,4,3,0,7,7,9,16,25
75,5063,13,8,21/6/2015,Joinville,Goias,4,5,1,1,5,6,2,9,11,13,12,25
76,5064,13,8,21/6/2015,Athletico-PR,Coritiba,2,5,0,2,2,7,2,7,9,10,20,30
77,5065,13,8,21/6/2015,Sao Paulo,Avai,1,5,0,0,1,5,0,6,6,14,13,27
78,5066,13,8,24/6/2015,Fluminense,Ponte Preta,2,3,0,0,2,3,0,5,5,16,18,34
79,5067,13,9,27/6/2015,Avai,Gremio,3,3,0,0,3,3,0,6,6,14,16,30
80,5068,13,9,27/6/2015,Chapecoense,Sport,1,6,0,0,1,6,0,7,7,7,16,23
81,5069,13,9,27/6/2015,Corinthians,Figueirense,0,2,0,0,0,2,0,2,2,10,11,21
82,5070,13,9,28/6/2015,Atletico-MG,Joinville,2,1,0,0,2,1,0,3,3,11,13,24
83,5071,13,9,28/6/2015,Palmeiras,Sao Paulo,1,3,0,0,1,3,0,4,4,18,14,32
84,5072,13,9,28/6/2015,Goias,Fluminense,2,2,0,1,2,3,1,4,5,15,12,27
85,5073,13,9,28/6/2015,Ponte Preta,Athletico-PR,1,2,0,0,1,2,0,3,3,16,27,43
86,5074,13,9,28/6/2015,Coritiba,Cruzeiro,5,5,0,0,5,5,0,10,10,22,15,37
87,5075,13,9,28/6/2015,Vasco,Flamengo,4,0,0,0,4,0,0,4,4,18,10,28
88,5076,13,9,28/6/2015,Internacional,Santos,3,3,0,1,3,4,1,6,7,4,12,16
89,5077,13,10,1/7/2015,Sport,Internacional,2,2,0,1,2,3,1,4,5,13,8,21
90,5078,13,10,1/7/2015,Vasco,Avai,3,2,1,1,4,3,2,5,7,16,11,27
91,5079,13,10,1/7/2015,Palmeiras,Chapecoense,0,3,0,0,0,3,0,3,3,15,17,32
92,5080,13,10,1/7/2015,Atletico-MG,Coritiba,3,5,0,0,3,5,0,8,8,8,11,19
93,5081,13,10,1/7/2015,Joinville,Flamengo,3,2,0,0,3,2,0,5,5,14,11,25
94,5082,13,10,1/7/2015,Gremio,Cruzeiro,5,6,0,0,5,6,0,11,11,21,21,42
95,5083,13,10,1/7/2015,Athletico-PR,Sao Paulo,2,0,0,0,2,0,0,2,2,17,8,25
96,5084,13,10,2/7/2015,Corinthians,Ponte Preta,1,2,0,0,1,2,0,3,3,5,12,17
97,5085,13,10,2/7/2015,Figueirense,Goias,2,2,1,0,3,2,1,4,5,17,20,37
98,5086,13,10,2/7/2015,Fluminense,Santos,2,3,0,0,2,3,0,5,5,7,21,28
99,5087,13,11,4/7/2015,Coritiba,Joinville,1,2,0,0,1,2,0,3,3,22,17,39
100,5088,13,11,4/7/2015,Chapecoense,Vasco,1,2,0,2,1,4,2,3,5,12,12,24
101,5089,13,11,4/7/2015,Cruzeiro,Athletico-PR,0,2,0,1,0,3,1,2,3,10,18,28
102,5090,13,11,5/7/2015,Avai,Sport,6,2,1,0,7,2,1,8,9,16,14,30
103,5091,13,11,5/7/2015,Goias,Corinthians,2,2,0,0,2,2,0,4,4,12,12,24
104,5092,13,11,5/7/2015,Sao Paulo,Fluminense,1,2,0,0,1,2,0,3,3,18,16,34
105,5093,13,11,5/7/2015,Santos,Gremio,4,1,1,0,5,1,1,5,6,13,12,25
106,5094,13,11,5/7/2015,Ponte Preta,Palmeiras,3,3,0,0,3,3,0,6,6,12,22,34
107,5095,13,11,5/7/2015,Flamengo,Figueirense,3,2,0,0,3,2,0,5,5,9,20,29
108,5096,13,11,5/7/2015,Internacional,Atletico-MG,1,3,1,0,2,3,1,4,5,5,11,16
109,5097,13,12,8/7/2015,Chapecoense,Gremio,1,2,0,0,1,2,0,3,3,8,7,15
110,5098,13,12,8/7/2015,Goias,Santos,0,3,0,0,0,3,0,3,3,7,8,15
111,5099,13,12,8/7/2015,Coritiba,Ponte Preta,4,6,0,0,4,6,0,10,10,18,17,35
112,5100,13,12,8/7/2015,Figueirense,Joinville,1,2,0,0,1,2,0,3,3,11,21,32
113,5101,13,12,8/7/2015,Palmeiras,Avai,2,6,0,0,2,6,0,8,8,12,11,23
114,5102,13,12,8/7/2015,Atletico-MG,Sport,2,2,0,0,2,2,0,4,4,17,12,29
115,5103,13,12,8/7/2015,Internacional,Flamengo,3,2,0,0,3,2,0,5,5,17,19,36
116,5104,13,12,8/7/2015,Vasco,Sao Paulo,3,0,0,0,3,0,0,3,3,12,10,22
117,5105,13,12,9/7/2015,Corinthians,Athletico-PR,1,2,0,0,1,2,0,3,3,6,13,19
118,5106,13,12,9/7/2015,Fluminense,Cruzeiro,2,2,0,0,2,2,0,4,4,10,15,25
119,5107,13,13,11/7/2015,Santos,Figueirense,1,5,0,0,1,5,0,6,6,12,12,24
120,5108,13,13,11/7/2015,Gremio,Vasco,1,3,0,0,1,3,0,4,4,16,12,28
121,5109,13,13,11/7/2015,Ponte Preta,Atletico-MG,1,3,0,0,1,3,0,4,4,13,19,32
122,5110,13,13,12/7/2015,Sao Paulo,Coritiba,1,3,0,0,1,3,0,4,4,18,14,32
123,5111,13,13,12/7/2015,Joinville,Internacional,4,3,0,0,4,3,0,7,7,17,19,36
124,5112,13,13,12/7/2015,Flamengo,Corinthians,0,2,0,0,0,2,0,2,2,7,15,22
125,5113,13,13,12/7/2015,Athletico-PR,Fluminense,1,2,0,0,1,2,0,3,3,12,11,23
126,5114,13,13,12/7/2015,Cruzeiro,Goias,2,1,0,0,2,1,0,3,3,17,13,30
127,5115,13,13,12/7/2015,Sport,Palmeiras,2,1,0,0,2,1,0,3,3,10,17,27
128,5116,13,13,12/7/2015,Avai,Chapecoense,4,2,0,0,4,2,0,6,6,15,14,29
129,5117,13,14,18/7/2015,Internacional,Goias,1,1,0,0,1,1,0,2,2,18,12,30
130,5118,13,14,18/7/2015,Flamengo,Gremio,1,5,0,0,1,5,0,6,6,12,11,23
131,5119,13,14,18/7/2015,Corinthians,Atletico-MG,1,1,0,0,1,1,0,2,2,12,15,27
132,5120,13,14,19/7/2015,Athletico-PR,Chapecoense,2,3,0,0,2,3,0,5,5,14,13,27
133,5121,13,14,19/7/2015,Figueirense,Coritiba,1,2,0,0,1,2,0,3,3,20,18,38
134,5122,13,14,19/7/2015,Sport,Sao Paulo,1,2,0,2,1,4,2,3,5,9,12,21
135,5123,13,14,19/7/2015,Fluminense,Vasco,2,6,0,0,2,6,0,8,8,15,17,32
136,5124,13,14,19/7/2015,Palmeiras,Santos,3,3,0,0,3,3,0,6,6,24,10,34
137,5125,13,14,19/7/2015,Cruzeiro,Avai,1,3,0,0,1,3,0,4,4,7,16,23
138,5126,13,14,19/7/2015,Joinville,Ponte Preta,2,5,0,0,2,5,0,7,7,11,14,25
139,5127,13,15,25/7/2015,Avai,Athletico-PR,3,3,0,0,3,3,0,6,6,5,17,22
140,5129,13,15,25/7/2015,Atletico-MG,Figueirense,2,4,0,0,2,4,0,6,6,16,19,35
141,5130,13,15,26/7/2015,Chapecoense,Fluminense,2,3,0,1,2,4,1,5,6,15,16,31
142,5131,13,15,26/7/2015,Santos,Joinville,2,2,0,0,2,2,0,4,4,4,12,16
143,5132,13,15,26/7/2015,Ponte Preta,Internacional,2,2,0,0,2,2,0,4,4,10,19,29
144,5133,13,15,26/7/2015,Coritiba,Corinthians,3,3,0,0,3,3,0,6,6,7,18,25
145,5134,13,15,26/7/2015,Sao Paulo,Cruzeiro,0,1,0,0,0,1,0,1,1,16,14,30
146,5135,13,15,26/7/2015,Goias,Flamengo,2,1,0,0,2,1,0,3,3,11,6,17
147,5136,13,15,26/7/2015,Vasco,Palmeiras,3,1,0,0,3,1,0,4,4,14,21,35
148,5137,13,16,29/7/2015,Corinthians,Vasco,0,3,0,0,0,3,0,3,3,7,15,22
149,5138,13,16,29/7/2015,Atletico-MG,Sao Paulo,0,1,0,0,0,1,0,1,1,6,6,12
150,5139,13,16,1/8/2015,Fluminense,Gremio,3,2,0,1,3,3,1,5,6,16,13,29
151,5140,13,16,2/8/2015,Coritiba,Goias,4,4,0,0,4,4,0,8,8,11,19,30
152,5141,13,16,2/8/2015,Palmeiras,Athletico-PR,1,2,0,0,1,2,0,3,3,13,18,31
153,5142,13,16,2/8/2015,Joinville,Avai,2,1,0,0,2,1,0,3,3,22,9,31
154,5143,13,16,2/8/2015,Internacional,Chapecoense,3,2,0,0,3,2,0,5,5,4,13,17
155,5144,13,16,2/8/2015,Figueirense,Ponte Preta,2,3,0,0,2,3,0,5,5,19,18,37
156,5145,13,16,2/8/2015,Flamengo,Santos,4,2,0,0,4,2,0,6,6,17,14,31
157,5146,13,16,2/8/2015,Sport,Cruzeiro,1,2,0,0,1,2,0,3,3,15,17,32
158,5147,13,17,8/8/2015,Avai,Fluminense,2,2,0,0,2,2,0,4,4,14,12,26
159,5148,13,17,8/8/2015,Santos,Coritiba,1,4,0,0,1,4,0,5,5,12,15,27
160,5150,13,17,9/8/2015,Vasco,Joinville,2,4,0,0,2,4,0,6,6,17,21,38
161,5151,13,17,9/8/2015,Sao Paulo,Corinthians,4,2,0,1,4,3,1,6,7,13,16,29
162,5152,13,17,9/8/2015,Cruzeiro,Palmeiras,4,3,0,0,4,3,0,7,7,21,18,39
163,5153,13,17,9/8/2015,Ponte Preta,Flamengo,2,4,0,0,2,4,0,6,6,17,16,33
164,5154,13,17,9/8/2015,Goias,Atletico-MG,2,2,0,0,2,2,0,4,4,8,11,19
165,5155,13,17,9/8/2015,Gremio,Internacional,2,4,0,0,2,4,0,6,6,16,12,28
166,5156,13,17,9/8/2015,Chapecoense,Figueirense,1,1,0,0,1,1,0,2,2,20,13,33
167,5157,13,18,12/8/2015,Coritiba,Palmeiras,3,1,0,0,3,1,0,4,4,14,11,25
168,5158,13,18,12/8/2015,Flamengo,Athletico-PR,2,4,0,1,2,5,1,6,7,10,16,26
169,5159,13,18,12/8/2015,Santos,Vasco,3,5,0,1,3,6,1,8,9,12,22,34
170,5160,13,18,12/8/2015,Goias,Chapecoense,1,3,0,0,1,3,0,4,4,6,16,22
171,5161,13,18,12/8/2015,Figueirense,Sao Paulo,3,4,0,1,3,5,1,7,8,18,18,36
172,5162,13,18,12/8/2015,Internacional,Fluminense,6,4,0,2,6,6,2,10,12,20,14,34
173,5163,13,18,12/8/2015,Corinthians,Sport,2,1,0,0,2,1,0,3,3,11,8,19
174,5164,13,18,13/8/2015,Ponte Preta,Avai,1,1,0,0,1,1,0,2,2,13,6,19
175,5165,13,18,13/8/2015,Joinville,Cruzeiro,1,2,0,0,1,2,0,3,3,10,10,20
176,5166,13,18,13/8/2015,Atletico-MG,Gremio,2,3,0,0,2,3,0,5,5,10,12,22
177,5167,13,19,15/8/2015,Vasco,Coritiba,3,1,0,0,3,1,0,4,4,12,19,31
178,5168,13,19,15/8/2015,Athletico-PR,Santos,2,1,1,0,3,1,1,3,4,10,13,23
179,5169,13,19,15/8/2015,Sao Paulo,Goias,1,0,0,0,1,0,0,1,1,4,4,8
180,5170,13,19,16/8/2015,Palmeiras,Flamengo,2,2,0,0,2,2,0,4,4,18,15,33
181,5171,13,19,16/8/2015,Avai,Corinthians,0,1,0,0,0,1,0,1,1,15,8,23
182,5172,13,19,16/8/2015,Fluminense,Figueirense,1,2,0,1,1,3,1,3,4,14,18,32
183,5173,13,19,16/8/2015,Cruzeiro,Internacional,2,2,0,0,2,2,0,4,4,14,22,36
184,5175,13,19,16/8/2015,Gremio,Joinville,1,0,0,0,1,0,0,1,1,10,18,28
185,5176,13,19,16/8/2015,Chapecoense,Atletico-MG,4,3,0,1,4,4,1,7,8,12,8,20
186,5177,13,20,22/8/2015,Goias,Vasco,3,3,0,2,3,5,2,6,8,16,13,29
187,5178,13,20,22/8/2015,Santos,Avai,1,3,0,0,1,3,0,4,4,14,12,26
188,5179,13,20,22/8/2015,Figueirense,Sport,1,3,0,0,1,3,0,4,4,19,13,32
189,5180,13,20,23/8/2015,Coritiba,Chapecoense,3,3,0,0,3,3,0,6,6,19,17,36
190,5181,13,20,23/8/2015,Ponte Preta,Gremio,1,1,0,0,1,1,0,2,2,12,13,25
191,5182,13,20,23/8/2015,Joinville,Fluminense,3,2,0,0,3,2,0,5,5,26,15,41
192,5183,13,20,23/8/2015,Internacional,Athletico-PR,1,3,0,0,1,3,0,4,4,10,12,22
193,5184,13,20,23/8/2015,Corinthians,Cruzeiro,2,1,0,0,2,1,0,3,3,12,7,19
194,5185,13,20,23/8/2015,Flamengo,Sao Paulo,4,2,0,0,4,2,0,6,6,25,15,40
195,5186,13,20,23/8/2015,Atletico-MG,Palmeiras,1,3,0,0,1,3,0,4,4,13,12,25
196,5187,13,21,29/8/2015,Vasco,Figueirense,2,4,0,0,2,4,0,6,6,11,19,30
197,5188,13,21,29/8/2015,Sao Paulo,Ponte Preta,4,0,0,0,4,0,0,4,4,16,11,27
198,5189,13,21,30/8/2015,Gremio,Coritiba,5,5,0,0,5,5,0,10,10,13,15,28
199,5190,13,21,30/8/2015,Avai,Internacional,2,2,0,0,2,2,0,4,4,14,12,26
200,5191,13,21,30/8/2015,Palmeiras,Joinville,0,3,0,0,0,3,0,3,3,9,18,27
201,5192,13,21,30/8/2015,Fluminense,Atletico-MG,3,4,0,0,3,4,0,7,7,23,16,39
202,5193,13,21,30/8/2015,Sport,Flamengo,1,5,1,0,2,5,1,6,7,6,19,25
203,5194,13,21,30/8/2015,Chapecoense,Corinthians,2,3,0,0,2,3,0,5,5,14,11,25
204,5195,13,21,30/8/2015,Cruzeiro,Santos,3,2,1,0,4,2,1,5,6,17,12,29
205,5196,13,21,30/8/2015,Athletico-PR,Goias,1,3,0,0,1,3,0,4,4,12,13,25
206,5197,13,22,2/9/2015,Joinville,Sao Paulo,4,5,0,0,4,5,0,9,9,23,14,37
207,5198,13,22,2/9/2015,Ponte Preta,Cruzeiro,2,5,1,0,3,5,1,7,8,19,22,41
208,5199,13,22,2/9/2015,Internacional,Vasco,3,1,0,0,3,1,0,4,4,22,10,32
209,5200,13,22,2/9/2015,Flamengo,Avai,1,4,0,0,1,4,0,5,5,14,18,32
210,5201,13,22,2/9/2015,Atletico-MG,Athletico-PR,5,4,1,0,6,4,1,9,10,18,16,34
211,5202,13,22,2/9/2015,Coritiba,Sport,2,2,0,0,2,2,0,4,4,16,14,30
212,5203,13,22,2/9/2015,Corinthians,Fluminense,0,3,0,0,0,3,0,3,3,12,11,23
213,5204,13,22,2/9/2015,Goias,Palmeiras,3,3,0,0,3,3,0,6,6,11,14,25
214,5205,13,22,3/9/2015,Santos,Chapecoense,0,1,0,0,0,1,0,1,1,16,12,28
215,5206,13,22,3/9/2015,Figueirense,Gremio,4,4,0,0,4,4,0,8,8,14,9,23
216,5208,13,23,5/9/2015,Vasco,Atletico-MG,3,2,1,0,4,2,1,5,6,19,16,35
217,5209,13,23,5/9/2015,Athletico-PR,Joinville,4,3,1,3,5,6,4,7,11,15,17,32
218,5210,13,23,6/9/2015,Cruzeiro,Figueirense,0,4,0,0,0,4,0,4,4,15,15,30
219,5211,13,23,6/9/2015,Chapecoense,Ponte Preta,1,2,0,0,1,2,0,3,3,9,17,26
220,5212,13,23,6/9/2015,Gremio,Goias,3,4,0,1,3,5,1,7,8,15,12,27
221,5213,13,23,6/9/2015,Palmeiras,Corinthians,6,3,0,0,6,3,0,9,9,20,14,34
222,5214,13,23,6/9/2015,Avai,Coritiba,2,4,0,0,2,4,0,6,6,19,22,41
223,5215,13,23,6/9/2015,Fluminense,Flamengo,6,6,0,1,6,7,1,12,13,13,24,37
224,5216,13,23,6/9/2015,Sport,Santos,1,0,0,0,1,0,0,1,1,9,9,18
225,5217,13,24,9/9/2015,Ponte Preta,Vasco,3,1,1,0,4,1,1,4,5,20,23,43
226,5218,13,24,9/9/2015,Atletico-MG,Avai,3,3,0,0,3,3,0,6,6,17,16,33
227,5219,13,24,9/9/2015,Internacional,Palmeiras,5,3,1,1,6,4,2,8,10,21,23,44
228,5220,13,24,9/9/2015,Figueirense,Athletico-PR,2,2,0,0,2,2,0,4,4,7,9,16
229,5221,13,24,9/9/2015,Coritiba,Fluminense,1,4,0,0,1,4,0,5,5,11,24,35
230,5222,13,24,9/9/2015,Santos,Sao Paulo,1,1,0,0,1,1,0,2,2,11,9,20
231,5223,13,24,9/9/2015,Corinthians,Gremio,0,3,0,0,0,3,0,3,3,7,6,13
232,5224,13,24,10/9/2015,Goias,Sport,3,1,0,0,3,1,0,4,4,8,6,14
233,5225,13,24,10/9/2015,Joinville,Chapecoense,4,2,0,0,4,2,0,6,6,13,10,23
234,5226,13,24,10/9/2015,Flamengo,Cruzeiro,3,3,0,0,3,3,0,6,6,18,10,28
235,5227,13,25,12/9/2015,Coritiba,Internacional,4,7,0,0,4,7,0,11,11,13,26,39
236,5228,13,25,12/9/2015,Palmeiras,Figueirense,4,4,0,1,4,5,1,8,9,19,18,37
237,5229,13,25,13/9/2015,Ponte Preta,Santos,5,2,0,0,5,2,0,7,7,22,15,37
238,5230,13,25,13/9/2015,Corinthians,Joinville,0,1,0,0,0,1,0,1,1,10,17,27
239,5231,13,25,13/9/2015,Cruzeiro,Atletico-MG,3,5,1,0,4,5,1,8,9,17,16,33
240,5232,13,25,13/9/2015,Gremio,Sao Paulo,3,3,0,0,3,3,0,6,6,11,13,24
241,5233,13,25,13/9/2015,Chapecoense,Flamengo,2,1,0,0,2,1,0,3,3,13,12,25
242,5234,13,25,13/9/2015,Vasco,Athletico-PR,2,2,0,0,2,2,0,4,4,18,20,38
243,5235,13,25,13/9/2015,Avai,Goias,2,2,0,0,2,2,0,4,4,18,19,37
244,5236,13,25,13/9/2015,Sport,Fluminense,2,3,0,0,2,3,0,5,5,19,17,36
245,5237,13,26,16/9/2015,Joinville,Sport,4,3,0,0,4,3,0,7,7,19,11,30
246,5238,13,26,16/9/2015,Fluminense,Palmeiras,1,3,0,0,1,3,0,4,4,14,19,33
247,5239,13,26,16/9/2015,Goias,Ponte Preta,2,5,0,0,2,5,0,7,7,12,11,23
248,5240,13,26,16/9/2015,Figueirense,Avai,2,4,0,0,2,4,0,6,6,16,23,39
249,5241,13,26,16/9/2015,Athletico-PR,Gremio,1,2,0,0,1,2,0,3,3,13,5,18
250,5242,13,26,16/9/2015,Santos,Atletico-MG,1,1,0,0,1,1,0,2,2,7,11,18
251,5243,13,26,16/9/2015,Internacional,Corinthians,2,1,0,0,2,1,0,3,3,15,12,27
252,5244,13,26,16/9/2015,Cruzeiro,Vasco,4,3,0,1,4,4,1,7,8,15,4,19
253,5245,13,26,17/9/2015,Sao Paulo,Chapecoense,2,2,0,0,2,2,0,4,4,12,14,26
254,5246,13,26,17/9/2015,Flamengo,Coritiba,2,3,0,0,2,3,0,5,5,12,21,33
255,5247,13,27,19/9/2015,Palmeiras,Gremio,2,4,0,0,2,4,0,6,6,22,17,39
256,5248,13,27,19/9/2015,Internacional,Figueirense,1,5,0,0,1,5,0,6,6,22,22,44
257,5249,13,27,19/9/2015,Ponte Preta,Fluminense,3,4,0,0,3,4,0,7,7,14,14,28
258,5250,13,27,20/9/2015,Goias,Joinville,0,1,0,0,0,1,0,1,1,6,12,18
259,5251,13,27,20/9/2015,Corinthians,Santos,2,5,0,2,2,7,2,7,9,8,10,18
260,5252,13,27,20/9/2015,Vasco,Sport,2,2,0,0,2,2,0,4,4,13,10,23
261,5253,13,27,20/9/2015,Atletico-MG,Flamengo,2,2,0,0,2,2,0,4,4,16,16,32
262,5254,13,27,20/9/2015,Avai,Sao Paulo,3,4,0,0,3,4,0,7,7,17,19,36
263,5255,13,27,20/9/2015,Chapecoense,Cruzeiro,2,1,0,1,2,2,1,3,4,15,12,27
264,5256,13,27,20/9/2015,Coritiba,Athletico-PR,7,3,1,0,8,3,1,10,11,19,23,42
265,5257,13,28,26/9/2015,Fluminense,Goias,4,3,0,0,4,3,0,7,7,27,15,42
266,5258,13,28,26/9/2015,Gremio,Avai,1,3,0,0,1,3,0,4,4,13,12,25
267,5259,13,28,27/9/2015,Athletico-PR,Ponte Preta,2,4,0,0,2,4,0,6,6,16,18,34
268,5260,13,28,27/9/2015,Santos,Internacional,1,4,0,0,1,4,0,5,5,8,17,25
269,5261,13,28,27/9/2015,Flamengo,Vasco,5,6,0,0,5,6,0,11,11,26,21,47
270,5262,13,28,27/9/2015,Joinville,Atletico-MG,2,2,0,0,2,2,0,4,4,19,8,27
271,5263,13,28,27/9/2015,Figueirense,Corinthians,3,3,0,0,3,3,0,6,6,21,14,35
272,5264,13,28,27/9/2015,Sao Paulo,Palmeiras,1,2,0,0,1,2,0,3,3,13,17,30
273,5265,13,28,27/9/2015,Sport,Chapecoense,3,0,0,0,3,0,0,3,3,17,8,25
274,5266,13,28,27/9/2015,Cruzeiro,Coritiba,0,1,1,1,1,2,2,1,3,13,13,26
275,5267,13,29,3/10/2015,Internacional,Sport,2,2,0,1,2,3,1,4,5,16,11,27
276,5268,13,29,3/10/2015,Coritiba,Atletico-MG,1,2,0,0,1,2,0,3,3,6,11,17
277,5269,13,29,3/10/2015,Sao Paulo,Athletico-PR,1,3,0,0,1,3,0,4,4,12,16,28
278,5270,13,29,4/10/2015,Avai,Vasco,4,6,1,2,5,8,3,10,13,18,18,36
279,5271,13,29,4/10/2015,Flamengo,Joinville,2,3,0,0,2,3,0,5,5,17,27,44
280,5272,13,29,4/10/2015,Santos,Fluminense,3,2,0,0,3,2,0,5,5,24,12,36
281,5273,13,29,4/10/2015,Cruzeiro,Gremio,3,3,0,0,3,3,0,6,6,9,15,24
282,5274,13,29,4/10/2015,Goias,Figueirense,1,5,0,1,1,6,1,6,7,15,11,26
283,5275,13,29,4/10/2015,Ponte Preta,Corinthians,2,4,1,0,3,4,1,6,7,17,15,32
284,5276,13,29,4/10/2015,Chapecoense,Palmeiras,0,5,0,0,0,5,0,5,5,17,17,34
285,5277,13,30,14/10/2015,Atletico-MG,Internacional,2,3,0,0,2,3,0,5,5,14,11,25
286,5278,13,30,14/10/2015,Sport,Avai,2,5,0,0,2,5,0,7,7,8,16,24
287,5279,13,30,14/10/2015,Joinville,Coritiba,6,1,0,0,6,1,0,7,7,23,16,39
288,5280,13,30,14/10/2015,Figueirense,Flamengo,1,1,0,0,1,1,0,2,2,14,10,24
289,5281,13,30,14/10/2015,Palmeiras,Ponte Preta,2,3,0,0,2,3,0,5,5,18,17,35
290,5282,13,30,14/10/2015,Fluminense,Sao Paulo,0,4,0,0,0,4,0,4,4,16,21,37
291,5283,13,30,14/10/2015,Athletico-PR,Cruzeiro,5,2,0,0,5,2,0,7,7,20,7,27
292,5284,13,30,15/10/2015,Vasco,Chapecoense,4,5,0,0,4,5,0,9,9,16,19,35
293,5285,13,30,15/10/2015,Corinthians,Goias,1,5,0,0,1,5,0,6,6,9,10,19
294,5286,13,30,15/10/2015,Gremio,Santos,3,3,0,1,3,4,1,6,7,14,4,18
295,5287,13,31,17/10/2015,Avai,Palmeiras,3,4,0,0,3,4,0,7,7,14,29,43
296,5288,13,31,17/10/2015,Joinville,Figueirense,2,3,1,0,3,3,1,5,6,24,16,40
297,5289,13,31,18/10/2015,Ponte Preta,Coritiba,3,3,0,0,3,3,0,6,6,30,27,57
298,5290,13,31,18/10/2015,Cruzeiro,Fluminense,2,1,0,0,2,1,0,3,3,13,14,27
299,5291,13,31,18/10/2015,Athletico-PR,Corinthians,2,1,0,0,2,1,0,3,3,11,12,23
300,5292,13,31,18/10/2015,Flamengo,Internacional,0,2,0,0,0,2,0,2,2,19,24,43
301,5293,13,31,18/10/2015,Sao Paulo,Vasco,2,1,1,0,3,1,1,3,4,11,16,27
302,5294,13,31,18/10/2015,Gremio,Chapecoense,3,2,0,1,3,3,1,5,6,17,13,30
303,5295,13,31,18/10/2015,Santos,Goias,0,1,0,0,0,1,0,1,1,9,8,17
304,5296,13,31,18/10/2015,Sport,Atletico-MG,0,1,0,1,0,2,1,1,2,13,8,21
305,5297,13,32,24/10/2015,Fluminense,Athletico-PR,1,3,0,0,1,3,0,4,4,4,21,25
306,5298,13,32,24/10/2015,Internacional,Joinville,1,2,0,0,1,2,0,3,3,11,18,29
307,5299,13,32,24/10/2015,Figueirense,Santos,5,2,0,0,5,2,0,7,7,24,20,44
308,5300,13,32,24/10/2015,Palmeiras,Sport,2,1,0,0,2,1,0,3,3,15,9,24
309,5301,13,32,25/10/2015,Corinthians,Flamengo,3,2,0,1,3,3,1,5,6,19,20,39
310,5302,13,32,25/10/2015,Coritiba,Sao Paulo,4,3,1,0,5,3,1,7,8,17,21,38
311,5303,13,32,25/10/2015,Chapecoense,Avai,1,2,0,0,1,2,0,3,3,17,16,33
312,5304,13,32,25/10/2015,Vasco,Gremio,1,2,0,0,1,2,0,3,3,12,16,28
313,5305,13,32,25/10/2015,Goias,Cruzeiro,4,4,0,0,4,4,0,8,8,14,11,25
314,5306,13,32,25/10/2015,Atletico-MG,Ponte Preta,2,1,0,0,2,1,0,3,3,15,12,27
315,5307,13,33,31/10/2015,Sao Paulo,Sport,1,2,0,0,1,2,0,3,3,10,15,25
316,5308,13,33,31/10/2015,Avai,Cruzeiro,3,3,0,0,3,3,0,6,6,16,16,32
317,5309,13,33,31/10/2015,Ponte Preta,Joinville,3,5,0,0,3,5,0,8,8,20,17,37
318,5310,13,33,31/10/2015,Coritiba,Figueirense,2,5,0,0,2,5,0,7,7,13,29,42
319,5311,13,33,1/11/2015,Chapecoense,Athletico-PR,3,4,0,1,3,5,1,7,8,13,12,25
320,5312,13,33,1/11/2015,Santos,Palmeiras,3,3,0,1,3,4,1,6,7,15,18,33
321,5313,13,33,1/11/2015,Gremio,Flamengo,0,1,0,1,0,2,1,1,2,12,12,24
322,5314,13,33,1/11/2015,Atletico-MG,Corinthians,1,0,0,0,1,0,0,1,1,11,15,26
323,5315,13,33,1/11/2015,Vasco,Fluminense,2,5,0,1,2,6,1,7,8,18,22,40
324,5316,13,33,1/11/2015,Goias,Internacional,3,3,0,0,3,3,0,6,6,16,12,28
325,5317,13,34,7/11/2015,Internacional,Ponte Preta,2,4,0,0,2,4,0,6,6,20,20,40
326,5318,13,34,7/11/2015,Corinthians,Coritiba,0,3,0,0,0,3,0,3,3,5,17,22
327,5319,13,34,7/11/2015,Athletico-PR,Avai,1,2,0,0,1,2,0,3,3,21,10,31
328,5320,13,34,7/11/2015,Fluminense,Chapecoense,3,3,0,0,3,3,0,6,6,12,14,26
329,5321,13,34,8/11/2015,Palmeiras,Vasco,1,4,0,0,1,4,0,5,5,29,13,42
330,5322,13,34,8/11/2015,Flamengo,Goias,1,0,0,0,1,0,0,1,1,16,14,30
331,5323,13,34,8/11/2015,Cruzeiro,Sao Paulo,1,2,0,0,1,2,0,3,3,5,12,17
332,5324,13,34,8/11/2015,Figueirense,Atletico-MG,2,4,0,0,2,4,0,6,6,14,13,27
333,5325,13,34,8/11/2015,Joinville,Santos,3,2,1,0,4,2,1,5,6,22,19,41
334,5326,13,34,8/11/2015,Sport,Gremio,2,3,0,1,2,4,1,5,6,8,16,24
335,5327,13,35,15/11/2015,Cruzeiro,Sport,2,4,0,0,2,4,0,6,6,13,15,28
336,5328,13,35,18/11/2015,Goias,Coritiba,1,1,0,0,1,1,0,2,2,20,18,38
337,5329,13,35,18/11/2015,Ponte Preta,Figueirense,4,4,0,0,4,4,0,8,8,18,24,42
338,5330,13,35,18/11/2015,Avai,Joinville,4,1,0,0,4,1,0,5,5,12,13,25
339,5331,13,35,18/11/2015,Athletico-PR,Palmeiras,2,4,0,2,2,6,2,6,8,13,15,28
340,5332,13,35,19/11/2015,Gremio,Fluminense,3,4,0,1,3,5,1,7,8,20,21,41
341,5333,13,35,19/11/2015,Chapecoense,Internacional,4,3,0,1,4,4,1,7,8,16,14,30
342,5335,13,35,19/11/2015,Santos,Flamengo,2,2,0,1,2,3,1,4,5,20,11,31
343,5336,13,35,19/11/2015,Vasco,Corinthians,2,3,1,0,3,3,1,5,6,12,15,27
344,5337,13,36,21/11/2015,Palmeiras,Cruzeiro,2,1,0,0,2,1,0,3,3,20,13,33
345,5338,13,36,22/11/2015,Joinville,Vasco,5,4,1,0,6,4,1,9,10,21,10,31
346,5339,13,36,22/11/2015,Atletico-MG,Goias,3,3,0,0,3,3,0,6,6,16,12,28
347,5340,13,36,22/11/2015,Internacional,Gremio,4,2,0,0,4,2,0,6,6,21,13,34
348,5341,13,36,22/11/2015,Figueirense,Chapecoense,1,3,0,0,1,3,0,4,4,13,15,28
349,5342,13,36,22/11/2015,Corinthians,Sao Paulo,2,2,0,0,2,2,0,4,4,10,10,20
350,5343,13,36,22/11/2015,Flamengo,Ponte Preta,3,3,0,0,3,3,0,6,6,19,23,42
351,5344,13,36,22/11/2015,Fluminense,Avai,2,3,0,0,2,3,0,5,5,11,6,17
352,5345,13,36,22/11/2015,Coritiba,Santos,3,3,0,1,3,4,1,6,7,13,21,34
353,5346,13,36,22/11/2015,Sport,Athletico-PR,3,2,0,0,3,2,0,5,5,10,20,30
354,5347,13,37,28/11/2015,Sao Paulo,Figueirense,1,4,0,0,1,4,0,5,5,16,26,42
355,5348,13,37,28/11/2015,Fluminense,Internacional,3,4,1,0,4,4,1,7,8,13,20,33
356,5349,13,37,28/11/2015,Avai,Ponte Preta,1,2,0,1,1,3,1,3,4,19,27,46
357,5350,13,37,29/11/2015,Sport,Corinthians,6,3,0,0,6,3,0,9,9,14,17,31
358,5351,13,37,29/11/2015,Cruzeiro,Joinville,2,3,0,0,2,3,0,5,5,12,13,25
359,5352,13,37,29/11/2015,Gremio,Atletico-MG,3,5,0,0,3,5,0,8,8,10,11,21
360,5353,13,37,29/11/2015,Chapecoense,Goias,5,3,0,0,5,3,0,8,8,17,17,34
361,5354,13,37,29/11/2015,Vasco,Santos,3,2,0,0,3,2,0,5,5,14,12,26
362,5355,13,37,29/11/2015,Palmeiras,Coritiba,3,3,0,0,3,3,0,6,6,22,27,49
363,5356,13,37,29/11/2015,Athletico-PR,Flamengo,1,3,0,0,1,3,0,4,4,16,14,30
364,5357,13,38,6/12/2015,Internacional,Cruzeiro,2,1,0,0,2,1,0,3,3,11,13,24
365,5358,13,38,6/12/2015,Flamengo,Palmeiras,0,1,0,0,0,1,0,1,1,16,20,36
366,5359,13,38,6/12/2015,Figueirense,Fluminense,4,4,0,0,4,4,0,8,8,16,18,34
367,5360,13,38,6/12/2015,Santos,Athletico-PR,0,1,0,0,0,1,0,1,1,10,10,20
368,5361,13,38,6/12/2015,Ponte Preta,Sport,4,2,0,0,4,2,0,6,6,21,12,33
369,5362,13,38,6/12/2015,Goias,Sao Paulo,4,1,0,0,4,1,0,5,5,12,21,33
370,5363,13,38,6/12/2015,Corinthians,Avai,2,2,0,0,2,2,0,4,4,11,14,25
371,5365,13,38,6/12/2015,Joinville,Gremio,3,1,0,0,3,1,0,4,4,12,13,25
372,5366,13,38,6/12/2015,Coritiba,Vasco,1,0,0,1,1,1,1,1,2,20,15,35
373,5367,14,1,14/5/2016,Palmeiras,Athletico-PR,1,4,0,1,1,5,1,5,6,14,17,31
374,5368,14,1,14/5/2016,Flamengo,Sport,2,1,0,1,2,2,1,3,4,18,15,33
375,5369,14,1,14/5/2016,Atletico-MG,Santos,2,2,0,0,2,2,0,4,4,18,12,30
376,5370,14,1,14/5/2016,Coritiba,Cruzeiro,1,3,0,2,1,5,2,4,6,19,23,42
377,5371,14,1,15/5/2016,Santa Cruz,Vitoria,3,0,0,0,3,0,0,3,3,11,17,28
378,5372,14,1,15/5/2016,Botafogo-RJ,Sao Paulo,1,5,0,0,1,5,0,6,6,7,10,17
379,5373,14,1,15/5/2016,Figueirense,Ponte Preta,2,5,0,0,2,5,0,7,7,8,21,29
380,5374,14,1,15/5/2016,Corinthians,Gremio,1,4,0,0,1,4,0,5,5,12,20,32
381,5376,14,1,15/5/2016,Internacional,Chapecoense,3,4,0,1,3,5,1,7,8,14,20,34
382,5377,14,2,21/5/2016,Ponte Preta,Palmeiras,3,4,0,0,3,4,0,7,7,21,16,37
383,5378,14,2,21/5/2016,Fluminense,Santa Cruz,3,5,0,0,3,5,0,8,8,20,23,43
384,5379,14,2,21/5/2016,Cruzeiro,Figueirense,3,1,0,0,3,1,0,4,4,11,14,25
385,5380,14,2,22/5/2016,Santos,Coritiba,5,2,0,0,5,2,0,7,7,12,15,27
386,5381,14,2,22/5/2016,Athletico-PR,Atletico-MG,3,1,0,0,3,1,0,4,4,18,7,25
387,5382,14,2,22/5/2016,Vitoria,Corinthians,5,4,1,0,6,4,1,9,10,20,24,44
388,5383,14,2,22/5/2016,Chapecoense,America-MG,0,4,0,0,0,4,0,4,4,12,26,38
389,5384,14,2,22/5/2016,Sao Paulo,Internacional,4,6,0,1,4,7,1,10,11,11,16,27
390,5385,14,2,22/5/2016,Gremio,Flamengo,3,2,0,0,3,2,0,5,5,17,8,25
391,5386,14,2,22/5/2016,Sport,Botafogo-RJ,3,2,0,0,3,2,0,5,5,14,10,24
392,5387,14,3,25/5/2016,Figueirense,Santos,2,3,0,1,2,4,1,5,6,21,12,33
393,5388,14,3,25/5/2016,Botafogo-RJ,Athletico-PR,2,2,0,0,2,2,0,4,4,8,12,20
394,5389,14,3,25/5/2016,Flamengo,Chapecoense,4,1,1,0,5,1,1,5,6,10,24,34
395,5390,14,3,25/5/2016,America-MG,Vitoria,4,2,0,1,4,3,1,6,7,22,18,40
396,5391,14,3,25/5/2016,Santa Cruz,Cruzeiro,2,3,0,0,2,3,0,5,5,16,15,31
397,5392,14,3,25/5/2016,Palmeiras,Fluminense,1,0,0,0,1,0,0,1,1,20,12,32
398,5393,14,3,25/5/2016,Coritiba,Sao Paulo,2,2,0,0,2,2,0,4,4,18,12,30
399,5394,14,3,26/5/2016,Corinthians,Ponte Preta,3,3,0,0,3,3,0,6,6,23,15,38
400,5395,14,3,26/5/2016,Internacional,Sport,3,1,0,0,3,1,0,4,4,14,13,27
401,5396,14,3,26/5/2016,Atletico-MG,Gremio,1,5,0,0,1,5,0,6,6,8,14,22
402,5397,14,4,28/5/2016,Cruzeiro,America-MG,1,1,0,0,1,1,0,2,2,7,9,16
403,5398,14,4,28/5/2016,Athletico-PR,Figueirense,2,1,0,0,2,1,0,3,3,17,17,34
404,5399,14,4,28/5/2016,Chapecoense,Santa Cruz,1,4,0,0,1,4,0,5,5,16,19,35
405,5400,14,4,29/5/2016,Ponte Preta,Flamengo,2,2,0,1,2,3,1,4,5,19,13,32
406,5401,14,4,29/5/2016,Sport,Corinthians,2,1,0,0,2,1,0,3,3,7,12,19
407,5402,14,4,29/5/2016,Fluminense,Botafogo-RJ,1,1,0,0,1,1,0,2,2,16,17,33
408,5403,14,4,29/5/2016,Vitoria,Atletico-MG,4,6,0,0,4,6,0,10,10,21,18,39
409,5404,14,4,29/5/2016,Sao Paulo,Palmeiras,2,5,0,0,2,5,0,7,7,18,21,39
410,5405,14,4,29/5/2016,Gremio,Coritiba,0,3,0,0,0,3,0,3,3,19,18,37
411,5406,14,4,29/5/2016,Santos,Internacional,1,1,0,0,1,1,0,2,2,9,14,23
412,5407,14,5,1/6/2016,Internacional,Athletico-PR,5,2,0,0,5,2,0,7,7,30,15,45
413,5408,14,5,1/6/2016,Corinthians,Santos,0,2,0,0,0,2,0,2,2,14,14,28
414,5409,14,5,1/6/2016,Santa Cruz,Sport,6,2,1,0,7,2,1,8,9,25,15,40
415,5410,14,5,1/6/2016,Coritiba,Chapecoense,4,5,0,0,4,5,0,9,9,17,23,40
416,5411,14,5,1/6/2016,Atletico-MG,Fluminense,2,5,0,0,2,5,0,7,7,16,19,35
417,5412,14,5,1/6/2016,Figueirense,Sao Paulo,2,1,0,0,2,1,0,3,3,16,19,35
418,5413,14,5,1/6/2016,Botafogo-RJ,Cruzeiro,1,3,0,0,1,3,0,4,4,11,23,34
419,5414,14,5,2/6/2016,America-MG,Ponte Preta,1,3,0,0,1,3,0,4,4,7,15,22
420,5415,14,5,2/6/2016,Palmeiras,Gremio,5,4,0,0,5,4,0,9,9,24,19,43
421,5416,14,5,2/6/2016,Flamengo,Vitoria,2,3,0,0,2,3,0,5,5,14,18,32
422,5417,14,6,4/6/2016,Athletico-PR,Santa Cruz,0,2,0,0,0,2,0,2,2,12,18,30
423,5418,14,6,4/6/2016,Chapecoense,Fluminense,3,0,0,0,3,0,0,3,3,12,11,23
424,5419,14,6,4/6/2016,Corinthians,Coritiba,2,5,0,0,2,5,0,7,7,13,12,25
425,5420,14,6,5/6/2016,America-MG,Figueirense,2,3,0,0,2,3,0,5,5,20,14,34
426,5421,14,6,5/6/2016,Santos,Botafogo-RJ,1,1,0,0,1,1,0,2,2,12,12,24
427,5422,14,6,5/6/2016,Vitoria,Internacional,1,6,0,0,1,6,0,7,7,16,19,35
428,5423,14,6,5/6/2016,Sport,Atletico-MG,1,3,0,0,1,3,0,4,4,10,17,27
429,5424,14,6,5/6/2016,Flamengo,Palmeiras,1,2,1,0,2,2,1,3,4,11,12,23
430,5425,14,6,5/6/2016,Gremio,Ponte Preta,2,4,1,1,3,5,2,6,8,14,13,27
431,5426,14,6,5/6/2016,Cruzeiro,Sao Paulo,2,0,0,0,2,0,0,2,2,12,9,21
432,5427,14,7,11/6/2016,Internacional,America-MG,2,3,0,0,2,3,0,5,5,16,15,31
433,5428,14,7,11/6/2016,Ponte Preta,Chapecoense,3,4,0,0,3,4,0,7,7,22,22,44
434,5429,14,7,11/6/2016,Fluminense,Gremio,4,2,0,1,4,3,1,6,7,9,10,19
435,5430,14,7,11/6/2016,Sao Paulo,Athletico-PR,1,2,0,0,1,2,0,3,3,12,17,29
436,5431,14,7,12/6/2016,Coritiba,Sport,5,4,1,1,6,5,2,9,11,18,26,44
437,5432,14,7,12/6/2016,Botafogo-RJ,Vitoria,3,1,0,0,3,1,0,4,4,20,18,38
438,5433,14,7,12/6/2016,Atletico-MG,Cruzeiro,4,6,1,3,5,9,4,10,14,15,15,30
439,5434,14,7,12/6/2016,Palmeiras,Corinthians,4,4,0,0,4,4,0,8,8,19,18,37
440,5435,14,7,12/6/2016,Figueirense,Flamengo,2,2,0,0,2,2,0,4,4,17,17,34
441,5436,14,7,12/6/2016,Santa Cruz,Santos,1,2,0,0,1,2,0,3,3,19,11,30
442,5437,14,8,15/6/2016,Sao Paulo,Vitoria,5,2,0,0,5,2,0,7,7,22,22,44
443,5438,14,8,15/6/2016,Chapecoense,Gremio,2,2,0,0,2,2,0,4,4,19,15,34
444,5439,14,8,15/6/2016,Ponte Preta,Athletico-PR,0,2,0,0,0,2,0,2,2,9,15,24
445,5440,14,8,15/6/2016,Santos,Sport,1,3,0,0,1,3,0,4,4,10,10,20
446,5441,14,8,15/6/2016,Santa Cruz,Figueirense,3,3,0,1,3,4,1,6,7,25,8,33
447,5442,14,8,15/6/2016,Botafogo-RJ,America-MG,2,2,0,0,2,2,0,4,4,17,20,37
448,5443,14,8,15/6/2016,Coritiba,Palmeiras,4,3,0,0,4,3,0,7,7,14,19,33
449,5445,14,8,16/6/2016,Internacional,Atletico-MG,2,1,0,0,2,1,0,3,3,23,12,35
450,5446,14,8,16/6/2016,Fluminense,Corinthians,2,1,0,1,2,2,1,3,4,12,7,19
451,5447,14,9,18/6/2016,Palmeiras,Santa Cruz,1,4,0,1,1,5,1,5,6,18,24,42
452,5448,14,9,18/6/2016,Athletico-PR,Santos,2,1,0,0,2,1,0,3,3,16,7,23
453,5449,14,9,18/6/2016,America-MG,Coritiba,0,3,0,0,0,3,0,3,3,17,12,29
454,5450,14,9,19/6/2016,Vitoria,Chapecoense,1,4,0,0,1,4,0,5,5,20,18,38
455,5451,14,9,19/6/2016,Atletico-MG,Ponte Preta,0,1,0,0,0,1,0,1,1,9,17,26
456,5452,14,9,19/6/2016,Corinthians,Botafogo-RJ,2,2,0,0,2,2,0,4,4,15,15,30
457,5453,14,9,19/6/2016,Flamengo,Sao Paulo,1,3,0,1,1,4,1,4,5,9,19,28
458,5454,14,9,19/6/2016,Figueirense,Internacional,3,0,0,0,3,0,0,3,3,16,15,31
459,5455,14,9,19/6/2016,Sport,Fluminense,2,0,0,0,2,0,0,2,2,12,12,24
460,5456,14,9,19/6/2016,Gremio,Cruzeiro,0,2,0,0,0,2,0,2,2,13,16,29
461,5457,14,10,21/6/2016,Palmeiras,America-MG,0,1,0,0,0,1,0,1,1,6,8,14
462,5458,14,10,22/6/2016,Ponte Preta,Cruzeiro,4,4,0,0,4,4,0,8,8,11,14,25
463,5459,14,10,22/6/2016,Botafogo-RJ,Figueirense,0,1,0,0,0,1,0,1,1,12,14,26
464,5460,14,10,22/6/2016,Santa Cruz,Flamengo,1,0,0,0,1,0,0,1,1,13,12,25
465,5461,14,10,22/6/2016,Fluminense,Santos,1,1,0,0,1,1,0,2,2,9,11,20
466,5462,14,10,22/6/2016,Atletico-MG,Corinthians,3,1,0,0,3,1,0,4,4,24,11,35
467,5463,14,10,23/6/2016,Chapecoense,Athletico-PR,2,2,0,0,2,2,0,4,4,16,17,33
468,5464,14,10,23/6/2016,Gremio,Vitoria,4,4,1,0,5,4,1,8,9,11,17,28
469,5465,14,10,23/6/2016,Sao Paulo,Sport,0,2,0,0,0,2,0,2,2,9,19,28
470,5466,14,10,23/6/2016,Coritiba,Internacional,2,5,1,0,3,5,1,7,8,13,27,40
471,5467,14,11,25/6/2016,Cruzeiro,Palmeiras,4,2,0,0,4,2,0,6,6,13,14,27
472,5468,14,11,25/6/2016,Corinthians,Santa Cruz,3,1,0,0,3,1,0,4,4,14,16,30
473,5469,14,11,26/6/2016,America-MG,Atletico-MG,3,3,0,0,3,3,0,6,6,19,17,36
474,5470,14,11,26/6/2016,Flamengo,Fluminense,0,1,0,0,0,1,0,1,1,9,14,23
475,5471,14,11,26/6/2016,Vitoria,Ponte Preta,3,2,0,0,3,2,0,5,5,17,22,39
476,5472,14,11,26/6/2016,Athletico-PR,Gremio,1,0,0,1,1,1,1,1,2,12,16,28
477,5473,14,11,26/6/2016,Internacional,Botafogo-RJ,4,3,1,0,5,3,1,7,8,21,18,39
478,5474,14,11,26/6/2016,Santos,Sao Paulo,2,3,0,1,2,4,1,5,6,8,14,22
479,5475,14,11,26/6/2016,Sport,Chapecoense,3,2,0,0,3,2,0,5,5,22,10,32
480,5476,14,11,26/6/2016,Figueirense,Coritiba,3,4,0,0,3,4,0,7,7,19,23,42
481,5477,14,12,29/6/2016,Flamengo,Internacional,1,1,0,0,1,1,0,2,2,11,22,33
482,5478,14,12,29/6/2016,Vitoria,Sport,4,4,0,2,4,6,2,8,10,22,19,41
483,5479,14,12,29/6/2016,Gremio,Santos,3,3,0,0,3,3,0,6,6,10,14,24
484,5480,14,12,29/6/2016,Coritiba,Athletico-PR,3,2,0,0,3,2,0,5,5,22,16,38
485,5481,14,12,29/6/2016,Chapecoense,Cruzeiro,4,6,0,0,4,6,0,10,10,19,20,39
486,5482,14,12,29/6/2016,Sao Paulo,Fluminense,4,3,0,0,4,3,0,7,7,17,15,32
487,5483,14,12,29/6/2016,America-MG,Corinthians,2,1,0,0,2,1,0,3,3,10,13,23
488,5484,14,12,30/6/2016,Santa Cruz,Ponte Preta,2,1,0,0,2,1,0,3,3,15,16,31
489,5485,14,12,30/6/2016,Palmeiras,Figueirense,1,1,0,0,1,1,0,2,2,26,24,50
490,5487,14,13,2/7/2016,Fluminense,Coritiba,1,2,0,0,1,2,0,3,3,14,19,33
491,5488,14,13,2/7/2016,Athletico-PR,America-MG,2,2,0,0,2,2,0,4,4,9,12,21
492,5489,14,13,3/7/2016,Cruzeiro,Vitoria,3,3,0,1,3,4,1,6,7,12,18,30
493,5490,14,13,3/7/2016,Internacional,Gremio,4,5,0,0,4,5,0,9,9,11,11,22
494,5491,14,13,3/7/2016,Santos,Chapecoense,1,1,0,0,1,1,0,2,2,13,12,25
495,5492,14,13,3/7/2016,Ponte Preta,Sao Paulo,3,2,0,1,3,3,1,5,6,20,16,36
496,5493,14,13,3/7/2016,Corinthians,Flamengo,2,3,0,0,2,3,0,5,5,15,10,25
497,5494,14,13,3/7/2016,Botafogo-RJ,Santa Cruz,1,3,0,0,1,3,0,4,4,11,13,24
498,5495,14,13,3/7/2016,Figueirense,Atletico-MG,2,4,1,1,3,5,2,6,8,18,21,39
499,5496,14,13,4/7/2016,Sport,Palmeiras,4,5,0,0,4,5,0,9,9,18,21,39
500,5497,14,14,9/7/2016,Chapecoense,Corinthians,1,1,1,0,2,1,1,2,3,17,13,30
501,5498,14,14,9/7/2016,Coritiba,Botafogo-RJ,1,3,0,0,1,3,0,4,4,21,14,35
502,5499,14,14,9/7/2016,Ponte Preta,Sport,2,2,0,0,2,2,0,4,4,17,12,29
503,5500,14,14,10/7/2016,Gremio,Figueirense,1,1,0,0,1,1,0,2,2,11,14,25
504,5501,14,14,10/7/2016,Flamengo,Atletico-MG,1,4,0,0,1,4,0,5,5,10,23,33
505,5502,14,14,10/7/2016,Santa Cruz,Internacional,0,2,0,0,0,2,0,2,2,21,19,40
506,5503,14,14,10/7/2016,Sao Paulo,America-MG,1,4,0,0,1,4,0,5,5,7,13,20
507,5504,14,14,10/7/2016,Vitoria,Fluminense,3,4,0,0,3,4,0,7,7,16,22,38
508,5505,14,14,11/7/2016,Cruzeiro,Athletico-PR,1,4,0,0,1,4,0,5,5,9,17,26
509,5506,14,14,12/7/2016,Palmeiras,Santos,3,2,0,0,3,2,0,5,5,17,17,34
510,5507,14,15,16/7/2016,Botafogo-RJ,Flamengo,2,4,0,0,2,4,0,6,6,12,22,34
511,5508,14,15,16/7/2016,Santos,Ponte Preta,3,2,0,0,3,2,0,5,5,14,11,25
512,5509,14,15,17/7/2016,America-MG,Santa Cruz,2,2,0,0,2,2,0,4,4,9,10,19
513,5510,14,15,17/7/2016,Internacional,Palmeiras,4,2,0,0,4,2,0,6,6,17,13,30
514,5511,14,15,17/7/2016,Figueirense,Chapecoense,1,4,0,0,1,4,0,5,5,16,18,34
515,5512,14,15,17/7/2016,Fluminense,Cruzeiro,0,6,0,0,0,6,0,6,6,17,17,34
516,5513,14,15,17/7/2016,Athletico-PR,Vitoria,3,3,0,0,3,3,0,6,6,16,10,26
517,5514,14,15,17/7/2016,Corinthians,Sao Paulo,3,3,0,0,3,3,0,6,6,11,26,37
518,5515,14,15,17/7/2016,Sport,Gremio,0,3,0,0,0,3,0,3,3,15,16,31
519,5516,14,15,18/7/2016,Atletico-MG,Coritiba,2,2,0,0,2,2,0,4,4,16,18,34
520,5517,14,16,23/7/2016,Corinthians,Figueirense,2,6,0,0,2,6,0,8,8,15,21,36
521,5518,14,16,23/7/2016,Santa Cruz,Coritiba,2,1,0,0,2,1,0,3,3,17,19,36
522,5519,14,16,24/7/2016,Palmeiras,Atletico-MG,1,2,0,0,1,2,0,3,3,11,19,30
523,5520,14,16,24/7/2016,Ponte Preta,Internacional,3,3,0,1,3,4,1,6,7,20,13,33
524,5521,14,16,24/7/2016,Gremio,Sao Paulo,0,3,0,1,0,4,1,3,4,16,12,28
525,5522,14,16,24/7/2016,Athletico-PR,Fluminense,3,5,0,0,3,5,0,8,8,13,20,33
526,5523,14,16,24/7/2016,Cruzeiro,Sport,1,4,0,0,1,4,0,5,5,15,18,33
527,5524,14,16,24/7/2016,Chapecoense,Botafogo-RJ,1,2,0,0,1,2,0,3,3,14,16,30
528,5525,14,16,24/7/2016,Vitoria,Santos,3,2,0,0,3,2,0,5,5,15,11,26
529,5526,14,16,25/7/2016,Flamengo,America-MG,1,0,0,0,1,0,0,1,1,11,13,24
530,5527,14,17,30/7/2016,Figueirense,Vitoria,3,4,1,1,4,5,2,7,9,19,26,45
531,5528,14,17,30/7/2016,Sport,Athletico-PR,2,1,0,0,2,1,0,3,3,23,9,32
532,5529,14,17,30/7/2016,Atletico-MG,Santa Cruz,1,3,0,0,1,3,0,4,4,13,12,25
533,5530,14,17,31/7/2016,Sao Paulo,Chapecoense,4,1,0,0,4,1,0,5,5,13,11,24
534,5531,14,17,31/7/2016,Fluminense,Ponte Preta,4,6,0,0,4,6,0,10,10,21,21,42
535,5532,14,17,31/7/2016,Coritiba,Flamengo,1,2,0,0,1,2,0,3,3,9,13,22
536,5533,14,17,31/7/2016,Internacional,Corinthians,2,2,0,0,2,2,0,4,4,19,19,38
537,5534,14,17,31/7/2016,Santos,Cruzeiro,1,1,0,0,1,1,0,2,2,12,10,22
538,5535,14,17,31/7/2016,Botafogo-RJ,Palmeiras,4,3,0,0,4,3,0,7,7,20,23,43
539,5536,14,17,31/7/2016,America-MG,Gremio,2,2,0,1,2,3,1,4,5,15,8,23
540,5537,14,18,3/8/2016,Vitoria,Coritiba,2,1,0,0,2,1,0,3,3,9,19,28
541,5538,14,18,3/8/2016,Sport,America-MG,1,3,0,0,1,3,0,4,4,8,22,30
542,5539,14,18,3/8/2016,Santos,Flamengo,2,2,0,0,2,2,0,4,4,10,9,19
543,5540,14,18,3/8/2016,Athletico-PR,Corinthians,3,0,0,0,3,0,0,3,3,11,12,23
544,5541,14,18,4/8/2016,Ponte Preta,Botafogo-RJ,2,2,0,0,2,2,0,4,4,16,12,28
545,5542,14,18,4/8/2016,Gremio,Santa Cruz,1,3,0,0,1,3,0,4,4,18,18,36
546,5543,14,18,4/8/2016,Sao Paulo,Atletico-MG,2,2,0,0,2,2,0,4,4,9,17,26
547,5544,14,18,4/8/2016,Cruzeiro,Internacional,1,1,0,0,1,1,0,2,2,10,14,24
548,5545,14,18,4/8/2016,Chapecoense,Palmeiras,1,0,0,0,1,0,0,1,1,18,15,33
549,5546,14,18,3/9/2016,Fluminense,Figueirense,3,3,0,0,3,3,0,6,6,21,15,36
550,5547,14,19,6/8/2016,Flamengo,Athletico-PR,2,4,0,0,2,4,0,6,6,11,11,22
551,5548,14,19,7/8/2016,America-MG,Santos,2,1,0,1,2,2,1,3,4,11,7,18
552,5549,14,19,7/8/2016,Coritiba,Ponte Preta,4,3,0,0,4,3,0,7,7,20,18,38
553,5550,14,19,7/8/2016,Palmeiras,Vitoria,2,4,0,0,2,4,0,6,6,13,20,33
554,5551,14,19,7/8/2016,Santa Cruz,Sao Paulo,1,3,0,0,1,3,0,4,4,15,24,39
555,5552,14,19,7/8/2016,Internacional,Fluminense,4,4,0,0,4,4,0,8,8,22,14,36
556,5553,14,19,7/8/2016,Figueirense,Sport,5,3,0,0,5,3,0,8,8,18,16,34
557,5554,14,19,8/8/2016,Atletico-MG,Chapecoense,0,1,0,0,0,1,0,1,1,15,12,27
558,5555,14,19,8/8/2016,Corinthians,Cruzeiro,4,3,0,0,4,3,0,7,7,15,8,23
559,5556,14,19,4/9/2016,Botafogo-RJ,Gremio,3,4,0,0,3,4,0,7,7,16,25,41
560,5557,14,20,13/8/2016,Sport,Flamengo,2,3,0,0,2,3,0,5,5,24,15,39
561,5558,14,20,13/8/2016,Ponte Preta,Figueirense,2,2,0,0,2,2,0,4,4,21,25,46
562,5559,14,20,14/8/2016,Fluminense,America-MG,2,5,0,0,2,5,0,7,7,12,28,40
563,5560,14,20,14/8/2016,Gremio,Corinthians,4,1,0,0,4,1,0,5,5,15,14,29
564,5561,14,20,14/8/2016,Cruzeiro,Coritiba,2,4,0,0,2,4,0,6,6,15,20,35
565,5562,14,20,14/8/2016,Santos,Atletico-MG,4,4,0,0,4,4,0,8,8,24,9,33
566,5563,14,20,14/8/2016,Vitoria,Santa Cruz,1,2,0,0,1,2,0,3,3,15,20,35
567,5564,14,20,14/8/2016,Sao Paulo,Botafogo-RJ,2,2,0,0,2,2,0,4,4,11,14,25
568,5565,14,20,14/8/2016,Athletico-PR,Palmeiras,3,3,0,0,3,3,0,6,6,12,15,27
569,5566,14,20,15/8/2016,Chapecoense,Internacional,1,2,0,0,1,2,0,3,3,15,18,33
570,5567,14,21,19/8/2016,America-MG,Chapecoense,1,1,0,0,1,1,0,2,2,13,10,23
571,5568,14,21,20/8/2016,Botafogo-RJ,Sport,1,2,0,0,1,2,0,3,3,19,12,31
572,5569,14,21,21/8/2016,Flamengo,Gremio,2,1,0,0,2,1,0,3,3,14,16,30
573,5570,14,21,21/8/2016,Atletico-MG,Athletico-PR,0,2,0,0,0,2,0,2,2,15,15,30
574,5571,14,21,21/8/2016,Internacional,Sao Paulo,1,2,0,0,1,2,0,3,3,9,22,31
575,5572,14,21,21/8/2016,Santa Cruz,Fluminense,0,2,0,0,0,2,0,2,2,16,16,32
576,5573,14,21,21/8/2016,Palmeiras,Ponte Preta,3,6,0,0,3,6,0,9,9,12,22,34
577,5574,14,21,21/8/2016,Coritiba,Santos,1,3,0,0,1,3,0,4,4,13,16,29
578,5575,14,21,21/8/2016,Figueirense,Cruzeiro,4,5,1,0,5,5,1,9,10,20,24,44
579,5576,14,21,22/8/2016,Corinthians,Vitoria,2,4,0,0,2,4,0,6,6,15,20,35
580,5577,14,22,27/8/2016,Ponte Preta,Corinthians,2,1,0,1,2,2,1,3,4,15,8,23
581,5578,14,22,28/8/2016,Cruzeiro,Santa Cruz,3,3,0,0,3,3,0,6,6,17,13,30
582,5579,14,22,28/8/2016,Santos,Figueirense,3,2,0,0,3,2,0,5,5,13,12,25
583,5580,14,22,28/8/2016,Gremio,Atletico-MG,4,4,0,0,4,4,0,8,8,18,17,35
584,5581,14,22,28/8/2016,Fluminense,Palmeiras,7,5,0,0,7,5,0,12,12,17,20,37
585,5582,14,22,28/8/2016,Chapecoense,Flamengo,4,0,0,0,4,0,0,4,4,15,13,28
586,5583,14,22,28/8/2016,Sao Paulo,Coritiba,2,1,0,0,2,1,0,3,3,18,16,34
587,5584,14,22,28/8/2016,Sport,Internacional,4,5,0,0,4,5,0,9,9,18,19,37
588,5585,14,22,28/8/2016,Vitoria,America-MG,3,5,0,0,3,5,0,8,8,20,19,39
589,5586,14,22,29/8/2016,Athletico-PR,Botafogo-RJ,3,2,0,0,3,2,0,5,5,12,14,26
590,5587,14,23,7/9/2016,Santa Cruz,Chapecoense,3,3,1,0,4,3,1,6,7,9,18,27
591,5588,14,23,7/9/2016,Figueirense,Athletico-PR,1,2,0,0,1,2,0,3,3,16,20,36
592,5589,14,23,7/9/2016,Botafogo-RJ,Fluminense,5,2,0,0,5,2,0,7,7,22,15,37
593,5590,14,23,7/9/2016,Atletico-MG,Vitoria,2,5,0,0,2,5,0,7,7,17,17,34
594,5591,14,23,7/9/2016,Palmeiras,Sao Paulo,3,3,0,0,3,3,0,6,6,20,19,39
595,5592,14,23,7/9/2016,Flamengo,Ponte Preta,1,3,0,0,1,3,0,4,4,15,19,34
596,5593,14,23,7/9/2016,Coritiba,Gremio,3,0,0,0,3,0,0,3,3,15,9,24
597,5594,14,23,8/9/2016,Corinthians,Sport,2,2,0,0,2,2,0,4,4,15,17,32
598,5595,14,23,8/9/2016,America-MG,Cruzeiro,1,2,0,0,1,2,0,3,3,19,13,32
599,5596,14,23,8/9/2016,Internacional,Santos,4,4,0,1,4,5,1,8,9,19,8,27
600,5597,14,24,10/9/2016,Vitoria,Flamengo,2,1,1,0,3,1,1,3,4,14,8,22
601,5598,14,24,11/9/2016,Chapecoense,Coritiba,2,3,0,0,2,3,0,5,5,20,16,36
602,5599,14,24,11/9/2016,Sao Paulo,Figueirense,2,2,0,0,2,2,0,4,4,25,17,42
603,5600,14,24,11/9/2016,Cruzeiro,Botafogo-RJ,4,2,0,0,4,2,0,6,6,16,16,32
604,5601,14,24,11/9/2016,Sport,Santa Cruz,2,1,1,1,3,2,2,3,5,14,18,32
605,5602,14,24,11/9/2016,Athletico-PR,Internacional,0,2,0,0,0,2,0,2,2,11,12,23
606,5603,14,24,11/9/2016,Santos,Corinthians,2,1,0,0,2,1,0,3,3,18,17,35
607,5604,14,24,11/9/2016,Ponte Preta,America-MG,2,1,0,0,2,1,0,3,3,10,12,22
608,5605,14,24,11/9/2016,Gremio,Palmeiras,4,3,0,0,4,3,0,7,7,23,16,39
609,5606,14,24,12/9/2016,Fluminense,Atletico-MG,1,4,0,0,1,4,0,5,5,14,16,30
610,5607,14,25,14/9/2016,Botafogo-RJ,Santos,2,1,0,0,2,1,0,3,3,10,10,20
611,5608,14,25,14/9/2016,Figueirense,America-MG,0,2,0,1,0,3,1,2,3,17,13,30
612,5609,14,25,14/9/2016,Ponte Preta,Gremio,2,1,0,0,2,1,0,3,3,16,18,34
613,5610,14,25,14/9/2016,Santa Cruz,Athletico-PR,3,4,0,0,3,4,0,7,7,12,13,25
614,5611,14,25,14/9/2016,Coritiba,Corinthians,3,1,1,0,4,1,1,4,5,15,12,27
615,5612,14,25,14/9/2016,Palmeiras,Flamengo,2,1,0,1,2,2,1,3,4,13,13,26
616,5613,14,25,15/9/2016,Atletico-MG,Sport,0,1,0,1,0,2,1,1,2,13,15,28
617,5614,14,25,15/9/2016,Fluminense,Chapecoense,3,4,0,0,3,4,0,7,7,19,18,37
618,5615,14,25,15/9/2016,Sao Paulo,Cruzeiro,0,0,0,1,0,1,1,0,1,14,8,22
619,5616,14,25,15/9/2016,Internacional,Vitoria,3,5,0,0,3,5,0,8,8,18,24,42
620,5617,14,26,17/9/2016,Corinthians,Palmeiras,2,4,1,0,3,4,1,6,7,16,16,32
621,5618,14,26,18/9/2016,Flamengo,Figueirense,2,3,0,1,2,4,1,5,6,16,17,33
622,5619,14,26,18/9/2016,Cruzeiro,Atletico-MG,1,2,1,0,2,2,1,3,4,12,23,35
623,5620,14,26,18/9/2016,Sport,Coritiba,0,1,0,0,0,1,0,1,1,20,21,41
624,5621,14,26,18/9/2016,Gremio,Fluminense,4,3,0,0,4,3,0,7,7,17,11,28
625,5622,14,26,18/9/2016,Chapecoense,Ponte Preta,2,0,0,0,2,0,0,2,2,16,12,28
626,5623,14,26,18/9/2016,Athletico-PR,Sao Paulo,1,1,0,0,1,1,0,2,2,12,12,24
627,5624,14,26,18/9/2016,Santos,Santa Cruz,1,1,0,0,1,1,0,2,2,13,11,24
628,5625,14,26,18/9/2016,Vitoria,Botafogo-RJ,2,5,0,0,2,5,0,7,7,15,24,39
629,5626,14,26,19/9/2016,America-MG,Internacional,1,2,0,0,1,2,0,3,3,12,14,26
630,5627,14,27,24/9/2016,Palmeiras,Coritiba,2,3,0,0,2,3,0,5,5,13,24,37
631,5628,14,27,24/9/2016,Sport,Santos,3,2,0,1,3,3,1,5,6,20,11,31
632,5629,14,27,24/9/2016,America-MG,Botafogo-RJ,2,3,0,0,2,3,0,5,5,16,12,28
633,5630,14,27,25/9/2016,Athletico-PR,Ponte Preta,2,5,0,1,2,6,1,7,8,11,20,31
634,5631,14,27,25/9/2016,Figueirense,Santa Cruz,1,5,0,0,1,5,0,6,6,19,12,31
635,5632,14,27,25/9/2016,Vitoria,Sao Paulo,4,3,0,0,4,3,0,7,7,21,19,40
636,5633,14,27,25/9/2016,Corinthians,Fluminense,4,3,0,0,4,3,0,7,7,19,15,34
637,5634,14,27,25/9/2016,Flamengo,Cruzeiro,1,2,0,0,1,2,0,3,3,13,12,25
638,5635,14,27,25/9/2016,Gremio,Chapecoense,2,2,0,0,2,2,0,4,4,13,12,25
639,5636,14,27,25/9/2016,Atletico-MG,Internacional,2,2,0,0,2,2,0,4,4,11,17,28
640,5637,14,28,1/10/2016,Fluminense,Sport,1,3,0,0,1,3,0,4,4,11,30,41
641,5638,14,28,1/10/2016,Sao Paulo,Flamengo,4,3,0,0,4,3,0,7,7,18,9,27
642,5639,14,28,1/10/2016,Chapecoense,Vitoria,1,2,0,0,1,2,0,3,3,18,18,36
643,5640,14,28,1/10/2016,Santos,Athletico-PR,2,1,0,0,2,1,0,3,3,10,13,23
644,5641,14,28,1/10/2016,Botafogo-RJ,Corinthians,4,4,0,0,4,4,0,8,8,23,16,39
645,5642,14,28,1/10/2016,Ponte Preta,Atletico-MG,2,2,0,0,2,2,0,4,4,25,16,41
646,5643,14,28,1/10/2016,Cruzeiro,Gremio,3,3,0,0,3,3,0,6,6,19,20,39
647,5644,14,28,1/10/2016,Internacional,Figueirense,2,2,0,0,2,2,0,4,4,32,19,51
648,5645,14,28,3/10/2016,Santa Cruz,Palmeiras,6,3,0,0,6,3,0,9,9,20,12,32
649,5646,14,28,3/10/2016,Coritiba,America-MG,2,2,0,0,2,2,0,4,4,17,15,32
650,5647,14,29,5/10/2016,Athletico-PR,Chapecoense,2,3,0,0,2,3,0,5,5,9,14,23
651,5648,14,29,5/10/2016,Vitoria,Gremio,3,3,0,0,3,3,0,6,6,16,19,35
652,5649,14,29,5/10/2016,Corinthians,Atletico-MG,0,2,0,1,0,3,1,2,3,16,16,32
653,5651,14,29,5/10/2016,Sport,Sao Paulo,0,2,0,0,0,2,0,2,2,19,17,36
654,5652,14,29,6/10/2016,Internacional,Coritiba,2,4,0,0,2,4,0,6,6,15,14,29
655,5653,14,29,8/10/2016,Cruzeiro,Ponte Preta,2,2,0,0,2,2,0,4,4,15,25,40
656,5654,14,29,9/10/2016,Flamengo,Santa Cruz,1,1,0,1,1,2,1,2,3,11,12,23
657,5655,14,29,9/10/2016,America-MG,Palmeiras,2,1,1,0,3,1,1,3,4,17,10,27
658,5656,14,29,9/10/2016,Figueirense,Botafogo-RJ,2,2,0,0,2,2,0,4,4,14,13,27
659,5657,14,30,12/10/2016,Chapecoense,Sport,1,2,0,1,1,3,1,3,4,16,19,35
660,5658,14,30,12/10/2016,Coritiba,Figueirense,4,3,0,0,4,3,0,7,7,13,22,35
661,5659,14,30,12/10/2016,Santa Cruz,Corinthians,2,2,0,0,2,2,0,4,4,8,7,15
662,5660,14,30,12/10/2016,Botafogo-RJ,Internacional,3,2,0,0,3,2,0,5,5,17,15,32
663,5661,14,30,13/10/2016,Palmeiras,Cruzeiro,1,4,0,0,1,4,0,5,5,16,16,32
664,5662,14,30,13/10/2016,Ponte Preta,Vitoria,4,2,0,0,4,2,0,6,6,23,12,35
665,5664,14,30,13/10/2016,Fluminense,Flamengo,3,3,0,0,3,3,0,6,6,14,21,35
666,5665,14,30,13/10/2016,Sao Paulo,Santos,2,3,0,0,2,3,0,5,5,16,18,34
667,5666,14,30,13/10/2016,Gremio,Athletico-PR,2,3,0,0,2,3,0,5,5,16,13,29
668,5667,14,31,16/10/2016,Botafogo-RJ,Atletico-MG,2,4,0,0,2,4,0,6,6,16,13,29
669,5668,14,31,16/10/2016,Cruzeiro,Chapecoense,1,2,0,0,1,2,0,3,3,15,17,32
670,5669,14,31,16/10/2016,Athletico-PR,Coritiba,0,3,0,0,0,3,0,3,3,18,14,32
671,5670,14,31,16/10/2016,Internacional,Flamengo,3,1,0,0,3,1,0,4,4,22,13,35
672,5671,14,31,16/10/2016,Figueirense,Palmeiras,4,3,0,0,4,3,0,7,7,18,29,47
673,5672,14,31,16/10/2016,Corinthians,America-MG,2,1,0,0,2,1,0,3,3,11,10,21
674,5673,14,31,16/10/2016,Ponte Preta,Santa Cruz,0,2,0,0,0,2,0,2,2,19,17,36
675,5674,14,31,16/10/2016,Santos,Gremio,1,7,0,0,1,7,0,8,8,13,20,33
676,5675,14,31,16/10/2016,Sport,Vitoria,1,4,0,1,1,5,1,5,6,9,20,29
677,5676,14,31,17/10/2016,Fluminense,Sao Paulo,1,4,0,0,1,4,0,5,5,8,18,26
678,5677,14,32,19/10/2016,Santa Cruz,Botafogo-RJ,0,2,0,0,0,2,0,2,2,12,15,27
679,5678,14,32,22/10/2016,Sao Paulo,Ponte Preta,0,1,0,0,0,1,0,1,1,16,15,31
680,5679,14,32,23/10/2016,Flamengo,Corinthians,2,4,0,1,2,5,1,6,7,13,19,32
681,5680,14,32,23/10/2016,Vitoria,Cruzeiro,2,3,0,1,2,4,1,5,6,20,16,36
682,5681,14,32,23/10/2016,Palmeiras,Sport,3,2,0,0,3,2,0,5,5,26,23,49
683,5682,14,32,23/10/2016,Gremio,Internacional,0,2,1,1,1,3,2,2,4,12,25,37
684,5683,14,32,23/10/2016,Coritiba,Fluminense,0,4,1,0,1,4,1,4,5,12,17,29
685,5684,14,32,23/10/2016,Atletico-MG,Figueirense,2,4,0,2,2,6,2,6,8,16,15,31
686,5685,14,32,23/10/2016,Chapecoense,Santos,2,3,0,0,2,3,0,5,5,13,16,29
687,5687,14,33,27/10/2016,Sport,Ponte Preta,2,3,0,0,2,3,0,5,5,12,23,35
688,5688,14,33,28/10/2016,Fluminense,Vitoria,3,2,0,0,3,2,0,5,5,20,22,42
689,5689,14,33,29/10/2016,Atletico-MG,Flamengo,0,1,0,0,0,1,0,1,1,12,14,26
690,5690,14,33,29/10/2016,Athletico-PR,Cruzeiro,1,1,0,0,1,1,0,2,2,17,13,30
691,5691,14,33,29/10/2016,Corinthians,Chapecoense,1,2,0,0,1,2,0,3,3,11,18,29
692,5692,14,33,29/10/2016,Botafogo-RJ,Coritiba,5,3,0,0,5,3,0,8,8,13,20,33
693,5693,14,33,29/10/2016,Internacional,Santa Cruz,3,2,1,0,4,2,1,5,6,15,11,26
694,5694,14,33,29/10/2016,Figueirense,Gremio,2,2,0,0,2,2,0,4,4,22,18,40
695,5695,14,33,29/10/2016,Santos,Palmeiras,4,3,0,0,4,3,0,7,7,20,22,42
696,5696,14,33,31/10/2016,America-MG,Sao Paulo,0,1,0,0,0,1,0,1,1,17,8,25
697,5697,14,34,5/11/2016,Flamengo,Botafogo-RJ,3,3,0,0,3,3,0,6,6,14,26,40
698,5698,14,34,5/11/2016,Sao Paulo,Corinthians,3,4,0,0,3,4,0,7,7,21,19,40
699,5699,14,34,6/11/2016,Ponte Preta,Santos,1,1,0,0,1,1,0,2,2,20,19,39
700,5700,14,34,6/11/2016,Santa Cruz,America-MG,1,1,0,0,1,1,0,2,2,10,9,19
701,5701,14,34,6/11/2016,Cruzeiro,Fluminense,2,1,0,0,2,1,0,3,3,14,7,21
702,5703,14,34,6/11/2016,Vitoria,Athletico-PR,2,2,0,0,2,2,0,4,4,13,18,31
703,5704,14,34,6/11/2016,Coritiba,Atletico-MG,1,3,0,0,1,3,0,4,4,12,11,23
704,5705,14,34,6/11/2016,Chapecoense,Figueirense,1,3,0,1,1,4,1,4,5,16,20,36
705,5706,14,34,7/11/2016,Gremio,Sport,4,3,0,0,4,3,0,7,7,11,10,21
706,5707,14,35,15/11/2016,Fluminense,Athletico-PR,3,3,0,0,3,3,0,6,6,14,16,30
707,5708,14,35,16/11/2016,Botafogo-RJ,Chapecoense,3,1,0,0,3,1,0,4,4,15,18,33
708,5709,14,35,16/11/2016,Coritiba,Santa Cruz,3,2,0,0,3,2,0,5,5,18,13,31
709,5710,14,35,16/11/2016,Sport,Cruzeiro,2,2,0,0,2,2,0,4,4,10,11,21
710,5711,14,35,16/11/2016,America-MG,Flamengo,1,0,0,0,1,0,0,1,1,13,11,24
711,5712,14,35,16/11/2016,Figueirense,Corinthians,3,2,0,1,3,3,1,5,6,26,15,41
712,5713,14,35,17/11/2016,Santos,Vitoria,3,1,0,0,3,1,0,4,4,16,14,30
713,5714,14,35,17/11/2016,Sao Paulo,Gremio,3,2,0,0,3,2,0,5,5,15,17,32
714,5715,14,35,17/11/2016,Internacional,Ponte Preta,1,3,0,0,1,3,0,4,4,15,19,34
715,5716,14,35,17/11/2016,Atletico-MG,Palmeiras,2,4,0,0,2,4,0,6,6,18,27,45
716,5717,14,36,20/11/2016,Vitoria,Figueirense,4,2,0,0,4,2,0,6,6,20,16,36
717,5718,14,36,20/11/2016,Cruzeiro,Santos,3,3,1,0,4,3,1,6,7,11,11,22
718,5719,14,36,20/11/2016,Palmeiras,Botafogo-RJ,0,4,0,1,0,5,1,4,5,13,22,35
719,5720,14,36,20/11/2016,Athletico-PR,Sport,0,2,0,0,0,2,0,2,2,11,12,23
720,5721,14,36,20/11/2016,Gremio,America-MG,0,2,0,0,0,2,0,2,2,8,18,26
721,5722,14,36,20/11/2016,Ponte Preta,Fluminense,3,3,0,1,3,4,1,6,7,20,18,38
722,5723,14,36,20/11/2016,Flamengo,Coritiba,1,2,0,0,1,2,0,3,3,15,18,33
723,5724,14,36,20/11/2016,Chapecoense,Sao Paulo,1,1,0,0,1,1,0,2,2,20,19,39
724,5725,14,36,20/11/2016,Santa Cruz,Atletico-MG,3,0,1,1,4,1,2,3,5,16,10,26
725,5726,14,36,21/11/2016,Corinthians,Internacional,2,2,0,0,2,2,0,4,4,22,22,44
726,5727,14,37,26/11/2016,America-MG,Sport,1,3,1,0,2,3,1,4,5,13,15,28
727,5728,14,37,26/11/2016,Botafogo-RJ,Ponte Preta,5,4,0,1,5,5,1,9,10,19,17,36
728,5729,14,37,26/11/2016,Corinthians,Athletico-PR,3,2,0,0,3,2,0,5,5,6,9,15
729,5730,14,37,27/11/2016,Atletico-MG,Sao Paulo,1,6,0,0,1,6,0,7,7,18,15,33
730,5731,14,37,27/11/2016,Palmeiras,Chapecoense,1,2,0,0,1,2,0,3,3,25,24,49
731,5732,14,37,27/11/2016,Flamengo,Santos,1,0,0,0,1,0,0,1,1,20,14,34
732,5733,14,37,27/11/2016,Internacional,Cruzeiro,3,4,0,0,3,4,0,7,7,13,15,28
733,5734,14,37,27/11/2016,Figueirense,Fluminense,3,3,0,0,3,3,0,6,6,26,28,54
734,5735,14,37,27/11/2016,Santa Cruz,Gremio,3,4,0,0,3,4,0,7,7,12,16,28
735,5736,14,37,28/11/2016,Coritiba,Vitoria,5,6,0,0,5,6,0,11,11,23,19,42
736,5737,14,38,11/12/2016,Santos,America-MG,0,1,0,0,0,1,0,1,1,6,9,15
737,5738,14,38,11/12/2016,Fluminense,Internacional,1,1,0,0,1,1,0,2,2,19,23,42
738,5739,14,38,11/12/2016,Gremio,Botafogo-RJ,2,4,0,1,2,5,1,6,7,10,13,23
739,5740,14,38,11/12/2016,Sao Paulo,Santa Cruz,2,1,1,0,3,1,1,3,4,13,9,22
740,5741,14,38,11/12/2016,Cruzeiro,Corinthians,2,4,0,0,2,4,0,6,6,9,22,31
741,5742,14,38,11/12/2016,Sport,Figueirense,5,2,0,0,5,2,0,7,7,22,22,44
742,5743,14,38,11/12/2016,Athletico-PR,Flamengo,2,6,0,1,2,7,1,8,9,15,12,27
743,5744,14,38,11/12/2016,Vitoria,Palmeiras,1,6,0,0,1,6,0,7,7,15,16,31
744,5745,14,38,11/12/2016,Ponte Preta,Coritiba,0,1,0,0,0,1,0,1,1,14,15,29
745,5746,15,1,13/5/2017,Flamengo,Atletico-MG,2,3,0,0,2,3,0,5,5,7,10,17
746,5747,15,1,13/5/2017,Corinthians,Chapecoense,2,2,0,0,2,2,0,4,4,10,12,22
747,5748,15,1,14/5/2017,Fluminense,Santos,1,5,0,0,1,5,0,6,6,15,18,33
748,5749,15,1,14/5/2017,Cruzeiro,Sao Paulo,0,1,0,0,0,1,0,1,1,10,13,23
749,5750,15,1,14/5/2017,Bahia,Athletico-PR,0,1,0,1,0,2,1,1,2,11,11,22
750,5751,15,1,14/5/2017,Ponte Preta,Sport,0,2,0,0,0,2,0,2,2,13,17,30
751,5752,15,1,14/5/2017,Avai,Vitoria,0,2,0,0,0,2,0,2,2,6,15,21
752,5753,15,1,14/5/2017,Palmeiras,Vasco,0,2,0,0,0,2,0,2,2,19,16,35
753,5754,15,1,14/5/2017,Gremio,Botafogo-RJ,2,5,0,0,2,5,0,7,7,13,19,32
754,5755,15,1,15/5/2017,Coritiba,Atletico-GO,1,2,0,0,1,2,0,3,3,17,13,30
755,5756,15,2,20/5/2017,Santos,Coritiba,6,4,0,0,6,4,0,10,10,24,17,41
756,5757,15,2,20/5/2017,Atletico-GO,Flamengo,2,1,0,0,2,1,0,3,3,11,13,24
757,5758,15,2,20/5/2017,Chapecoense,Palmeiras,1,1,0,0,1,1,0,2,2,16,13,29
758,5759,15,2,21/5/2017,Vasco,Bahia,4,2,0,1,4,3,1,6,7,13,23,36
759,5760,15,2,21/5/2017,Athletico-PR,Gremio,2,4,0,1,2,5,1,6,7,11,16,27
760,5761,15,2,21/5/2017,Vitoria,Corinthians,0,1,0,0,0,1,0,1,1,13,6,19
761,5762,15,2,21/5/2017,Atletico-MG,Fluminense,0,6,0,0,0,6,0,6,6,18,23,41
762,5763,15,2,21/5/2017,Botafogo-RJ,Ponte Preta,1,0,0,0,1,0,0,1,1,15,12,27
763,5764,15,2,21/5/2017,Sport,Cruzeiro,3,3,0,0,3,3,0,6,6,20,14,34
764,5765,15,2,22/5/2017,Sao Paulo,Avai,1,2,0,0,1,2,0,3,3,16,10,26
765,5766,15,3,27/5/2017,Vasco,Fluminense,2,3,0,0,2,3,0,5,5,11,11,22
766,5767,15,3,27/5/2017,Sao Paulo,Palmeiras,3,1,0,0,3,1,0,4,4,13,16,29
767,5768,15,3,27/5/2017,Vitoria,Coritiba,3,3,0,0,3,3,0,6,6,19,16,35
768,5769,15,3,28/5/2017,Atletico-MG,Ponte Preta,2,2,0,0,2,2,0,4,4,16,14,30
769,5770,15,3,28/5/2017,Athletico-PR,Flamengo,1,0,0,0,1,0,0,1,1,10,12,22
770,5771,15,3,28/5/2017,Santos,Cruzeiro,2,3,0,0,2,3,0,5,5,8,14,22
771,5772,15,3,28/5/2017,Atletico-GO,Corinthians,2,0,0,0,2,0,0,2,2,23,11,34
772,5773,15,3,28/5/2017,Sport,Gremio,4,1,1,0,5,1,1,5,6,21,13,34
773,5774,15,3,28/5/2017,Botafogo-RJ,Bahia,1,1,0,0,1,1,0,2,2,20,18,38
774,5775,15,3,29/5/2017,Chapecoense,Avai,2,1,1,1,3,2,2,3,5,16,11,27
775,5776,15,4,3/6/2017,Coritiba,Athletico-PR,3,2,0,0,3,2,0,5,5,15,11,26
776,5777,15,4,3/6/2017,Fluminense,Vitoria,0,5,0,0,0,5,0,5,5,18,22,40
777,5778,15,4,3/6/2017,Corinthians,Santos,0,1,0,1,0,2,1,1,2,11,9,20
778,5779,15,4,4/6/2017,Flamengo,Botafogo-RJ,2,2,0,0,2,2,0,4,4,19,19,38
779,5780,15,4,4/6/2017,Avai,Sport,4,4,0,0,4,4,0,8,8,26,25,51
780,5781,15,4,4/6/2017,Palmeiras,Atletico-MG,2,4,0,0,2,4,0,6,6,20,12,32
781,5782,15,4,4/6/2017,Ponte Preta,Sao Paulo,2,5,0,0,2,5,0,7,7,13,12,25
782,5783,15,4,4/6/2017,Gremio,Vasco,2,3,0,0,2,3,0,5,5,15,13,28
783,5784,15,4,4/6/2017,Cruzeiro,Chapecoense,1,3,0,0,1,3,0,4,4,8,16,24
784,5785,15,4,5/6/2017,Bahia,Atletico-GO,0,2,0,0,0,2,0,2,2,21,27,48
785,5786,15,5,6/6/2017,Fluminense,Athletico-PR,3,3,0,0,3,3,0,6,6,19,16,35
786,5787,15,5,7/6/2017,Atletico-MG,Avai,3,1,0,0,3,1,0,4,4,20,10,30
787,5788,15,5,7/6/2017,Coritiba,Palmeiras,4,3,0,0,4,3,0,7,7,14,17,31
788,5789,15,5,7/6/2017,Santos,Botafogo-RJ,4,2,0,0,4,2,0,6,6,13,9,22
789,5790,15,5,7/6/2017,Vasco,Corinthians,0,3,0,0,0,3,0,3,3,10,14,24
790,5791,15,5,7/6/2017,Sport,Flamengo,2,2,0,0,2,2,0,4,4,17,16,33
791,5792,15,5,8/6/2017,Atletico-GO,Ponte Preta,1,2,0,1,1,3,1,3,4,20,9,29
792,5793,15,5,8/6/2017,Sao Paulo,Vitoria,1,1,0,0,1,1,0,2,2,14,18,32
793,5794,15,5,8/6/2017,Chapecoense,Gremio,4,3,0,0,4,3,0,7,7,22,9,31
794,5795,15,5,8/6/2017,Bahia,Cruzeiro,4,2,0,1,4,3,1,6,7,18,12,30
795,5796,15,6,10/6/2017,Palmeiras,Fluminense,4,2,0,0,4,2,0,6,6,24,19,43
796,5797,15,6,10/6/2017,Vasco,Sport,0,1,0,0,0,1,0,1,1,15,19,34
797,5798,15,6,11/6/2017,Botafogo-RJ,Coritiba,4,3,0,0,4,3,0,7,7,14,28,42
798,5799,15,6,11/6/2017,Ponte Preta,Chapecoense,2,4,0,0,2,4,0,6,6,8,22,30
799,5800,15,6,11/6/2017,Avai,Flamengo,2,1,1,0,3,1,1,3,4,17,18,35
800,5801,15,6,11/6/2017,Vitoria,Atletico-MG,3,2,0,0,3,2,0,5,5,20,7,27
801,5802,15,6,11/6/2017,Corinthians,Sao Paulo,1,1,0,0,1,1,0,2,2,11,15,26
802,5803,15,6,11/6/2017,Cruzeiro,Atletico-GO,3,4,0,0,3,4,0,7,7,11,21,32
803,5804,15,6,11/6/2017,Athletico-PR,Santos,1,1,0,1,1,2,1,2,3,15,12,27
804,5805,15,6,12/6/2017,Gremio,Bahia,0,1,0,0,0,1,0,1,1,15,16,31
805,5806,15,7,14/6/2017,Atletico-MG,Athletico-PR,2,5,0,1,2,6,1,7,8,11,10,21
806,5807,15,7,14/6/2017,Atletico-GO,Avai,3,6,0,0,3,6,0,9,9,21,24,45
807,5808,15,7,14/6/2017,Vitoria,Botafogo-RJ,1,1,1,0,2,1,1,2,3,12,10,22
808,5809,15,7,14/6/2017,Sport,Sao Paulo,1,1,0,0,1,1,0,2,2,21,14,35
809,5810,15,7,14/6/2017,Flamengo,Ponte Preta,2,2,0,0,2,2,0,4,4,12,16,28
810,5811,15,7,14/6/2017,Santos,Palmeiras,1,3,0,0,1,3,0,4,4,16,14,30
811,5812,15,7,14/6/2017,Chapecoense,Vasco,3,2,0,0,3,2,0,5,5,24,15,39
812,5813,15,7,14/6/2017,Corinthians,Cruzeiro,0,1,0,0,0,1,0,1,1,9,16,25
813,5814,15,7,15/6/2017,Coritiba,Bahia,1,4,1,1,2,5,2,5,7,16,14,30
814,5815,15,7,15/6/2017,Fluminense,Gremio,4,3,0,0,4,3,0,7,7,12,17,29
815,5816,15,8,17/6/2017,Atletico-GO,Athletico-PR,1,5,0,0,1,5,0,6,6,16,15,31
816,5817,15,8,17/6/2017,Vasco,Avai,4,1,0,0,4,1,0,5,5,20,22,42
817,5818,15,8,17/6/2017,Santos,Ponte Preta,3,4,0,0,3,4,0,7,7,17,13,30
818,5819,15,8,18/6/2017,Coritiba,Corinthians,2,3,0,0,2,3,0,5,5,18,13,31
819,5820,15,8,18/6/2017,Bahia,Palmeiras,2,5,0,0,2,5,0,7,7,14,23,37
820,5821,15,8,18/6/2017,Fluminense,Flamengo,1,6,0,0,1,6,0,7,7,16,25,41
821,5822,15,8,18/6/2017,Chapecoense,Botafogo-RJ,0,2,0,0,0,2,0,2,2,11,13,24
822,5823,15,8,18/6/2017,Sao Paulo,Atletico-MG,2,2,0,0,2,2,0,4,4,12,24,36
823,5825,15,8,19/6/2017,Cruzeiro,Gremio,5,2,0,0,5,2,0,7,7,12,14,26
824,5826,15,9,21/6/2017,Vitoria,Santos,2,1,0,0,2,1,0,3,3,15,10,25
825,5827,15,9,21/6/2017,Palmeiras,Atletico-GO,2,2,0,0,2,2,0,4,4,10,17,27
826,5828,15,9,21/6/2017,Botafogo-RJ,Vasco,5,1,0,0,5,1,0,6,6,20,11,31
827,5829,15,9,21/6/2017,Avai,Fluminense,1,1,0,0,1,1,0,2,2,19,20,39
828,5830,15,9,21/6/2017,Athletico-PR,Sao Paulo,3,3,0,0,3,3,0,6,6,17,15,32
829,5831,15,9,21/6/2017,Atletico-MG,Sport,2,1,0,0,2,1,0,3,3,23,26,49
830,5832,15,9,22/6/2017,Corinthians,Bahia,3,3,1,1,4,4,2,6,8,15,12,27
831,5833,15,9,22/6/2017,Ponte Preta,Cruzeiro,2,2,0,0,2,2,0,4,4,21,23,44
832,5834,15,9,22/6/2017,Gremio,Coritiba,2,0,0,0,2,0,0,2,2,18,11,29
833,5835,15,9,22/6/2017,Flamengo,Chapecoense,3,1,0,0,3,1,0,4,4,21,13,34
834,5836,15,10,24/6/2017,Santos,Sport,0,1,0,0,0,1,0,1,1,13,17,30
835,5837,15,10,25/6/2017,Vasco,Atletico-GO,2,0,0,0,2,0,0,2,2,21,19,40
836,5838,15,10,25/6/2017,Gremio,Corinthians,4,5,0,0,4,5,0,9,9,16,16,32
837,5839,15,10,25/6/2017,Sao Paulo,Fluminense,1,1,0,0,1,1,0,2,2,12,25,37
838,5840,15,10,25/6/2017,Athletico-PR,Vitoria,0,3,0,0,0,3,0,3,3,10,11,21
839,5841,15,10,25/6/2017,Cruzeiro,Coritiba,0,2,0,0,0,2,0,2,2,15,26,41
840,5842,15,10,25/6/2017,Ponte Preta,Palmeiras,6,3,2,1,8,4,3,9,12,21,28,49
841,5843,15,10,25/6/2017,Bahia,Flamengo,2,3,1,0,3,3,1,5,6,6,23,29
842,5844,15,10,25/6/2017,Chapecoense,Atletico-MG,5,5,0,0,5,5,0,10,10,24,19,43
843,5845,15,10,26/6/2017,Botafogo-RJ,Avai,1,2,0,0,1,2,0,3,3,11,10,21
844,5846,15,11,1/7/2017,Palmeiras,Gremio,3,1,0,0,3,1,0,4,4,23,14,37
845,5847,15,11,1/7/2017,Atletico-GO,Santos,3,1,1,0,4,1,1,4,5,14,10,24
846,5848,15,11,2/7/2017,Sport,Athletico-PR,1,3,0,0,1,3,0,4,4,12,18,30
847,5849,15,11,2/7/2017,Vitoria,Bahia,5,3,0,0,5,3,0,8,8,17,16,33
848,5850,15,11,2/7/2017,Atletico-MG,Cruzeiro,4,4,0,0,4,4,0,8,8,23,18,41
849,5851,15,11,2/7/2017,Flamengo,Sao Paulo,1,1,0,0,1,1,0,2,2,17,14,31
850,5852,15,11,2/7/2017,Corinthians,Botafogo-RJ,3,2,0,0,3,2,0,5,5,14,14,28
851,5853,15,11,2/7/2017,Avai,Ponte Preta,2,2,0,0,2,2,0,4,4,14,25,39
852,5854,15,11,2/7/2017,Coritiba,Vasco,3,5,0,0,3,5,0,8,8,17,20,37
853,5855,15,11,3/7/2017,Fluminense,Chapecoense,3,5,0,1,3,6,1,8,9,14,22,36
854,5856,15,12,8/7/2017,Atletico-GO,Vitoria,1,4,0,0,1,4,0,5,5,12,23,35
855,5857,15,12,8/7/2017,Vasco,Flamengo,4,1,0,0,4,1,0,5,5,23,15,38
856,5858,15,12,8/7/2017,Corinthians,Ponte Preta,2,2,0,0,2,2,0,4,4,17,8,25
857,5859,15,12,9/7/2017,Chapecoense,Athletico-PR,1,3,0,0,1,3,0,4,4,18,13,31
858,5860,15,12,9/7/2017,Bahia,Fluminense,4,2,0,0,4,2,0,6,6,16,18,34
859,5861,15,12,9/7/2017,Gremio,Avai,1,5,0,1,1,6,1,6,7,9,17,26
860,5862,15,12,9/7/2017,Cruzeiro,Palmeiras,1,4,0,0,1,4,0,5,5,12,15,27
861,5863,15,12,9/7/2017,Santos,Sao Paulo,4,3,0,0,4,3,0,7,7,18,5,23
862,5864,15,12,9/7/2017,Botafogo-RJ,Atletico-MG,1,3,0,0,1,3,0,4,4,14,27,41
863,5865,15,12,10/7/2017,Coritiba,Sport,2,2,1,0,3,2,1,4,5,16,18,34
864,5866,15,13,12/7/2017,Ponte Preta,Bahia,1,3,0,0,1,3,0,4,4,12,14,26
865,5867,15,13,12/7/2017,Atletico-MG,Santos,1,2,0,0,1,2,0,3,3,9,13,22
866,5868,15,13,12/7/2017,Fluminense,Botafogo-RJ,3,4,0,0,3,4,0,7,7,13,20,33
867,5869,15,13,12/7/2017,Palmeiras,Corinthians,3,4,0,0,3,4,0,7,7,16,14,30
868,5870,15,13,12/7/2017,Athletico-PR,Cruzeiro,3,1,0,0,3,1,0,4,4,16,9,25
869,5871,15,13,12/7/2017,Vitoria,Vasco,4,3,0,0,4,3,0,7,7,16,14,30
870,5872,15,13,13/7/2017,Sao Paulo,Atletico-GO,0,3,0,0,0,3,0,3,3,18,21,39
871,5873,15,13,13/7/2017,Sport,Chapecoense,2,8,0,0,2,8,0,10,10,9,26,35
872,5874,15,13,13/7/2017,Flamengo,Gremio,2,2,0,0,2,2,0,4,4,12,20,32
873,5875,15,13,13/7/2017,Avai,Coritiba,2,2,0,0,2,2,0,4,4,14,18,32
874,5877,15,14,16/7/2017,Palmeiras,Vitoria,2,3,0,0,2,3,0,5,5,21,19,40
875,5878,15,14,16/7/2017,Vasco,Santos,4,3,0,1,4,4,1,7,8,16,25,41
876,5879,15,14,16/7/2017,Atletico-GO,Atletico-MG,2,3,0,0,2,3,0,5,5,21,24,45
877,5880,15,14,16/7/2017,Chapecoense,Sao Paulo,4,2,0,0,4,2,0,6,6,22,14,36
878,5881,15,14,16/7/2017,Cruzeiro,Flamengo,3,1,0,0,3,1,0,4,4,16,14,30
879,5882,15,14,16/7/2017,Gremio,Ponte Preta,1,2,0,0,1,2,0,3,3,20,18,38
880,5883,15,14,16/7/2017,Bahia,Avai,2,0,0,0,2,0,0,2,2,18,12,30
881,5884,15,14,16/7/2017,Coritiba,Fluminense,4,4,0,0,4,4,0,8,8,19,18,37
882,5885,15,14,17/7/2017,Botafogo-RJ,Sport,4,3,0,0,4,3,0,7,7,14,16,30
883,5886,15,15,19/7/2017,Vitoria,Gremio,3,3,0,0,3,3,0,6,6,18,7,25
884,5887,15,15,19/7/2017,Santos,Chapecoense,5,2,0,0,5,2,0,7,7,13,17,30
885,5888,15,15,19/7/2017,Avai,Corinthians,2,3,0,0,2,3,0,5,5,18,10,28
886,5889,15,15,19/7/2017,Ponte Preta,Coritiba,1,0,0,0,1,0,0,1,1,12,12,24
887,5890,15,15,19/7/2017,Atletico-MG,Bahia,4,6,0,0,4,6,0,10,10,19,18,37
888,5891,15,15,19/7/2017,Sao Paulo,Vasco,3,3,0,0,3,3,0,6,6,26,20,46
889,5892,15,15,19/7/2017,Flamengo,Palmeiras,2,9,0,0,2,9,0,11,11,16,23,39
890,5893,15,15,20/7/2017,Fluminense,Cruzeiro,3,3,0,0,3,3,0,6,6,21,18,39
891,5894,15,15,20/7/2017,Sport,Atletico-GO,2,1,0,0,2,1,0,3,3,22,34,56
892,5895,15,15,20/7/2017,Athletico-PR,Botafogo-RJ,3,5,0,1,3,6,1,8,9,16,21,37
893,5896,15,16,22/7/2017,Vitoria,Chapecoense,2,5,0,0,2,5,0,7,7,13,19,32
894,5897,15,16,22/7/2017,Flamengo,Coritiba,1,6,0,0,1,6,0,7,7,20,24,44
895,5898,15,16,23/7/2017,Santos,Bahia,1,1,0,0,1,1,0,2,2,10,19,29
896,5899,15,16,23/7/2017,Avai,Cruzeiro,2,0,0,0,2,0,0,2,2,20,10,30
897,5900,15,16,23/7/2017,Sport,Palmeiras,3,4,0,0,3,4,0,7,7,21,31,52
898,5901,15,16,23/7/2017,Fluminense,Corinthians,2,2,0,0,2,2,0,4,4,15,13,28
899,5902,15,16,23/7/2017,Athletico-PR,Ponte Preta,2,2,0,0,2,2,0,4,4,25,19,44
900,5903,15,16,23/7/2017,Atletico-GO,Botafogo-RJ,1,4,0,0,1,4,0,5,5,12,20,32
901,5904,15,16,23/7/2017,Atletico-MG,Vasco,5,3,0,0,5,3,0,8,8,24,16,40
902,5905,15,16,24/7/2017,Sao Paulo,Gremio,1,3,0,0,1,3,0,4,4,17,14,31
903,5906,15,17,29/7/2017,Botafogo-RJ,Sao Paulo,0,1,0,0,0,1,0,1,1,9,11,20
904,5907,15,17,29/7/2017,Palmeiras,Avai,1,2,0,1,1,3,1,3,4,19,18,37
905,5908,15,17,30/7/2017,Chapecoense,Atletico-GO,1,1,0,0,1,1,0,2,2,21,19,40
906,5909,15,17,30/7/2017,Coritiba,Atletico-MG,4,4,0,0,4,4,0,8,8,18,25,43
907,5910,15,17,30/7/2017,Bahia,Sport,2,6,0,0,2,6,0,8,8,18,24,42
908,5911,15,17,30/7/2017,Corinthians,Flamengo,0,1,0,0,0,1,0,1,1,9,16,25
909,5912,15,17,30/7/2017,Gremio,Santos,4,5,1,0,5,5,1,9,10,14,17,31
910,5913,15,17,30/7/2017,Cruzeiro,Vitoria,4,4,0,0,4,4,0,8,8,15,23,38
911,5914,15,17,31/7/2017,Vasco,Athletico-PR,3,3,0,0,3,3,0,6,6,13,20,33
912,5915,15,17,9/8/2017,Ponte Preta,Fluminense,1,1,0,0,1,1,0,2,2,14,12,26
913,5916,15,18,2/8/2017,Sport,Fluminense,5,4,0,1,5,5,1,9,10,14,18,32
914,5917,15,18,2/8/2017,Chapecoense,Bahia,5,3,0,0,5,3,0,8,8,26,17,43
915,5918,15,18,2/8/2017,Atletico-MG,Corinthians,3,1,0,0,3,1,0,4,4,19,12,31
916,5919,15,18,2/8/2017,Vitoria,Ponte Preta,3,1,0,0,3,1,0,4,4,20,7,27
917,5920,15,18,2/8/2017,Santos,Flamengo,3,3,1,1,4,4,2,6,8,18,15,33
918,5921,15,18,2/8/2017,Atletico-GO,Gremio,4,2,0,0,4,2,0,6,6,20,21,41
919,5922,15,18,2/8/2017,Botafogo-RJ,Palmeiras,5,2,0,0,5,2,0,7,7,22,14,36
920,5923,15,18,3/8/2017,Athletico-PR,Avai,1,2,0,0,1,2,0,3,3,9,18,27
921,5924,15,18,3/8/2017,Sao Paulo,Coritiba,4,5,0,0,4,5,0,9,9,18,15,33
922,5925,15,18,3/8/2017,Vasco,Cruzeiro,4,1,0,0,4,1,0,5,5,12,18,30
923,5926,15,19,5/8/2017,Corinthians,Sport,1,2,0,0,1,2,0,3,3,2,10,12
924,5927,15,19,5/8/2017,Fluminense,Atletico-GO,1,3,0,0,1,3,0,4,4,13,12,25
925,5928,15,19,6/8/2017,Flamengo,Vitoria,4,2,0,0,4,2,0,6,6,15,21,36
926,5929,15,19,6/8/2017,Cruzeiro,Botafogo-RJ,3,3,0,0,3,3,0,6,6,16,15,31
927,5930,15,19,6/8/2017,Gremio,Atletico-MG,3,1,0,0,3,1,0,4,4,18,13,31
928,5932,15,19,6/8/2017,Palmeiras,Athletico-PR,1,3,0,0,1,3,0,4,4,10,22,32
929,5933,15,19,6/8/2017,Bahia,Sao Paulo,4,2,0,0,4,2,0,6,6,20,12,32
930,5934,15,19,6/8/2017,Avai,Santos,3,1,0,0,3,1,0,4,4,22,16,38
931,5935,15,19,6/8/2017,Ponte Preta,Vasco,1,4,0,0,1,4,0,5,5,17,16,33
932,5936,15,20,12/8/2017,Atletico-GO,Coritiba,2,3,0,0,2,3,0,5,5,27,20,47
933,5937,15,20,12/8/2017,Vitoria,Avai,1,3,0,0,1,3,0,4,4,14,11,25
934,5938,15,20,13/8/2017,Sao Paulo,Cruzeiro,5,4,1,2,6,6,3,9,12,19,18,37
935,5939,15,20,13/8/2017,Sport,Ponte Preta,1,1,0,0,1,1,0,2,2,14,10,24
936,5940,15,20,13/8/2017,Atletico-MG,Flamengo,4,2,0,1,4,3,1,6,7,22,17,39
937,5941,15,20,13/8/2017,Vasco,Palmeiras,1,2,0,0,1,2,0,3,3,17,13,30
938,5942,15,20,13/8/2017,Athletico-PR,Bahia,2,4,0,0,2,4,0,6,6,13,15,28
939,5943,15,20,13/8/2017,Botafogo-RJ,Gremio,3,1,0,0,3,1,0,4,4,18,15,33
940,5944,15,20,14/8/2017,Santos,Fluminense,2,2,0,0,2,2,0,4,4,7,10,17
941,5945,15,20,23/8/2017,Chapecoense,Corinthians,1,4,0,0,1,4,0,5,5,13,7,20
942,5946,15,21,19/8/2017,Corinthians,Vitoria,1,2,0,0,1,2,0,3,3,9,21,30
943,5947,15,21,19/8/2017,Flamengo,Atletico-GO,2,3,0,0,2,3,0,5,5,12,13,25
944,5948,15,21,20/8/2017,Gremio,Athletico-PR,2,2,0,0,2,2,0,4,4,11,26,37
945,5949,15,21,20/8/2017,Avai,Sao Paulo,1,3,0,0,1,3,0,4,4,17,16,33
946,5950,15,21,20/8/2017,Bahia,Vasco,0,4,0,0,0,4,0,4,4,18,18,36
947,5951,15,21,20/8/2017,Cruzeiro,Sport,1,0,0,0,1,0,0,1,1,11,12,23
948,5952,15,21,20/8/2017,Ponte Preta,Botafogo-RJ,4,4,0,0,4,4,0,8,8,18,18,36
949,5953,15,21,20/8/2017,Coritiba,Santos,3,1,0,0,3,1,0,4,4,13,7,20
950,5954,15,21,20/8/2017,Palmeiras,Chapecoense,1,4,0,0,1,4,0,5,5,11,24,35
951,5955,15,21,21/8/2017,Fluminense,Atletico-MG,1,2,0,0,1,2,0,3,3,0,0,0
952,5956,15,22,26/8/2017,Fluminense,Vasco,2,4,0,0,2,4,0,6,6,14,12,26
953,5957,15,22,26/8/2017,Corinthians,Atletico-GO,1,5,0,0,1,5,0,6,6,15,17,32
954,5958,15,22,27/8/2017,Ponte Preta,Atletico-MG,4,4,0,0,4,4,0,8,8,20,19,39
955,5959,15,22,27/8/2017,Palmeiras,Sao Paulo,1,2,0,0,1,2,0,3,3,12,8,20
956,5960,15,22,27/8/2017,Bahia,Botafogo-RJ,2,0,0,0,2,0,0,2,2,14,9,23
957,5961,15,22,27/8/2017,Flamengo,Athletico-PR,0,2,0,0,0,2,0,2,2,6,11,17
958,5962,15,22,27/8/2017,Cruzeiro,Santos,0,2,0,0,0,2,0,2,2,13,18,31
959,5963,15,22,27/8/2017,Avai,Chapecoense,4,5,0,0,4,5,0,9,9,18,22,40
960,5964,15,22,28/8/2017,Coritiba,Vitoria,2,2,2,1,4,3,3,4,7,18,22,40
961,5965,15,22,2/9/2017,Gremio,Sport,1,5,0,0,1,5,0,6,6,8,21,29
962,5966,15,23,9/9/2017,Atletico-MG,Palmeiras,3,3,0,2,3,5,2,6,8,14,18,32
963,5967,15,23,9/9/2017,Vasco,Gremio,3,0,0,0,3,0,0,3,3,18,11,29
964,5968,15,23,9/9/2017,Sao Paulo,Ponte Preta,2,1,1,0,3,1,1,3,4,12,9,21
965,5969,15,23,10/9/2017,Athletico-PR,Coritiba,1,3,0,1,1,4,1,4,5,16,15,31
966,5970,15,23,10/9/2017,Santos,Corinthians,3,5,0,0,3,5,0,8,8,9,17,26
967,5971,15,23,10/9/2017,Sport,Avai,4,5,0,0,4,5,0,9,9,13,17,30
968,5972,15,23,10/9/2017,Vitoria,Fluminense,1,3,0,1,1,4,1,4,5,9,11,20
969,5973,15,23,10/9/2017,Chapecoense,Cruzeiro,2,1,0,0,2,1,0,3,3,15,17,32
970,5975,15,23,11/9/2017,Atletico-GO,Bahia,1,2,0,0,1,2,0,3,3,16,11,27
971,5976,15,24,16/9/2017,Botafogo-RJ,Santos,2,2,0,0,2,2,0,4,4,14,12,26
972,5977,15,24,16/9/2017,Ponte Preta,Atletico-GO,2,2,0,0,2,2,0,4,4,22,20,42
973,5978,15,24,17/9/2017,Avai,Atletico-MG,2,3,0,1,2,4,1,5,6,17,16,33
974,5979,15,24,17/9/2017,Gremio,Chapecoense,1,5,0,0,1,5,0,6,6,6,19,25
975,5980,15,24,17/9/2017,Corinthians,Vasco,1,2,0,0,1,2,0,3,3,15,9,24
976,5981,15,24,17/9/2017,Athletico-PR,Fluminense,3,3,0,0,3,3,0,6,6,15,13,28
977,5982,15,24,17/9/2017,Vitoria,Sao Paulo,3,2,0,0,3,2,0,5,5,21,16,37
978,5983,15,24,17/9/2017,Flamengo,Sport,0,3,0,1,0,4,1,3,4,13,18,31
979,5984,15,24,17/9/2017,Cruzeiro,Bahia,5,1,1,0,6,1,1,6,7,12,19,31
980,5985,15,24,18/9/2017,Palmeiras,Coritiba,3,3,0,0,3,3,0,6,6,18,17,35
981,5986,15,25,23/9/2017,Flamengo,Avai,2,0,0,0,2,0,0,2,2,14,16,30
982,5987,15,25,23/9/2017,Santos,Athletico-PR,1,1,0,0,1,1,0,2,2,7,14,21
983,5988,15,25,24/9/2017,Sao Paulo,Corinthians,2,4,0,0,2,4,0,6,6,13,12,25
984,5989,15,25,24/9/2017,Chapecoense,Ponte Preta,4,3,0,0,4,3,0,7,7,16,19,35
985,5990,15,25,24/9/2017,Coritiba,Botafogo-RJ,2,3,0,0,2,3,0,5,5,20,19,39
986,5991,15,25,24/9/2017,Atletico-GO,Cruzeiro,4,2,0,0,4,2,0,6,6,16,18,34
987,5992,15,25,24/9/2017,Fluminense,Palmeiras,2,2,0,0,2,2,0,4,4,26,9,35
988,5993,15,25,24/9/2017,Atletico-MG,Vitoria,1,2,0,0,1,2,0,3,3,10,21,31
989,5994,15,25,24/9/2017,Bahia,Gremio,4,5,0,0,4,5,0,9,9,18,17,35
990,5995,15,25,25/9/2017,Sport,Vasco,1,4,1,0,2,4,1,5,6,13,16,29
991,5996,15,26,30/9/2017,Vasco,Chapecoense,3,0,0,0,3,0,0,3,3,15,22,37
992,5997,15,26,30/9/2017,Bahia,Coritiba,4,5,0,0,4,5,0,9,9,13,18,31
993,5998,15,26,30/9/2017,Palmeiras,Santos,3,5,0,0,3,5,0,8,8,18,22,40
994,5999,15,26,1/10/2017,Cruzeiro,Corinthians,3,4,0,0,3,4,0,7,7,15,14,29
995,6000,15,26,1/10/2017,Botafogo-RJ,Vitoria,2,2,1,0,3,2,1,4,5,11,21,32
996,6001,15,26,1/10/2017,Sao Paulo,Sport,0,2,0,0,0,2,0,2,2,12,15,27
997,6002,15,26,1/10/2017,Gremio,Fluminense,1,2,0,0,1,2,0,3,3,12,18,30
998,6003,15,26,1/10/2017,Avai,Atletico-GO,2,2,0,0,2,2,0,4,4,14,24,38
999,6004,15,26,1/10/2017,Athletico-PR,Atletico-MG,1,4,0,0,1,4,0,5,5,17,16,33
1000,6005,15,26,2/10/2017,Ponte Preta,Flamengo,5,3,1,0,6,3,1,8,9,23,17,40
1001,6006,15,28,7/10/2017,Cruzeiro,Ponte Preta,5,1,0,1,5,2,1,6,7,8,12,20
1002,6007,15,28,14/10/2017,Vasco,Botafogo-RJ,5,3,0,0,5,3,0,8,8,16,13,29
1003,6008,15,28,14/10/2017,Sao Paulo,Athletico-PR,1,2,0,1,1,3,1,3,4,6,12,18
1004,6009,15,28,15/10/2017,Chapecoense,Flamengo,2,2,0,0,2,2,0,4,4,23,17,40
1005,6010,15,28,15/10/2017,Atletico-GO,Palmeiras,2,1,1,0,3,1,1,3,4,18,13,31
1006,6011,15,28,15/10/2017,Fluminense,Avai,2,2,0,0,2,2,0,4,4,18,12,30
1007,6012,15,28,15/10/2017,Sport,Atletico-MG,2,2,0,0,2,2,0,4,4,19,14,33
1008,6013,15,28,15/10/2017,Coritiba,Gremio,4,3,0,0,4,3,0,7,7,14,16,30
1009,6014,15,28,15/10/2017,Bahia,Corinthians,0,2,0,0,0,2,0,2,2,11,16,27
1010,6015,15,28,16/10/2017,Santos,Vitoria,2,4,0,0,2,4,0,6,6,12,15,27
1011,6016,15,27,11/10/2017,Athletico-PR,Atletico-GO,3,2,0,0,3,2,0,5,5,15,17,32
1012,6017,15,27,11/10/2017,Botafogo-RJ,Chapecoense,1,3,0,0,1,3,0,4,4,12,20,32
1013,6018,15,27,11/10/2017,Corinthians,Coritiba,1,3,0,0,1,3,0,4,4,8,16,24
1014,6020,15,27,11/10/2017,Avai,Vasco,5,3,1,1,6,4,2,8,10,23,28,51
1015,6021,15,27,11/10/2017,Atletico-MG,Sao Paulo,1,3,0,0,1,3,0,4,4,16,12,28
1016,6022,15,27,12/10/2017,Vitoria,Sport,2,3,1,0,3,3,1,5,6,18,13,31
1017,6023,15,27,12/10/2017,Flamengo,Fluminense,2,4,0,0,2,4,0,6,6,17,16,33
1018,6024,15,27,12/10/2017,Ponte Preta,Santos,3,2,1,0,4,2,1,5,6,20,11,31
1019,6025,15,27,12/10/2017,Palmeiras,Bahia,1,2,0,0,1,2,0,3,3,23,24,47
1020,6026,15,29,18/10/2017,Atletico-GO,Vasco,2,2,1,0,3,2,1,4,5,23,10,33
1021,6027,15,29,18/10/2017,Coritiba,Cruzeiro,1,1,0,0,1,1,0,2,2,7,9,16
1022,6028,15,29,18/10/2017,Atletico-MG,Chapecoense,2,3,1,0,3,3,1,5,6,16,15,31
1023,6029,15,29,18/10/2017,Avai,Botafogo-RJ,2,4,0,0,2,4,0,6,6,20,22,42
1024,6030,15,29,18/10/2017,Fluminense,Sao Paulo,2,0,0,0,2,0,0,2,2,23,12,35
1025,6031,15,29,18/10/2017,Corinthians,Gremio,1,1,0,0,1,1,0,2,2,13,14,27
1026,6032,15,29,19/10/2017,Vitoria,Athletico-PR,0,3,0,0,0,3,0,3,3,11,12,23
1027,6033,15,29,19/10/2017,Palmeiras,Ponte Preta,0,4,0,0,0,4,0,4,4,14,18,32
1028,6034,15,29,19/10/2017,Flamengo,Bahia,5,4,0,0,5,4,0,9,9,23,11,34
1029,6035,15,29,19/10/2017,Sport,Santos,1,5,0,0,1,5,0,6,6,17,23,40
1030,6036,15,30,21/10/2017,Vasco,Coritiba,1,2,1,0,2,2,1,3,4,10,15,25
1031,6037,15,30,22/10/2017,Santos,Atletico-GO,1,1,0,0,1,1,0,2,2,15,14,29
1032,6038,15,30,22/10/2017,Bahia,Vitoria,2,3,0,0,2,3,0,5,5,12,17,29
1033,6039,15,30,22/10/2017,Gremio,Palmeiras,2,1,0,0,2,1,0,3,3,17,19,36
1034,6040,15,30,22/10/2017,Sao Paulo,Flamengo,1,1,0,0,1,1,0,2,2,14,12,26
1035,6041,15,30,22/10/2017,Athletico-PR,Sport,0,2,0,0,0,2,0,2,2,15,13,28
1036,6042,15,30,22/10/2017,Cruzeiro,Atletico-MG,2,4,0,0,2,4,0,6,6,23,14,37
1037,6043,15,30,22/10/2017,Chapecoense,Fluminense,1,1,0,0,1,1,0,2,2,22,12,34
1038,6044,15,30,22/10/2017,Ponte Preta,Avai,5,2,0,0,5,2,0,7,7,19,19,38
1039,6045,15,30,23/10/2017,Botafogo-RJ,Corinthians,3,2,0,0,3,2,0,5,5,19,14,33
1040,6046,15,31,28/10/2017,Sao Paulo,Santos,1,6,0,0,1,6,0,7,7,12,31,43
1041,6047,15,31,28/10/2017,Flamengo,Vasco,1,1,0,0,1,1,0,2,2,16,12,28
1042,6048,15,31,28/10/2017,Athletico-PR,Chapecoense,1,4,0,0,1,4,0,5,5,6,20,26
1043,6049,15,31,29/10/2017,Ponte Preta,Corinthians,4,1,0,0,4,1,0,5,5,19,12,31
1044,6050,15,31,29/10/2017,Fluminense,Bahia,1,3,0,1,1,4,1,4,5,19,17,36
1045,6051,15,31,29/10/2017,Atletico-MG,Botafogo-RJ,1,2,0,0,1,2,0,3,3,21,16,37
1046,6052,15,31,29/10/2017,Vitoria,Atletico-GO,1,3,0,0,1,3,0,4,4,19,18,37
1047,6053,15,31,29/10/2017,Sport,Coritiba,3,6,0,0,3,6,0,9,9,21,21,42
1048,6054,15,31,29/10/2017,Avai,Gremio,1,2,0,0,1,2,0,3,3,13,19,32
1049,6055,15,31,30/10/2017,Palmeiras,Cruzeiro,0,2,0,0,0,2,0,2,2,9,9,18
1050,6056,15,32,4/11/2017,Santos,Atletico-MG,1,3,0,0,1,3,0,4,4,12,18,30
1051,6057,15,32,4/11/2017,Botafogo-RJ,Fluminense,3,4,0,0,3,4,0,7,7,16,16,32
1052,6058,15,32,4/11/2017,Atletico-GO,Sao Paulo,2,0,0,0,2,0,0,2,2,17,9,26
1053,6059,15,32,4/11/2017,Coritiba,Avai,1,2,0,0,1,2,0,3,3,15,6,21
1054,6060,15,32,5/11/2017,Corinthians,Palmeiras,6,5,0,1,6,6,1,11,12,21,11,32
1055,6061,15,32,5/11/2017,Cruzeiro,Athletico-PR,1,2,0,0,1,2,0,3,3,9,13,22
1056,6063,15,32,5/11/2017,Bahia,Ponte Preta,1,2,0,0,1,2,0,3,3,16,18,34
1057,6064,15,32,5/11/2017,Vasco,Vitoria,3,4,0,0,3,4,0,7,7,17,23,40
1058,6065,15,32,5/11/2017,Chapecoense,Sport,3,3,0,1,3,4,1,6,7,21,16,37
1059,6066,15,33,8/11/2017,Ponte Preta,Gremio,4,3,1,0,5,3,1,7,8,19,14,33
1060,6067,15,33,8/11/2017,Avai,Bahia,2,2,0,0,2,2,0,4,4,18,25,43
1061,6068,15,33,8/11/2017,Sport,Botafogo-RJ,2,4,0,0,2,4,0,6,6,13,20,33
1062,6069,15,33,8/11/2017,Athletico-PR,Corinthians,2,1,0,0,2,1,0,3,3,11,11,22
1063,6070,15,33,8/11/2017,Santos,Vasco,2,5,0,0,2,5,0,7,7,14,14,28
1064,6071,15,33,8/11/2017,Flamengo,Cruzeiro,2,3,0,0,2,3,0,5,5,17,10,27
1065,6072,15,33,8/11/2017,Vitoria,Palmeiras,4,1,1,0,5,1,1,5,6,20,10,30
1066,6073,15,33,9/11/2017,Sao Paulo,Chapecoense,1,2,0,0,1,2,0,3,3,8,14,22
1067,6074,15,33,9/11/2017,Atletico-MG,Atletico-GO,6,5,0,0,6,5,0,11,11,19,13,32
1068,6075,15,33,9/11/2017,Fluminense,Coritiba,3,4,0,0,3,4,0,7,7,11,20,31
1069,6076,15,34,11/11/2017,Botafogo-RJ,Athletico-PR,0,1,0,0,0,1,0,1,1,13,14,27
1070,6077,15,34,11/11/2017,Corinthians,Avai,3,3,0,0,3,3,0,6,6,15,12,27
1071,6078,15,34,12/11/2017,Vasco,Sao Paulo,2,2,0,1,2,3,1,4,5,15,15,30
1072,6079,15,34,12/11/2017,Palmeiras,Flamengo,0,1,0,0,0,1,0,1,1,12,18,30
1073,6080,15,34,12/11/2017,Atletico-GO,Sport,0,3,0,0,0,3,0,3,3,20,15,35
1074,6081,15,34,12/11/2017,Gremio,Vitoria,0,2,0,1,0,3,1,2,3,14,16,30
1075,6082,15,34,12/11/2017,Bahia,Atletico-MG,1,4,0,0,1,4,0,5,5,12,13,25
1076,6083,15,34,12/11/2017,Cruzeiro,Fluminense,4,3,0,1,4,4,1,7,8,13,8,21
1077,6084,15,34,12/11/2017,Coritiba,Ponte Preta,2,2,0,0,2,2,0,4,4,17,15,32
1078,6085,15,34,13/11/2017,Chapecoense,Santos,0,3,0,0,0,3,0,3,3,10,16,26
1079,6086,15,35,15/11/2017,Ponte Preta,Athletico-PR,1,3,0,0,1,3,0,4,4,12,10,22
1080,6087,15,35,15/11/2017,Cruzeiro,Avai,4,2,0,0,4,2,0,6,6,10,9,19
1081,6088,15,35,15/11/2017,Gremio,Sao Paulo,1,3,0,0,1,3,0,4,4,16,12,28
1082,6089,15,35,15/11/2017,Vasco,Atletico-MG,1,0,0,0,1,0,0,1,1,12,17,29
1083,6090,15,35,15/11/2017,Corinthians,Fluminense,1,6,0,0,1,6,0,7,7,12,26,38
1084,6091,15,35,16/11/2017,Botafogo-RJ,Atletico-GO,1,3,0,0,1,3,0,4,4,12,17,29
1085,6092,15,35,16/11/2017,Chapecoense,Vitoria,1,4,0,0,1,4,0,5,5,17,18,35
1086,6093,15,35,16/11/2017,Palmeiras,Sport,0,2,0,0,0,2,0,2,2,7,15,22
1087,6094,15,35,16/11/2017,Coritiba,Flamengo,3,5,0,0,3,5,0,8,8,20,12,32
1088,6095,15,35,16/11/2017,Bahia,Santos,3,2,0,0,3,2,0,5,5,17,16,33
1089,6096,15,36,19/11/2017,Sport,Bahia,4,3,0,0,4,3,0,7,7,21,16,37
1090,6097,15,36,19/11/2017,Flamengo,Corinthians,4,4,0,0,4,4,0,8,8,20,16,36
1091,6098,15,36,19/11/2017,Vitoria,Cruzeiro,3,2,0,0,3,2,0,5,5,20,7,27
1092,6099,15,36,19/11/2017,Atletico-GO,Chapecoense,4,4,0,0,4,4,0,8,8,12,23,35
1093,6100,15,36,19/11/2017,Sao Paulo,Botafogo-RJ,2,3,0,0,2,3,0,5,5,13,17,30
1094,6101,15,36,19/11/2017,Athletico-PR,Vasco,1,2,0,0,1,2,0,3,3,8,8,16
1095,6102,15,36,19/11/2017,Atletico-MG,Coritiba,2,5,0,0,2,5,0,7,7,10,15,25
1096,6103,15,36,19/11/2017,Santos,Gremio,2,2,0,0,2,2,0,4,4,22,14,36
1097,6104,15,36,20/11/2017,Fluminense,Ponte Preta,2,2,0,1,2,3,1,4,5,16,15,31
1098,6105,15,36,20/11/2017,Avai,Palmeiras,2,2,0,0,2,2,0,4,4,9,10,19
1099,6106,15,37,25/11/2017,Fluminense,Sport,4,2,0,0,4,2,0,6,6,9,19,28
1100,6107,15,37,26/11/2017,Avai,Athletico-PR,3,1,0,0,3,1,0,4,4,19,15,34
1101,6108,15,37,26/11/2017,Corinthians,Atletico-MG,4,1,0,0,4,1,0,5,5,15,10,25
1102,6109,15,37,26/11/2017,Ponte Preta,Vitoria,3,6,1,0,4,6,1,9,10,11,19,30
1103,6110,15,37,26/11/2017,Coritiba,Sao Paulo,4,1,0,0,4,1,0,5,5,16,12,28
1104,6111,15,37,26/11/2017,Cruzeiro,Vasco,3,2,0,0,3,2,0,5,5,16,20,36
1105,6112,15,37,26/11/2017,Gremio,Atletico-GO,2,3,0,0,2,3,0,5,5,14,16,30
1106,6113,15,37,26/11/2017,Flamengo,Santos,3,4,0,0,3,4,0,7,7,14,17,31
1107,6114,15,37,26/11/2017,Bahia,Chapecoense,5,3,1,0,6,3,1,8,9,16,21,37
1108,6115,15,37,27/11/2017,Palmeiras,Botafogo-RJ,3,4,0,0,3,4,0,7,7,19,17,36
1109,6116,15,38,3/12/2017,Atletico-MG,Gremio,7,1,1,0,8,1,1,8,9,17,20,37
1110,6117,15,38,3/12/2017,Botafogo-RJ,Cruzeiro,1,5,0,1,1,6,1,6,7,13,28,41
1111,6118,15,38,3/12/2017,Santos,Avai,2,1,0,0,2,1,0,3,3,17,11,28
1112,6119,15,38,3/12/2017,Sport,Corinthians,3,2,0,0,3,2,0,5,5,19,18,37
1113,6120,15,38,3/12/2017,Vitoria,Flamengo,3,3,2,0,5,3,2,6,8,17,13,30
1114,6121,15,38,3/12/2017,Atletico-GO,Fluminense,1,4,0,0,1,4,0,5,5,16,18,34
1115,6122,15,38,3/12/2017,Sao Paulo,Bahia,4,4,1,1,5,5,2,8,10,20,29,49
1116,6123,15,38,3/12/2017,Chapecoense,Coritiba,3,2,0,0,3,2,0,5,5,18,11,29
1117,6124,15,38,3/12/2017,Vasco,Ponte Preta,5,5,0,0,5,5,0,10,10,18,16,34
1118,6125,15,38,3/12/2017,Athletico-PR,Palmeiras,3,5,0,0,3,5,0,8,8,16,14,30
1119,6126,16,1,14/4/2018,Cruzeiro,Gremio,3,1,0,1,3,2,1,4,5,20,15,35
1120,6127,16,1,14/4/2018,Vitoria,Flamengo,3,2,0,1,3,3,1,5,6,24,10,34
1121,6128,16,1,14/4/2018,Santos,Ceara,0,1,0,0,0,1,0,1,1,7,5,12
1122,6129,16,1,15/4/2018,America-MG,Sport,1,3,0,0,1,3,0,4,4,11,12,23
1123,6130,16,1,15/4/2018,Vasco,Atletico-MG,4,3,0,0,4,3,0,7,7,11,18,29
1124,6131,16,1,15/4/2018,Internacional,Bahia,2,0,0,0,2,0,0,2,2,16,18,34
1125,6133,16,1,15/4/2018,Athletico-PR,Chapecoense,1,3,0,0,1,3,0,4,4,10,16,26
1126,6134,16,1,16/4/2018,Sao Paulo,Parana,4,2,0,0,4,2,0,6,6,20,15,35
1127,6135,16,1,16/4/2018,Botafogo-RJ,Palmeiras,1,4,0,0,1,4,0,5,5,7,23,30
1128,6136,16,2,21/4/2018,Bahia,Santos,4,3,0,0,4,3,0,7,7,29,21,50
1129,6137,16,2,21/4/2018,Flamengo,America-MG,1,1,0,0,1,1,0,2,2,15,17,32
1130,6138,16,2,22/4/2018,Parana,Corinthians,1,1,0,0,1,1,0,2,2,16,16,32
1131,6139,16,2,22/4/2018,Ceara,Sao Paulo,1,1,0,0,1,1,0,2,2,12,7,19
1132,6140,16,2,22/4/2018,Atletico-MG,Vitoria,2,4,0,0,2,4,0,6,6,22,19,41
1133,6141,16,2,22/4/2018,Fluminense,Cruzeiro,3,2,1,0,4,2,1,5,6,13,19,32
1134,6142,16,2,22/4/2018,Chapecoense,Vasco,1,2,0,0,1,2,0,3,3,13,8,21
1135,6143,16,2,22/4/2018,Palmeiras,Internacional,2,2,0,0,2,2,0,4,4,14,15,29
1136,6144,16,2,22/4/2018,Gremio,Athletico-PR,3,3,0,1,3,4,1,6,7,9,15,24
1137,6145,16,2,23/4/2018,Sport,Botafogo-RJ,1,3,0,0,1,3,0,4,4,14,15,29
1138,6146,16,3,28/4/2018,Botafogo-RJ,Gremio,1,1,0,0,1,1,0,2,2,14,12,26
1139,6147,16,3,29/4/2018,Bahia,Athletico-PR,2,2,0,0,2,2,0,4,4,22,12,34
1140,6148,16,3,29/4/2018,Ceara,Flamengo,1,2,0,0,1,2,0,3,3,18,12,30
1141,6149,16,3,29/4/2018,Palmeiras,Chapecoense,4,6,0,0,4,6,0,10,10,17,17,34
1142,6150,16,3,29/4/2018,Parana,Sport,1,1,0,0,1,1,0,2,2,14,15,29
1143,6151,16,3,29/4/2018,Atletico-MG,Corinthians,4,3,0,0,4,3,0,7,7,25,15,40
1144,6152,16,3,29/4/2018,Fluminense,Sao Paulo,3,2,0,0,3,2,0,5,5,17,16,33
1145,6153,16,3,29/4/2018,Internacional,Cruzeiro,4,3,0,0,4,3,0,7,7,15,14,29
1146,6154,16,3,30/4/2018,America-MG,Vitoria,2,2,1,0,3,2,1,4,5,14,12,26
1147,6155,16,3,27/9/2018,Santos,Vasco,1,3,0,1,1,4,1,4,5,11,17,28
1148,6156,16,4,5/5/2018,Vasco,America-MG,4,4,0,0,4,4,0,8,8,14,24,38
1149,6157,16,4,5/5/2018,Sao Paulo,Atletico-MG,4,4,0,0,4,4,0,8,8,17,14,31
1150,6158,16,4,6/5/2018,Corinthians,Ceara,2,4,0,0,2,4,0,6,6,12,20,32
1151,6159,16,4,6/5/2018,Flamengo,Internacional,5,4,0,1,5,5,1,9,10,12,15,27
1152,6160,16,4,6/5/2018,Cruzeiro,Botafogo-RJ,1,4,0,0,1,4,0,5,5,19,12,31
1153,6161,16,4,6/5/2018,Athletico-PR,Palmeiras,1,2,0,0,1,2,0,3,3,10,15,25
1154,6162,16,4,6/5/2018,Vitoria,Fluminense,2,1,0,0,2,1,0,3,3,18,7,25
1155,6163,16,4,6/5/2018,Gremio,Santos,1,3,0,0,1,3,0,4,4,15,22,37
1156,6164,16,4,6/5/2018,Sport,Bahia,1,2,0,1,1,3,1,3,4,18,21,39
1157,6165,16,4,7/5/2018,Chapecoense,Parana,1,2,0,1,1,3,1,3,4,10,16,26
1158,6166,16,5,12/5/2018,Gremio,Internacional,3,4,0,0,3,4,0,7,7,13,24,37
1159,6167,16,5,13/5/2018,Cruzeiro,Sport,2,3,0,0,2,3,0,5,5,18,16,34
1160,6168,16,5,13/5/2018,Athletico-PR,Atletico-MG,2,2,0,0,2,2,0,4,4,15,16,31
1161,6169,16,5,13/5/2018,Vasco,Vitoria,2,3,0,0,2,3,0,5,5,16,19,35
1162,6170,16,5,13/5/2018,Corinthians,Palmeiras,2,3,0,0,2,3,0,5,5,15,21,36
1163,6171,16,5,13/5/2018,Bahia,Sao Paulo,5,3,0,0,5,3,0,8,8,20,14,34
1164,6172,16,5,13/5/2018,Chapecoense,Flamengo,2,3,0,0,2,3,0,5,5,18,17,35
1165,6173,16,5,13/5/2018,Santos,Parana,1,2,0,0,1,2,0,3,3,12,14,26
1166,6174,16,5,14/5/2018,Botafogo-RJ,Fluminense,2,2,0,0,2,2,0,4,4,12,12,24
1167,6175,16,5,14/5/2018,Ceara,America-MG,1,3,0,0,1,3,0,4,4,16,18,34
1168,6176,16,6,19/5/2018,Atletico-MG,Cruzeiro,3,2,0,1,3,3,1,5,6,13,15,28
1169,6177,16,6,19/5/2018,Flamengo,Vasco,2,3,2,2,4,5,4,5,9,16,24,40
1170,6178,16,6,19/5/2018,Palmeiras,Bahia,3,2,0,0,3,2,0,5,5,17,13,30
1171,6179,16,6,20/5/2018,Vitoria,Ceara,4,0,0,0,4,0,0,4,4,11,17,28
1172,6180,16,6,20/5/2018,Sao Paulo,Santos,4,2,1,0,5,2,1,6,7,13,6,19
1173,6181,16,6,20/5/2018,America-MG,Botafogo-RJ,2,4,0,0,2,4,0,6,6,20,11,31
1174,6182,16,6,20/5/2018,Parana,Gremio,2,1,0,0,2,1,0,3,3,16,18,34
1175,6183,16,6,20/5/2018,Sport,Corinthians,2,3,0,0,2,3,0,5,5,18,17,35
1176,6184,16,6,20/5/2018,Fluminense,Athletico-PR,1,2,0,0,1,2,0,3,3,13,18,31
1177,6185,16,6,21/5/2018,Internacional,Chapecoense,1,2,0,0,1,2,0,3,3,14,15,29
1178,6186,16,7,26/5/2018,Fluminense,Chapecoense,1,1,0,0,1,1,0,2,2,21,14,35
1179,6187,16,7,26/5/2018,Palmeiras,Sport,3,3,0,1,3,4,1,6,7,17,10,27
1180,6188,16,7,26/5/2018,Atletico-MG,Flamengo,1,4,0,0,1,4,0,5,5,15,13,28
1181,6189,16,7,27/5/2018,Parana,Athletico-PR,3,1,0,0,3,1,0,4,4,8,14,22
1182,6190,16,7,27/5/2018,Internacional,Corinthians,3,1,0,0,3,1,0,4,4,13,10,23
1183,6191,16,7,27/5/2018,Bahia,Vasco,1,6,0,1,1,7,1,7,8,20,16,36
1184,6192,16,7,27/5/2018,Santos,Cruzeiro,1,4,0,0,1,4,0,5,5,12,12,24
1185,6193,16,7,27/5/2018,Botafogo-RJ,Vitoria,1,4,0,0,1,4,0,5,5,10,18,28
1186,6194,16,7,27/5/2018,Ceara,Gremio,4,2,0,0,4,2,0,6,6,15,13,28
1187,6195,16,7,27/5/2018,America-MG,Sao Paulo,4,3,0,0,4,3,0,7,7,22,19,41
1188,6196,16,8,30/5/2018,Vasco,Parana,3,3,1,1,4,4,2,6,8,24,18,42
1189,6197,16,8,30/5/2018,Vitoria,Internacional,3,2,0,0,3,2,0,5,5,14,12,26
1190,6198,16,8,30/5/2018,Sport,Atletico-MG,4,2,0,0,4,2,0,6,6,14,10,24
1191,6199,16,8,30/5/2018,Chapecoense,Ceara,2,3,0,0,2,3,0,5,5,17,13,30
1192,6200,16,8,30/5/2018,Sao Paulo,Botafogo-RJ,2,3,0,0,2,3,0,5,5,19,16,35
1193,6201,16,8,30/5/2018,Gremio,Fluminense,1,5,0,0,1,5,0,6,6,19,13,32
1194,6202,16,8,30/5/2018,Cruzeiro,Palmeiras,3,6,0,0,3,6,0,9,9,26,18,44
1195,6203,16,8,31/5/2018,Flamengo,Bahia,0,2,0,0,0,2,0,2,2,10,7,17
1196,6204,16,8,31/5/2018,Corinthians,America-MG,2,3,0,2,2,5,2,5,7,14,13,27
1197,6205,16,8,31/5/2018,Athletico-PR,Santos,1,1,0,0,1,1,0,2,2,14,6,20
1198,6206,16,9,2/6/2018,Internacional,Sport,3,3,0,0,3,3,0,6,6,14,14,28
1199,6207,16,9,2/6/2018,Atletico-MG,Chapecoense,2,4,0,1,2,5,1,6,7,15,19,34
1200,6208,16,9,2/6/2018,Vasco,Botafogo-RJ,2,4,0,0,2,4,0,6,6,12,16,28
1201,6209,16,9,2/6/2018,Palmeiras,Sao Paulo,4,4,0,0,4,4,0,8,8,22,23,45
1202,6210,16,9,3/6/2018,Flamengo,Corinthians,3,1,0,0,3,1,0,4,4,14,18,32
1203,6211,16,9,3/6/2018,Bahia,Gremio,2,5,0,0,2,5,0,7,7,18,16,34
1204,6212,16,9,3/6/2018,America-MG,Athletico-PR,1,2,0,0,1,2,0,3,3,9,15,24
1205,6213,16,9,3/6/2018,Santos,Vitoria,0,4,0,0,0,4,0,4,4,12,16,28
1206,6214,16,9,3/6/2018,Ceara,Cruzeiro,2,4,0,0,2,4,0,6,6,13,15,28
1207,6215,16,9,4/6/2018,Parana,Fluminense,6,3,0,0,6,3,0,9,9,14,16,30
1208,6216,16,10,5/6/2018,Sao Paulo,Internacional,4,2,0,0,4,2,0,6,6,30,8,38
1209,6217,16,10,6/6/2018,Vitoria,Chapecoense,3,2,0,0,3,2,0,5,5,20,15,35
1210,6218,16,10,6/6/2018,Botafogo-RJ,Ceara,0,3,0,0,0,3,0,3,3,17,17,34
1211,6219,16,10,6/6/2018,Corinthians,Santos,3,2,0,0,3,2,0,5,5,12,15,27
1212,6220,16,10,6/6/2018,Sport,Athletico-PR,2,4,0,0,2,4,0,6,6,13,20,33
1213,6221,16,10,6/6/2018,Gremio,Palmeiras,2,5,0,0,2,5,0,7,7,13,30,43
1214,6222,16,10,6/6/2018,Cruzeiro,Vasco,1,1,0,0,1,1,0,2,2,8,14,22
1215,6223,16,10,7/6/2018,Parana,Bahia,4,2,0,0,4,2,0,6,6,17,18,35
1216,6224,16,10,7/6/2018,Fluminense,Flamengo,5,2,0,0,5,2,0,7,7,16,7,23
1217,6225,16,10,7/6/2018,America-MG,Atletico-MG,2,2,0,0,2,2,0,4,4,13,7,20
1218,6226,16,11,9/6/2018,Athletico-PR,Sao Paulo,3,3,0,0,3,3,0,6,6,15,18,33
1219,6227,16,11,9/6/2018,Chapecoense,Cruzeiro,2,3,0,0,2,3,0,5,5,22,17,39
1220,6228,16,11,9/6/2018,Vasco,Sport,4,3,0,0,4,3,0,7,7,27,10,37
1221,6229,16,11,9/6/2018,Corinthians,Vitoria,2,2,0,0,2,2,0,4,4,14,19,33
1222,6230,16,11,10/6/2018,Atletico-MG,Fluminense,2,2,0,0,2,2,0,4,4,15,9,24
1223,6231,16,11,10/6/2018,Bahia,Botafogo-RJ,4,3,0,1,4,4,1,7,8,24,9,33
1224,6232,16,11,10/6/2018,Gremio,America-MG,2,3,0,0,2,3,0,5,5,14,13,27
1225,6233,16,11,10/6/2018,Ceara,Palmeiras,3,2,0,0,3,2,0,5,5,15,12,27
1226,6234,16,11,10/6/2018,Flamengo,Parana,2,0,0,0,2,0,0,2,2,11,8,19
1227,6235,16,11,10/6/2018,Santos,Internacional,3,4,1,0,4,4,1,7,8,10,20,30
1228,6236,16,12,12/6/2018,Sao Paulo,Vitoria,4,3,1,1,5,4,2,7,9,24,17,41
1229,6237,16,12,13/6/2018,America-MG,Chapecoense,5,0,0,0,5,0,0,5,5,13,15,28
1230,6238,16,12,13/6/2018,Fluminense,Santos,2,3,0,0,2,3,0,5,5,16,12,28
1231,6239,16,12,13/6/2018,Sport,Gremio,3,2,0,0,3,2,0,5,5,14,16,30
1232,6240,16,12,13/6/2018,Parana,Cruzeiro,8,2,0,0,8,2,0,10,10,23,23,46
1233,6241,16,12,13/6/2018,Palmeiras,Flamengo,4,6,3,3,7,9,6,10,16,21,18,39
1234,6242,16,12,13/6/2018,Botafogo-RJ,Athletico-PR,0,2,0,0,0,2,0,2,2,11,9,20
1235,6243,16,12,13/6/2018,Bahia,Corinthians,2,1,0,0,2,1,0,3,3,19,11,30
1236,6244,16,12,13/6/2018,Internacional,Vasco,2,0,0,0,2,0,0,2,2,13,11,24
1237,6245,16,12,13/6/2018,Atletico-MG,Ceara,1,0,0,0,1,0,0,1,1,10,10,20
1238,6247,16,13,18/7/2018,Vitoria,Parana,2,2,0,0,2,2,0,4,4,24,22,46
1239,6248,16,13,18/7/2018,Corinthians,Botafogo-RJ,2,3,0,0,2,3,0,5,5,19,13,32
1240,6249,16,13,18/7/2018,Gremio,Atletico-MG,1,2,0,0,1,2,0,3,3,10,19,29
1241,6250,16,13,18/7/2018,Flamengo,Sao Paulo,3,4,0,1,3,5,1,7,8,11,17,28
1242,6251,16,13,19/7/2018,Chapecoense,Bahia,1,2,0,0,1,2,0,3,3,12,19,31
1243,6252,16,13,19/7/2018,Cruzeiro,America-MG,3,1,0,0,3,1,0,4,4,11,8,19
1244,6253,16,13,19/7/2018,Vasco,Fluminense,4,2,0,0,4,2,0,6,6,21,21,42
1245,6254,16,13,19/7/2018,Santos,Palmeiras,4,6,0,0,4,6,0,10,10,15,16,31
1246,6255,16,13,19/7/2018,Athletico-PR,Internacional,4,5,1,0,5,5,1,9,10,11,16,27
1247,6256,16,14,21/7/2018,Flamengo,Botafogo-RJ,0,1,0,1,0,2,1,1,2,17,15,32
1248,6257,16,14,21/7/2018,Sao Paulo,Corinthians,2,7,0,0,2,7,0,9,9,9,21,30
1249,6258,16,14,22/7/2018,Vasco,Gremio,5,6,1,0,6,6,1,11,12,12,17,29
1250,6259,16,14,22/7/2018,Palmeiras,Atletico-MG,2,2,0,1,2,3,1,4,5,20,18,38
1251,6260,16,14,22/7/2018,Parana,America-MG,3,3,0,0,3,3,0,6,6,23,10,33
1252,6261,16,14,22/7/2018,Bahia,Vitoria,3,5,0,1,3,6,1,8,9,18,26,44
1253,6262,16,14,22/7/2018,Sport,Fluminense,1,5,0,0,1,5,0,6,6,14,17,31
1254,6263,16,14,22/7/2018,Cruzeiro,Athletico-PR,1,3,0,1,1,4,1,4,5,7,14,21
1255,6264,16,14,22/7/2018,Chapecoense,Santos,1,4,0,0,1,4,0,5,5,10,13,23
1256,6265,16,14,23/7/2018,Internacional,Ceara,2,3,0,0,2,3,0,5,5,12,13,25
1257,6266,16,15,25/7/2018,Fluminense,Palmeiras,2,2,0,1,2,3,1,4,5,18,16,34
1258,6267,16,15,25/7/2018,Atletico-MG,Parana,1,1,1,0,2,1,1,2,3,16,15,31
1259,6268,16,15,25/7/2018,Corinthians,Cruzeiro,0,2,0,0,0,2,0,2,2,9,10,19
1260,6269,16,15,25/7/2018,Santos,Flamengo,1,1,0,0,1,1,0,2,2,17,14,31
1261,6270,16,15,26/7/2018,Botafogo-RJ,Chapecoense,2,3,0,0,2,3,0,5,5,20,16,36
1262,6271,16,15,26/7/2018,Vitoria,Sport,2,2,0,0,2,2,0,4,4,17,14,31
1263,6272,16,15,26/7/2018,Gremio,Sao Paulo,4,5,0,0,4,5,0,9,9,23,19,42
1264,6273,16,15,26/7/2018,America-MG,Internacional,2,2,1,1,3,3,2,4,6,12,9,21
1265,6274,16,15,29/8/2018,Ceara,Bahia,3,4,0,0,3,4,0,7,7,16,25,41
1266,6275,16,15,29/8/2018,Athletico-PR,Vasco,1,2,0,0,1,2,0,3,3,15,14,29
1267,6276,16,16,28/7/2018,Ceara,Fluminense,5,1,0,0,5,1,0,6,6,22,13,35
1268,6277,16,16,29/7/2018,Palmeiras,Parana,2,2,0,0,2,2,0,4,4,20,17,37
1269,6278,16,16,29/7/2018,Vasco,Corinthians,4,0,0,0,4,0,0,4,4,17,11,28
1270,6279,16,16,29/7/2018,Flamengo,Sport,1,1,0,0,1,1,0,2,2,12,11,23
1271,6280,16,16,29/7/2018,Athletico-PR,Vitoria,3,5,0,0,3,5,0,8,8,20,17,37
1272,6281,16,16,29/7/2018,Internacional,Botafogo-RJ,1,2,0,0,1,2,0,3,3,13,14,27
1273,6282,16,16,29/7/2018,Cruzeiro,Sao Paulo,2,1,0,0,2,1,0,3,3,11,11,22
1274,6283,16,16,29/7/2018,Santos,America-MG,2,2,0,0,2,2,0,4,4,8,13,21
1275,6284,16,16,29/7/2018,Chapecoense,Gremio,1,3,0,0,1,3,0,4,4,12,15,27
1276,6285,16,16,30/7/2018,Bahia,Atletico-MG,4,2,0,0,4,2,0,6,6,15,18,33
1277,6286,16,17,4/8/2018,Botafogo-RJ,Santos,1,5,0,0,1,5,0,6,6,12,19,31
1278,6287,16,17,4/8/2018,Gremio,Flamengo,3,4,0,0,3,4,0,7,7,21,17,38
1279,6288,16,17,4/8/2018,Corinthians,Athletico-PR,2,2,0,0,2,2,0,4,4,8,13,21
1280,6289,16,17,5/8/2018,Vitoria,Cruzeiro,3,5,0,0,3,5,0,8,8,19,20,39
1281,6290,16,17,5/8/2018,Parana,Ceara,4,2,0,0,4,2,0,6,6,15,21,36
1282,6291,16,17,5/8/2018,America-MG,Palmeiras,1,2,0,0,1,2,0,3,3,16,18,34
1283,6292,16,17,5/8/2018,Sao Paulo,Vasco,2,2,0,0,2,2,0,4,4,27,9,36
1284,6293,16,17,5/8/2018,Fluminense,Bahia,4,2,0,0,4,2,0,6,6,12,18,30
1285,6294,16,17,5/8/2018,Sport,Chapecoense,1,1,0,0,1,1,0,2,2,14,20,34
1286,6295,16,17,6/8/2018,Atletico-MG,Internacional,1,1,0,0,1,1,0,2,2,13,13,26
1287,6296,16,20,8/8/2018,Ceara,Santos,3,2,0,0,3,2,0,5,5,11,13,24
1288,6297,16,20,22/8/2018,Bahia,Internacional,1,2,0,0,1,2,0,3,3,15,18,33
1289,6298,16,20,22/8/2018,Parana,Sao Paulo,3,1,0,0,3,1,0,4,4,14,12,26
1290,6299,16,20,22/8/2018,Palmeiras,Botafogo-RJ,2,5,0,1,2,6,1,7,8,14,17,31
1291,6300,16,20,22/8/2018,Sport,America-MG,2,2,0,0,2,2,0,4,4,9,21,30
1292,6301,16,20,22/8/2018,Fluminense,Corinthians,1,2,0,1,1,3,1,3,4,12,8,20
1293,6302,16,20,22/8/2018,Gremio,Cruzeiro,2,4,0,0,2,4,0,6,6,13,16,29
1294,6303,16,20,23/8/2018,Flamengo,Vitoria,2,2,0,0,2,2,0,4,4,18,19,37
1295,6304,16,20,23/8/2018,Atletico-MG,Vasco,2,4,0,0,2,4,0,6,6,16,15,31
1296,6305,16,20,13/9/2018,Chapecoense,Athletico-PR,1,3,0,0,1,3,0,4,4,19,18,37
1297,6306,16,18,11/8/2018,Ceara,Athletico-PR,3,3,0,0,3,3,0,6,6,15,14,29
1298,6307,16,18,11/8/2018,Bahia,America-MG,1,4,0,0,1,4,0,5,5,11,13,24
1299,6308,16,18,12/8/2018,Parana,Botafogo-RJ,3,4,1,1,4,5,2,7,9,11,9,20
1300,6309,16,18,12/8/2018,Atletico-MG,Santos,2,0,0,0,2,0,0,2,2,17,8,25
1301,6310,16,18,12/8/2018,Sport,Sao Paulo,1,3,0,0,1,3,0,4,4,7,15,22
1302,6311,16,18,12/8/2018,Flamengo,Cruzeiro,3,3,0,0,3,3,0,6,6,28,17,45
1303,6312,16,18,12/8/2018,Chapecoense,Corinthians,1,2,1,0,2,2,1,3,4,18,20,38
1304,6313,16,18,12/8/2018,Gremio,Vitoria,1,3,0,0,1,3,0,4,4,20,17,37
1305,6314,16,18,12/8/2018,Palmeiras,Vasco,1,2,0,0,1,2,0,3,3,17,16,33
1306,6315,16,18,13/8/2018,Fluminense,Internacional,3,3,0,0,3,3,0,6,6,8,17,25
1307,6316,16,19,18/8/2018,Santos,Sport,3,3,0,1,3,4,1,6,7,20,21,41
1308,6317,16,19,18/8/2018,Corinthians,Gremio,1,1,0,0,1,1,0,2,2,8,8,16
1309,6318,16,19,19/8/2018,Athletico-PR,Flamengo,3,1,0,0,3,1,0,4,4,15,10,25
1310,6319,16,19,19/8/2018,Internacional,Parana,3,5,0,0,3,5,0,8,8,16,16,32
1311,6320,16,19,19/8/2018,Vitoria,Palmeiras,2,1,0,0,2,1,0,3,3,25,18,43
1312,6321,16,19,19/8/2018,Botafogo-RJ,Atletico-MG,2,4,0,0,2,4,0,6,6,13,12,25
1313,6322,16,19,19/8/2018,Cruzeiro,Bahia,2,2,0,0,2,2,0,4,4,14,13,27
1314,6323,16,19,19/8/2018,America-MG,Fluminense,2,0,1,0,3,0,1,2,3,13,8,21
1315,6324,16,19,19/8/2018,Sao Paulo,Chapecoense,2,1,0,0,2,1,0,3,3,17,20,37
1316,6325,16,19,20/8/2018,Vasco,Ceara,1,1,0,1,1,2,1,2,3,16,21,37
1317,6326,16,21,25/8/2018,Santos,Bahia,1,2,0,0,1,2,0,3,3,25,17,42
1318,6327,16,21,25/8/2018,Corinthians,Parana,3,4,0,1,3,5,1,7,8,18,20,38
1319,6328,16,21,25/8/2018,Athletico-PR,Gremio,2,2,0,0,2,2,0,4,4,18,17,35
1320,6329,16,21,25/8/2018,Cruzeiro,Fluminense,4,3,0,0,4,3,0,7,7,17,14,31
1321,6330,16,21,25/8/2018,Botafogo-RJ,Sport,2,2,0,0,2,2,0,4,4,21,13,34
1322,6331,16,21,26/8/2018,Sao Paulo,Ceara,3,6,0,1,3,7,1,9,10,13,21,34
1323,6332,16,21,26/8/2018,America-MG,Flamengo,3,2,0,1,3,3,1,5,6,12,9,21
1324,6333,16,21,26/8/2018,Internacional,Palmeiras,2,3,0,0,2,3,0,5,5,14,24,38
1325,6334,16,21,26/8/2018,Vitoria,Atletico-MG,2,3,0,0,2,3,0,5,5,17,12,29
1326,6335,16,21,26/8/2018,Vasco,Chapecoense,3,2,0,0,3,2,0,5,5,18,20,38
1327,6336,16,22,1/9/2018,Vitoria,America-MG,5,1,0,1,5,2,1,6,7,21,10,31
1328,6337,16,22,1/9/2018,Gremio,Botafogo-RJ,2,3,0,0,2,3,0,5,5,12,19,31
1329,6338,16,22,1/9/2018,Vasco,Santos,1,1,0,0,1,1,0,2,2,12,11,23
1330,6339,16,22,1/9/2018,Corinthians,Atletico-MG,1,3,0,0,1,3,0,4,4,16,21,37
1331,6340,16,22,2/9/2018,Flamengo,Ceara,2,2,0,0,2,2,0,4,4,16,14,30
1332,6341,16,22,2/9/2018,Athletico-PR,Bahia,2,2,0,0,2,2,0,4,4,14,9,23
1333,6342,16,22,2/9/2018,Sport,Parana,3,2,0,0,3,2,0,5,5,19,12,31
1334,6343,16,22,2/9/2018,Sao Paulo,Fluminense,2,2,1,0,3,2,1,4,5,14,16,30
1335,6344,16,22,2/9/2018,Cruzeiro,Internacional,3,2,0,0,3,2,0,5,5,16,14,30
1336,6345,16,22,2/9/2018,Chapecoense,Palmeiras,4,4,0,0,4,4,0,8,8,14,23,37
1337,6346,16,23,5/9/2018,Bahia,Sport,1,1,0,0,1,1,0,2,2,19,19,38
1338,6347,16,23,5/9/2018,Botafogo-RJ,Cruzeiro,3,3,0,0,3,3,0,6,6,13,17,30
1339,6348,16,23,5/9/2018,Ceara,Corinthians,6,2,0,0,6,2,0,8,8,19,19,38
1340,6349,16,23,5/9/2018,Palmeiras,Athletico-PR,2,3,0,0,2,3,0,5,5,16,18,34
1341,6350,16,23,5/9/2018,Parana,Chapecoense,2,2,0,0,2,2,0,4,4,24,19,43
1342,6351,16,23,5/9/2018,Atletico-MG,Sao Paulo,3,1,0,0,3,1,0,4,4,17,18,35
1343,6352,16,23,5/9/2018,Internacional,Flamengo,4,1,0,0,4,1,0,5,5,13,13,26
1344,6353,16,23,6/9/2018,Santos,Gremio,2,1,0,0,2,1,0,3,3,14,8,22
1345,6354,16,23,6/9/2018,Fluminense,Vitoria,1,1,0,0,1,1,0,2,2,11,8,19
1346,6355,16,23,6/9/2018,America-MG,Vasco,1,1,0,0,1,1,0,2,2,19,12,31
1347,6356,16,24,8/9/2018,Sport,Cruzeiro,3,1,0,0,3,1,0,4,4,22,19,41
1348,6357,16,24,8/9/2018,Sao Paulo,Bahia,3,2,0,0,3,2,0,5,5,16,19,35
1349,6358,16,24,8/9/2018,Flamengo,Chapecoense,2,2,0,0,2,2,0,4,4,17,13,30
1350,6359,16,24,9/9/2018,America-MG,Ceara,1,1,0,0,1,1,0,2,2,16,10,26
1351,6360,16,24,9/9/2018,Palmeiras,Corinthians,2,3,0,0,2,3,0,5,5,14,16,30
1352,6361,16,24,9/9/2018,Fluminense,Botafogo-RJ,3,4,0,0,3,4,0,7,7,21,14,35
1353,6362,16,24,9/9/2018,Internacional,Gremio,5,5,0,0,5,5,0,10,10,17,15,32
1354,6363,16,24,9/9/2018,Parana,Santos,4,3,0,0,4,3,0,7,7,15,18,33
1355,6364,16,24,9/9/2018,Vitoria,Vasco,4,1,1,1,5,2,2,5,7,19,19,38
1356,6365,16,24,10/9/2018,Atletico-MG,Athletico-PR,4,5,0,1,4,6,1,9,10,13,14,27
1357,6366,16,25,15/9/2018,Ceara,Vitoria,2,4,0,0,2,4,0,6,6,23,21,44
1358,6367,16,25,15/9/2018,Gremio,Parana,1,1,0,0,1,1,0,2,2,11,13,24
1359,6368,16,25,15/9/2018,Vasco,Flamengo,3,2,0,1,3,3,1,5,6,19,13,32
1360,6369,16,25,16/9/2018,Botafogo-RJ,America-MG,1,1,1,1,2,2,2,2,4,13,18,31
1361,6370,16,25,16/9/2018,Cruzeiro,Atletico-MG,3,1,0,0,3,1,0,4,4,19,16,35
1362,6371,16,25,16/9/2018,Bahia,Palmeiras,1,2,0,0,1,2,0,3,3,14,11,25
1363,6372,16,25,16/9/2018,Athletico-PR,Fluminense,3,2,0,0,3,2,0,5,5,15,14,29
1364,6373,16,25,16/9/2018,Santos,Sao Paulo,7,4,0,0,7,4,0,11,11,15,15,30
1365,6374,16,25,16/9/2018,Corinthians,Sport,2,1,0,0,2,1,0,3,3,16,19,35
1366,6375,16,25,17/9/2018,Chapecoense,Internacional,4,3,0,1,4,4,1,7,8,14,15,29
1367,6376,16,26,22/9/2018,Sao Paulo,America-MG,1,1,0,0,1,1,0,2,2,14,12,26
1368,6377,16,26,23/9/2018,Gremio,Ceara,3,1,0,0,3,1,0,4,4,12,9,21
1369,6378,16,26,23/9/2018,Athletico-PR,Parana,0,4,0,0,0,4,0,4,4,15,11,26
1370,6379,16,26,23/9/2018,Flamengo,Atletico-MG,2,2,0,0,2,2,0,4,4,26,15,41
1371,6380,16,26,23/9/2018,Corinthians,Internacional,0,2,0,0,0,2,0,2,2,13,11,24
1372,6381,16,26,23/9/2018,Sport,Palmeiras,2,2,0,0,2,2,0,4,4,16,16,32
1373,6382,16,26,23/9/2018,Vitoria,Botafogo-RJ,1,4,0,0,1,4,0,5,5,15,17,32
1374,6383,16,26,23/9/2018,Cruzeiro,Santos,2,2,0,0,2,2,0,4,4,17,12,29
1375,6384,16,26,24/9/2018,Chapecoense,Fluminense,3,3,1,0,4,3,1,6,7,19,19,38
1376,6385,16,26,24/9/2018,Vasco,Bahia,5,2,0,1,5,3,1,7,8,12,15,27
1377,6386,16,27,29/9/2018,Fluminense,Gremio,1,2,0,0,1,2,0,3,3,10,13,23
1378,6387,16,27,29/9/2018,America-MG,Corinthians,0,1,0,0,0,1,0,1,1,8,4,12
1379,6388,16,27,29/9/2018,Bahia,Flamengo,2,1,0,0,2,1,0,3,3,16,17,33
1380,6389,16,27,30/9/2018,Palmeiras,Cruzeiro,5,6,0,0,5,6,0,11,11,15,19,34
1381,6390,16,27,30/9/2018,Atletico-MG,Sport,1,4,0,1,1,5,1,5,6,18,16,34
1382,6391,16,27,30/9/2018,Santos,Athletico-PR,2,6,0,0,2,6,0,8,8,8,17,25
1383,6392,16,27,30/9/2018,Botafogo-RJ,Sao Paulo,1,2,0,0,1,2,0,3,3,20,18,38
1384,6393,16,27,30/9/2018,Internacional,Vitoria,3,6,0,1,3,7,1,9,10,19,18,37
1385,6394,16,27,30/9/2018,Ceara,Chapecoense,4,5,0,0,4,5,0,9,9,15,20,35
1386,6395,16,27,1/10/2018,Parana,Vasco,1,0,0,1,1,1,1,1,2,15,11,26
1387,6396,16,28,5/10/2018,Sport,Internacional,4,1,0,0,4,1,0,5,5,10,10,20
1388,6397,16,28,5/10/2018,Corinthians,Flamengo,2,1,0,0,2,1,0,3,3,9,18,27
1389,6398,16,28,5/10/2018,Vitoria,Santos,3,2,1,0,4,2,1,5,6,17,24,41
1390,6399,16,28,6/10/2018,Athletico-PR,America-MG,3,3,0,0,3,3,0,6,6,10,13,23
1391,6400,16,28,6/10/2018,Chapecoense,Atletico-MG,3,3,0,0,3,3,0,6,6,20,15,35
1392,6401,16,28,6/10/2018,Sao Paulo,Palmeiras,2,3,0,0,2,3,0,5,5,21,17,38
1393,6402,16,28,6/10/2018,Gremio,Bahia,2,4,0,1,2,5,1,6,7,13,25,38
1394,6403,16,28,8/10/2018,Fluminense,Parana,1,2,0,0,1,2,0,3,3,8,18,26
1395,6404,16,28,9/10/2018,Botafogo-RJ,Vasco,3,2,0,0,3,2,0,5,5,13,13,26
1396,6405,16,28,24/10/2018,Cruzeiro,Ceara,1,3,0,0,1,3,0,4,4,7,18,25
1397,6406,16,29,13/10/2018,Flamengo,Fluminense,2,3,0,0,2,3,0,5,5,16,15,31
1398,6407,16,29,13/10/2018,Santos,Corinthians,3,3,0,0,3,3,0,6,6,19,19,38
1399,6408,16,29,13/10/2018,Bahia,Parana,3,3,0,0,3,3,0,6,6,5,10,15
1400,6409,16,29,14/10/2018,Chapecoense,Vitoria,3,2,0,0,3,2,0,5,5,14,20,34
1401,6410,16,29,14/10/2018,Vasco,Cruzeiro,6,2,0,1,6,3,1,8,9,14,17,31
1402,6411,16,29,14/10/2018,Internacional,Sao Paulo,0,4,0,1,0,5,1,4,5,16,23,39
1403,6412,16,29,14/10/2018,Palmeiras,Gremio,4,2,0,0,4,2,0,6,6,16,16,32
1404,6413,16,29,14/10/2018,Atletico-MG,America-MG,1,0,0,0,1,0,0,1,1,16,15,31
1405,6414,16,29,14/10/2018,Athletico-PR,Sport,0,3,0,0,0,3,0,3,3,13,12,25
1406,6415,16,29,15/10/2018,Ceara,Botafogo-RJ,1,3,0,0,1,3,0,4,4,13,10,23
1407,6417,16,30,20/10/2018,Botafogo-RJ,Bahia,2,1,0,0,2,1,0,3,3,10,21,31
1408,6418,16,30,20/10/2018,Sao Paulo,Athletico-PR,3,2,0,0,3,2,0,5,5,20,15,35
1409,6419,16,30,20/10/2018,Sport,Vasco,0,3,0,0,0,3,0,3,3,16,18,34
1410,6420,16,30,21/10/2018,Vitoria,Corinthians,1,4,0,0,1,4,0,5,5,18,23,41
1411,6421,16,30,21/10/2018,Fluminense,Atletico-MG,2,2,1,0,3,2,1,4,5,14,19,33
1412,6422,16,30,21/10/2018,Palmeiras,Ceara,5,2,1,0,6,2,1,7,8,14,13,27
1413,6423,16,30,21/10/2018,Cruzeiro,Chapecoense,2,1,0,0,2,1,0,3,3,9,15,24
1414,6424,16,30,21/10/2018,Parana,Flamengo,1,0,1,0,2,0,1,1,2,17,13,30
1415,6425,16,30,22/10/2018,Internacional,Santos,1,3,0,0,1,3,0,4,4,14,15,29
1416,6426,16,31,26/10/2018,Vitoria,Sao Paulo,1,2,0,1,1,3,1,3,4,8,24,32
1417,6427,16,31,26/10/2018,Vasco,Internacional,3,5,0,1,3,6,1,8,9,17,20,37
1418,6428,16,31,27/10/2018,Santos,Fluminense,2,3,0,0,2,3,0,5,5,15,17,32
1419,6429,16,31,27/10/2018,Gremio,Sport,2,2,0,0,2,2,0,4,4,10,16,26
1420,6430,16,31,27/10/2018,Corinthians,Bahia,3,3,0,0,3,3,0,6,6,11,15,26
1421,6431,16,31,27/10/2018,Chapecoense,America-MG,3,4,0,0,3,4,0,7,7,12,24,36
1422,6432,16,31,27/10/2018,Flamengo,Palmeiras,2,5,0,0,2,5,0,7,7,19,17,36
1423,6433,16,31,27/10/2018,Cruzeiro,Parana,0,2,0,0,0,2,0,2,2,13,18,31
1424,6434,16,31,27/10/2018,Athletico-PR,Botafogo-RJ,2,5,0,0,2,5,0,7,7,19,30,49
1425,6435,16,31,29/10/2018,Ceara,Atletico-MG,2,4,0,0,2,4,0,6,6,13,21,34
1426,6436,16,32,3/11/2018,Fluminense,Vasco,2,3,1,0,3,3,1,5,6,14,12,26
1427,6437,16,32,3/11/2018,Atletico-MG,Gremio,4,1,0,0,4,1,0,5,5,12,12,24
1428,6438,16,32,3/11/2018,Palmeiras,Santos,3,5,0,1,3,6,1,8,9,26,23,49
1429,6439,16,32,4/11/2018,America-MG,Cruzeiro,3,1,0,0,3,1,0,4,4,18,8,26
1430,6440,16,32,4/11/2018,Parana,Vitoria,3,4,0,1,3,5,1,7,8,19,19,38
1431,6441,16,32,4/11/2018,Sao Paulo,Flamengo,2,1,0,0,2,1,0,3,3,17,13,30
1432,6442,16,32,4/11/2018,Botafogo-RJ,Corinthians,1,2,0,0,1,2,0,3,3,25,19,44
1433,6443,16,32,4/11/2018,Internacional,Athletico-PR,2,3,0,0,2,3,0,5,5,9,20,29
1434,6444,16,32,4/11/2018,Bahia,Chapecoense,1,1,0,0,1,1,0,2,2,15,22,37
1435,6445,16,32,5/11/2018,Sport,Ceara,3,3,0,0,3,3,0,6,6,13,16,29
1436,6446,16,33,10/11/2018,America-MG,Parana,3,1,1,1,4,2,2,4,6,10,10,20
1437,6447,16,33,10/11/2018,Corinthians,Sao Paulo,1,3,1,0,2,3,1,4,5,10,18,28
1438,6448,16,33,10/11/2018,Botafogo-RJ,Flamengo,4,6,0,0,4,6,0,10,10,30,16,46
1439,6449,16,33,10/11/2018,Athletico-PR,Cruzeiro,4,7,0,0,4,7,0,11,11,17,14,31
1440,6450,16,33,11/11/2018,Vitoria,Bahia,3,4,0,0,3,4,0,7,7,18,25,43
1441,6451,16,33,11/11/2018,Ceara,Internacional,2,5,0,0,2,5,0,7,7,11,15,26
1442,6452,16,33,11/11/2018,Atletico-MG,Palmeiras,3,2,0,0,3,2,0,5,5,22,14,36
1443,6453,16,33,11/11/2018,Gremio,Vasco,2,4,0,0,2,4,0,6,6,12,17,29
1444,6454,16,33,11/11/2018,Fluminense,Sport,0,2,0,0,0,2,0,2,2,18,16,34
1445,6455,16,33,12/11/2018,Santos,Chapecoense,2,1,0,0,2,1,0,3,3,15,24,39
1446,6456,16,34,14/11/2018,Vasco,Athletico-PR,1,0,0,0,1,0,0,1,1,13,9,22
1447,6457,16,34,14/11/2018,Bahia,Ceara,2,3,0,0,2,3,0,5,5,11,15,26
1448,6458,16,34,14/11/2018,Parana,Atletico-MG,4,3,2,0,6,3,2,7,9,19,14,33
1449,6459,16,34,14/11/2018,Sport,Vitoria,4,4,0,0,4,4,0,8,8,21,17,38
1450,6460,16,34,14/11/2018,Palmeiras,Fluminense,6,5,0,1,6,6,1,11,12,20,24,44
1451,6461,16,34,14/11/2018,Cruzeiro,Corinthians,2,2,0,1,2,3,1,4,5,13,6,19
1452,6462,16,34,15/11/2018,Chapecoense,Botafogo-RJ,1,2,0,0,1,2,0,3,3,12,14,26
1453,6463,16,34,15/11/2018,Flamengo,Santos,3,5,0,0,3,5,0,8,8,22,18,40
1454,6464,16,34,15/11/2018,Sao Paulo,Gremio,1,2,0,0,1,2,0,3,3,14,13,27
1455,6465,16,34,15/11/2018,Internacional,America-MG,1,2,0,0,1,2,0,3,3,19,20,39
1456,6466,16,35,17/11/2018,Corinthians,Vasco,2,2,0,0,2,2,0,4,4,22,14,36
1457,6467,16,35,17/11/2018,Vitoria,Athletico-PR,3,3,1,0,4,3,1,6,7,15,23,38
1458,6468,16,35,17/11/2018,Atletico-MG,Bahia,3,3,1,0,4,3,1,6,7,16,24,40
1459,6469,16,35,18/11/2018,Parana,Palmeiras,4,2,0,0,4,2,0,6,6,22,8,30
1460,6470,16,35,18/11/2018,America-MG,Santos,6,1,0,0,6,1,0,7,7,20,14,34
1461,6471,16,35,18/11/2018,Sport,Flamengo,1,1,0,1,1,2,1,2,3,9,13,22
1462,6472,16,35,18/11/2018,Botafogo-RJ,Internacional,2,4,0,2,2,6,2,6,8,13,18,31
1463,6473,16,35,18/11/2018,Sao Paulo,Cruzeiro,2,2,0,0,2,2,0,4,4,14,17,31
1464,6474,16,35,18/11/2018,Gremio,Chapecoense,2,2,0,0,2,2,0,4,4,12,21,33
1465,6475,16,35,19/11/2018,Fluminense,Ceara,4,3,0,0,4,3,0,7,7,16,24,40
1466,6476,16,36,21/11/2018,Internacional,Atletico-MG,1,2,0,0,1,2,0,3,3,10,17,27
1467,6477,16,36,21/11/2018,Santos,Botafogo-RJ,2,2,0,0,2,2,0,4,4,19,16,35
1468,6478,16,36,21/11/2018,Athletico-PR,Corinthians,2,4,0,0,2,4,0,6,6,18,14,32
1469,6479,16,36,21/11/2018,Palmeiras,America-MG,0,6,0,0,0,6,0,6,6,13,20,33
1470,6480,16,36,21/11/2018,Flamengo,Gremio,2,3,0,0,2,3,0,5,5,17,14,31
1471,6481,16,36,21/11/2018,Cruzeiro,Vitoria,2,1,0,0,2,1,0,3,3,18,15,33
1472,6482,16,36,22/11/2018,Vasco,Sao Paulo,2,4,0,0,2,4,0,6,6,19,22,41
1473,6483,16,36,22/11/2018,Ceara,Parana,2,1,0,0,2,1,0,3,3,17,12,29
1474,6484,16,36,22/11/2018,Bahia,Fluminense,2,1,0,0,2,1,0,3,3,23,9,32
1475,6485,16,36,22/11/2018,Chapecoense,Sport,2,1,0,0,2,1,0,3,3,22,13,35
1476,6486,16,37,24/11/2018,Santos,Atletico-MG,4,1,1,0,5,1,1,5,6,19,15,34
1477,6487,16,37,25/11/2018,Athletico-PR,Ceara,3,4,0,0,3,4,0,7,7,19,18,37
1478,6488,16,37,25/11/2018,Cruzeiro,Flamengo,6,3,0,0,6,3,0,9,9,10,9,19
1479,6489,16,37,25/11/2018,Vitoria,Gremio,2,4,0,0,2,4,0,6,6,15,20,35
1480,6490,16,37,25/11/2018,Vasco,Palmeiras,4,5,1,0,5,5,1,9,10,17,18,35
1481,6491,16,37,25/11/2018,Internacional,Fluminense,3,2,0,1,3,3,1,5,6,12,17,29
1482,6492,16,37,25/11/2018,America-MG,Bahia,2,2,0,1,2,3,1,4,5,19,21,40
1483,6493,16,37,25/11/2018,Corinthians,Chapecoense,2,1,0,0,2,1,0,3,3,13,13,26
1484,6494,16,37,26/11/2018,Botafogo-RJ,Parana,1,3,0,0,1,3,0,4,4,13,16,29
1485,6495,16,37,26/11/2018,Sao Paulo,Sport,2,3,0,1,2,4,1,5,6,14,21,35
1486,6496,16,38,1/12/2018,Flamengo,Athletico-PR,4,1,1,1,5,2,2,5,7,17,17,34
1487,6497,16,38,1/12/2018,Atletico-MG,Botafogo-RJ,4,3,0,0,4,3,0,7,7,15,17,32
1488,6498,16,38,2/12/2018,Ceara,Vasco,3,2,1,0,4,2,1,5,6,17,11,28
1489,6499,16,38,2/12/2018,Gremio,Corinthians,2,4,0,0,2,4,0,6,6,11,15,26
1490,6500,16,38,2/12/2018,Bahia,Cruzeiro,4,1,0,0,4,1,0,5,5,18,15,33
1491,6501,16,38,2/12/2018,Sport,Santos,3,1,0,0,3,1,0,4,4,21,21,42
1492,6502,16,38,2/12/2018,Parana,Internacional,1,2,1,0,2,2,1,3,4,14,15,29
1493,6503,16,38,2/12/2018,Fluminense,America-MG,5,2,0,0,5,2,0,7,7,15,19,34
1494,6504,16,38,2/12/2018,Chapecoense,Sao Paulo,0,3,0,0,0,3,0,3,3,11,23,34
1495,6505,16,38,2/12/2018,Palmeiras,Vitoria,2,2,0,0,2,2,0,4,4,11,6,17
1496,6506,17,1,27/4/2019,Sao Paulo,Botafogo-RJ,0,4,0,0,0,4,0,4,4,23,7,30
1497,6507,17,1,27/4/2019,Atletico-MG,Avai,0,1,0,0,0,1,0,1,1,12,18,30
1498,6508,17,1,27/4/2019,Chapecoense,Internacional,1,1,0,0,1,1,0,2,2,15,11,26
1499,6509,17,1,27/4/2019,Flamengo,Cruzeiro,4,5,0,1,4,6,1,9,10,13,17,30
1500,6510,17,1,28/4/2019,Gremio,Santos,3,4,0,1,3,5,1,7,8,12,18,30
1501,6511,17,1,28/4/2019,Bahia,Corinthians,1,4,0,0,1,4,0,5,5,17,5,22
1502,6512,17,1,28/4/2019,Athletico-PR,Vasco,1,1,0,0,1,1,0,2,2,15,19,34
1503,6513,17,1,28/4/2019,Ceara,CSA,0,0,0,1,0,1,1,0,1,15,4,19
1504,6514,17,1,28/4/2019,Palmeiras,Fortaleza,1,2,0,0,1,2,0,3,3,12,16,28
1505,6515,17,1,28/4/2019,Fluminense,Goias,4,1,0,0,4,1,0,5,5,14,9,23
1506,6516,17,2,1/5/2019,Internacional,Flamengo,3,2,0,0,3,2,0,5,5,8,9,17
1507,6518,17,2,1/5/2019,Corinthians,Chapecoense,2,1,0,0,2,1,0,3,3,14,10,24
1508,6519,17,2,1/5/2019,Cruzeiro,Ceara,1,0,0,0,1,0,0,1,1,10,12,22
1509,6520,17,2,1/5/2019,Avai,Gremio,4,3,0,0,4,3,0,7,7,15,17,32
1510,6521,17,2,1/5/2019,Goias,Sao Paulo,3,2,0,1,3,3,1,5,6,15,12,27
1511,6523,17,2,1/5/2019,Fortaleza,Athletico-PR,3,3,0,0,3,3,0,6,6,12,19,31
1512,6524,17,2,2/5/2019,Santos,Fluminense,3,2,0,0,3,2,0,5,5,25,14,39
1513,6525,17,2,2/5/2019,Botafogo-RJ,Bahia,3,0,0,0,3,0,0,3,3,11,15,26
1514,6526,17,3,4/5/2019,Vasco,Corinthians,2,1,0,0,2,1,0,3,3,21,8,29
1515,6527,17,3,4/5/2019,Palmeiras,Internacional,2,5,0,0,2,5,0,7,7,15,18,33
1516,6528,17,3,4/5/2019,Ceara,Atletico-MG,0,1,0,0,0,1,0,1,1,12,7,19
1517,6529,17,3,5/5/2019,Chapecoense,Athletico-PR,1,3,0,0,1,3,0,4,4,16,17,33
1518,6530,17,3,5/5/2019,Sao Paulo,Flamengo,1,7,0,0,1,7,0,8,8,16,15,31
1519,6531,17,3,5/5/2019,Botafogo-RJ,Fortaleza,0,2,0,0,0,2,0,2,2,10,16,26
1520,6532,17,3,5/5/2019,CSA,Santos,1,4,0,0,1,4,0,5,5,11,13,24
1521,6533,17,3,5/5/2019,Cruzeiro,Goias,1,2,0,1,1,3,1,3,4,14,10,24
1522,6534,17,3,5/5/2019,Gremio,Fluminense,2,1,0,0,2,1,0,3,3,8,10,18
1523,6535,17,3,5/5/2019,Bahia,Avai,1,2,0,0,1,2,0,3,3,27,15,42
1524,6536,17,4,11/5/2019,Fluminense,Botafogo-RJ,3,5,0,0,3,5,0,8,8,16,12,28
1525,6537,17,4,11/5/2019,Corinthians,Gremio,2,4,0,0,2,4,0,6,6,13,19,32
1526,6538,17,4,11/5/2019,Goias,Ceara,2,2,0,0,2,2,0,4,4,20,12,32
1527,6539,17,4,12/5/2019,Flamengo,Chapecoense,2,3,0,0,2,3,0,5,5,18,9,27
1528,6540,17,4,12/5/2019,Santos,Vasco,2,4,0,1,2,5,1,6,7,18,11,29
1529,6541,17,4,12/5/2019,Atletico-MG,Palmeiras,1,3,0,0,1,3,0,4,4,0,0,0
1530,6542,17,4,12/5/2019,Internacional,Cruzeiro,0,0,0,1,0,1,1,0,1,10,14,24
1531,6543,17,4,12/5/2019,Avai,CSA,1,2,0,0,1,2,0,3,3,14,18,32
1532,6544,17,4,12/5/2019,Athletico-PR,Bahia,2,3,0,0,2,3,0,5,5,13,14,27
1533,6545,17,4,12/5/2019,Fortaleza,Sao Paulo,2,2,0,0,2,2,0,4,4,12,14,26
1534,6546,17,5,18/5/2019,Fluminense,Cruzeiro,3,2,0,0,3,2,0,5,5,20,12,32
1535,6547,17,5,18/5/2019,Palmeiras,Santos,2,4,0,0,2,4,0,6,6,23,19,42
1536,6548,17,5,18/5/2019,Atletico-MG,Flamengo,3,1,1,0,4,1,1,4,5,11,8,19
1537,6549,17,5,19/5/2019,Sao Paulo,Bahia,1,3,1,0,2,3,1,4,5,9,19,28
1538,6550,17,5,19/5/2019,Internacional,CSA,2,3,0,0,2,3,0,5,5,11,9,20
1539,6551,17,5,19/5/2019,Athletico-PR,Corinthians,1,4,0,0,1,4,0,5,5,16,12,28
1540,6552,17,5,19/5/2019,Goias,Botafogo-RJ,1,3,0,0,1,3,0,4,4,18,14,32
1541,6553,17,5,19/5/2019,Chapecoense,Fortaleza,1,1,0,0,1,1,0,2,2,16,12,28
1542,6554,17,5,19/5/2019,Vasco,Avai,1,2,0,0,1,2,0,3,3,16,14,30
1543,6555,17,5,19/5/2019,Ceara,Gremio,3,6,0,0,3,6,0,9,9,14,16,30
1544,6556,17,6,25/5/2019,Botafogo-RJ,Palmeiras,10,0,0,0,10,0,0,10,10,13,19,32
1545,6557,17,6,25/5/2019,Gremio,Atletico-MG,1,4,0,0,1,4,0,5,5,10,14,24
1546,6558,17,6,26/5/2019,Flamengo,Athletico-PR,4,3,0,0,4,3,0,7,7,16,21,37
1547,6559,17,6,26/5/2019,Santos,Internacional,5,5,0,0,5,5,0,10,10,19,19,38
1548,6560,17,6,26/5/2019,Fortaleza,Vasco,1,2,0,0,1,2,0,3,3,9,12,21
1549,6561,17,6,26/5/2019,Cruzeiro,Chapecoense,1,3,0,0,1,3,0,4,4,13,11,24
1550,6562,17,6,26/5/2019,Bahia,Fluminense,2,3,0,1,2,4,1,5,6,9,10,19
1551,6563,17,6,26/5/2019,Corinthians,Sao Paulo,3,4,0,0,3,4,0,7,7,16,14,30
1552,6564,17,6,27/5/2019,CSA,Goias,3,1,0,0,3,1,0,4,4,19,10,29
1553,6565,17,6,27/5/2019,Avai,Ceara,4,3,0,0,4,3,0,7,7,21,15,36
1554,6566,17,7,1/6/2019,Flamengo,Fortaleza,1,0,0,0,1,0,0,1,1,16,6,22
1555,6567,17,7,1/6/2019,Bahia,Gremio,1,2,0,0,1,2,0,3,3,8,10,18
1556,6568,17,7,2/6/2019,Botafogo-RJ,Vasco,2,3,0,0,2,3,0,5,5,15,16,31
1557,6569,17,7,2/6/2019,Ceara,Santos,2,1,0,0,2,1,0,3,3,14,22,36
1558,6570,17,7,2/6/2019,Athletico-PR,Fluminense,1,3,0,1,1,4,1,4,5,20,17,37
1559,6571,17,7,2/6/2019,Sao Paulo,Cruzeiro,2,3,1,0,3,3,1,5,6,15,12,27
1560,6572,17,7,2/6/2019,Atletico-MG,CSA,0,3,0,0,0,3,0,3,3,2,11,13
1561,6573,17,7,2/6/2019,Chapecoense,Palmeiras,2,5,0,0,2,5,0,7,7,14,21,35
1562,6575,17,7,7/8/2019,Corinthians,Goias,1,2,0,1,1,3,1,3,4,13,11,24
1563,6576,17,8,7/6/2019,Vasco,Internacional,0,2,0,0,0,2,0,2,2,13,16,29
1564,6577,17,8,8/6/2019,Palmeiras,Athletico-PR,2,4,0,0,2,4,0,6,6,16,29,45
1565,6578,17,8,8/6/2019,Gremio,Fortaleza,1,4,0,1,1,5,1,5,6,7,7,14
1566,6579,17,8,8/6/2019,Cruzeiro,Corinthians,1,1,0,0,1,1,0,2,2,12,13,25
1567,6580,17,8,8/6/2019,Ceara,Bahia,2,2,0,0,2,2,0,4,4,12,10,22
1568,6581,17,8,8/6/2019,Avai,Sao Paulo,5,2,0,0,5,2,0,7,7,17,17,34
1569,6582,17,8,9/6/2019,CSA,Botafogo-RJ,2,1,0,0,2,1,0,3,3,20,10,30
1570,6583,17,8,9/6/2019,Fluminense,Flamengo,2,3,0,0,2,3,0,5,5,14,17,31
1571,6584,17,8,9/6/2019,Santos,Atletico-MG,1,2,0,0,1,2,0,3,3,12,14,26
1572,6585,17,8,10/6/2019,Goias,Chapecoense,2,0,0,1,2,1,1,2,3,14,17,31
1573,6586,17,9,12/6/2019,Botafogo-RJ,Gremio,1,2,0,0,1,2,0,3,3,9,11,20
1574,6587,17,9,12/6/2019,Fortaleza,Cruzeiro,1,6,1,0,2,6,1,7,8,10,15,25
1575,6588,17,9,12/6/2019,Internacional,Bahia,1,1,0,0,1,1,0,2,2,11,7,18
1576,6589,17,9,12/6/2019,CSA,Flamengo,3,1,0,0,3,1,0,4,4,13,10,23
1577,6590,17,9,12/6/2019,Santos,Corinthians,4,4,0,0,4,4,0,8,8,16,13,29
1578,6591,17,9,13/6/2019,Vasco,Ceara,0,2,0,0,0,2,0,2,2,14,15,29
1579,6592,17,9,13/6/2019,Chapecoense,Fluminense,2,6,0,1,2,7,1,8,9,12,21,33
1580,6593,17,9,13/6/2019,Palmeiras,Avai,1,1,0,0,1,1,0,2,2,13,18,31
1581,6594,17,9,13/6/2019,Atletico-MG,Sao Paulo,2,4,0,0,2,4,0,6,6,13,17,30
1582,6595,17,9,13/6/2019,Goias,Athletico-PR,1,3,0,0,1,3,0,4,4,0,0,0
1583,6596,17,10,13/7/2019,Gremio,Vasco,2,4,0,0,2,4,0,6,6,18,12,30
1584,6597,17,10,13/7/2019,Fortaleza,Avai,2,2,0,0,2,2,0,4,4,15,12,27
1585,6598,17,10,13/7/2019,Bahia,Santos,2,3,0,0,2,3,0,5,5,13,11,24
1586,6599,17,10,13/7/2019,Sao Paulo,Palmeiras,3,3,0,0,3,3,0,6,6,19,18,37
1587,6600,17,10,14/7/2019,Flamengo,Goias,1,2,0,0,1,2,0,3,3,8,9,17
1588,6601,17,10,14/7/2019,Corinthians,CSA,2,6,0,0,2,6,0,8,8,2,18,20
1589,6602,17,10,14/7/2019,Athletico-PR,Internacional,3,3,0,0,3,3,0,6,6,15,16,31
1590,6604,17,10,14/7/2019,Chapecoense,Atletico-MG,3,5,0,0,3,5,0,8,8,20,16,36
1591,6605,17,10,15/7/2019,Fluminense,Ceara,2,2,0,0,2,2,0,4,4,11,15,26
1592,6606,17,11,20/7/2019,Vasco,Fluminense,4,3,0,2,4,5,2,7,9,25,22,47
1593,6607,17,11,20/7/2019,Bahia,Cruzeiro,2,1,1,0,3,1,1,3,4,17,8,25
1594,6608,17,11,20/7/2019,Ceara,Palmeiras,3,2,0,0,3,2,0,5,5,26,13,39
1595,6609,17,11,20/7/2019,CSA,Athletico-PR,2,1,0,0,2,1,0,3,3,0,0,0
1596,6610,17,11,20/7/2019,Internacional,Gremio,3,2,0,0,3,2,0,5,5,13,14,27
1597,6611,17,11,21/7/2019,Botafogo-RJ,Santos,2,3,1,1,3,4,2,5,7,12,14,26
1598,6612,17,11,21/7/2019,Atletico-MG,Fortaleza,1,4,0,0,1,4,0,5,5,15,12,27
1599,6613,17,11,21/7/2019,Corinthians,Flamengo,1,4,0,1,1,5,1,5,6,20,17,37
1600,6614,17,11,21/7/2019,Avai,Goias,4,2,0,0,4,2,0,6,6,16,19,35
1601,6615,17,11,22/7/2019,Sao Paulo,Chapecoense,1,3,0,0,1,3,0,4,4,29,19,48
1602,6616,17,12,27/7/2019,Palmeiras,Vasco,1,4,0,0,1,4,0,5,5,22,22,44
1603,6617,17,12,27/7/2019,Cruzeiro,Athletico-PR,1,0,0,0,1,0,0,1,1,0,0,0
1604,6618,17,12,27/7/2019,Fluminense,Sao Paulo,1,3,0,0,1,3,0,4,4,20,14,34
1605,6619,17,12,27/7/2019,Internacional,Ceara,3,3,0,0,3,3,0,6,6,11,12,23
1606,6620,17,12,28/7/2019,Chapecoense,Bahia,1,1,0,0,1,1,0,2,2,16,15,31
1607,6621,17,12,28/7/2019,Flamengo,Botafogo-RJ,5,2,0,0,5,2,0,7,7,23,16,39
1608,6622,17,12,28/7/2019,Santos,Avai,2,2,0,0,2,2,0,4,4,9,13,22
1609,6623,17,12,28/7/2019,Goias,Atletico-MG,1,0,0,0,1,0,0,1,1,14,9,23
1610,6624,17,12,28/7/2019,Fortaleza,Corinthians,2,1,0,0,2,1,0,3,3,18,16,34
1611,6625,17,12,29/7/2019,CSA,Gremio,4,2,0,0,4,2,0,6,6,13,13,26
1612,6626,17,13,3/8/2019,Ceara,Fortaleza,3,1,0,1,3,2,1,4,5,14,16,30
1613,6627,17,13,3/8/2019,Fluminense,Internacional,1,2,0,0,1,2,0,3,3,8,12,20
1614,6628,17,13,4/8/2019,Santos,Goias,3,4,0,0,3,4,0,7,7,15,8,23
1615,6629,17,13,4/8/2019,Avai,Botafogo-RJ,2,1,1,0,3,1,1,3,4,12,11,23
1616,6630,17,13,4/8/2019,Bahia,Flamengo,1,1,1,0,2,1,1,2,3,18,14,32
1617,6631,17,13,4/8/2019,Corinthians,Palmeiras,1,3,0,0,1,3,0,4,4,11,24,35
1618,6632,17,13,4/8/2019,Vasco,CSA,4,1,0,0,4,1,0,5,5,13,14,27
1619,6633,17,13,4/8/2019,Atletico-MG,Cruzeiro,2,3,0,0,2,3,0,5,5,19,13,32
1620,6634,17,13,5/8/2019,Gremio,Chapecoense,4,3,0,0,4,3,0,7,7,17,16,33
1621,6635,17,13,21/8/2019,Athletico-PR,Sao Paulo,3,3,0,0,3,3,0,6,6,0,0,0
1622,6636,17,14,10/8/2019,Ceara,Chapecoense,3,2,0,0,3,2,0,5,5,20,11,31
1623,6637,17,14,10/8/2019,Sao Paulo,Santos,6,1,0,0,6,1,0,7,7,21,15,36
1624,6638,17,14,10/8/2019,Flamengo,Gremio,4,2,0,0,4,2,0,6,6,14,15,29
1625,6639,17,14,10/8/2019,Atletico-MG,Fluminense,4,3,0,1,4,4,1,7,8,14,13,27
1626,6640,17,14,11/8/2019,Internacional,Corinthians,3,2,0,0,3,2,0,5,5,16,8,24
1627,6641,17,14,11/8/2019,Palmeiras,Bahia,6,4,1,1,7,5,2,10,12,15,19,34
1628,6642,17,14,11/8/2019,Avai,Cruzeiro,4,2,1,1,5,3,2,6,8,15,15,30
1629,6643,17,14,11/8/2019,Botafogo-RJ,Athletico-PR,3,1,0,0,3,1,0,4,4,11,12,23
1630,6644,17,14,11/8/2019,Goias,Vasco,4,4,0,1,4,5,1,8,9,14,22,36
1631,6645,17,14,12/8/2019,CSA,Fortaleza,3,1,0,0,3,1,0,4,4,19,13,32
1632,6646,17,15,17/8/2019,Corinthians,Botafogo-RJ,2,3,0,0,2,3,0,5,5,17,13,30
1633,6647,17,15,17/8/2019,Fortaleza,Internacional,2,2,1,0,3,2,1,4,5,14,14,28
1634,6648,17,15,17/8/2019,Vasco,Flamengo,0,3,0,0,0,3,0,3,3,12,18,30
1635,6649,17,15,17/8/2019,Athletico-PR,Atletico-MG,3,1,0,0,3,1,0,4,4,0,0,0
1636,6651,17,15,18/8/2019,Fluminense,CSA,1,2,0,0,1,2,0,3,3,7,16,23
1637,6652,17,15,18/8/2019,Sao Paulo,Ceara,3,2,0,0,3,2,0,5,5,12,16,28
1638,6653,17,15,18/8/2019,Bahia,Goias,2,3,1,0,3,3,1,5,6,7,13,20
1639,6654,17,15,18/8/2019,Cruzeiro,Santos,2,0,0,1,2,1,1,2,3,16,7,23
1640,6655,17,15,18/8/2019,Chapecoense,Avai,1,0,0,0,1,0,0,1,1,25,15,40
1641,6656,17,16,24/8/2019,Atletico-MG,Bahia,0,2,0,0,0,2,0,2,2,17,16,33
1642,6657,17,16,24/8/2019,Gremio,Athletico-PR,3,1,0,0,3,1,0,4,4,0,0,0
1643,6658,17,16,25/8/2019,Goias,Internacional,2,2,1,0,3,2,1,4,5,9,14,23
1644,6659,17,16,25/8/2019,Vasco,Sao Paulo,4,3,0,1,4,4,1,7,8,19,16,35
1645,6660,17,16,25/8/2019,Santos,Fortaleza,3,3,0,0,3,3,0,6,6,14,22,36
1646,6661,17,16,25/8/2019,Ceara,Flamengo,3,0,0,0,3,0,0,3,3,11,14,25
1647,6662,17,16,25/8/2019,Avai,Corinthians,0,1,1,1,1,2,2,1,3,19,15,34
1648,6663,17,16,25/8/2019,CSA,Cruzeiro,3,3,0,0,3,3,0,6,6,17,14,31
1649,6664,17,16,26/8/2019,Botafogo-RJ,Chapecoense,2,1,0,0,2,1,0,3,3,13,16,29
1650,6665,17,16,10/9/2019,Palmeiras,Fluminense,0,2,0,0,0,2,0,2,2,12,11,23
1651,6666,17,17,31/8/2019,Sao Paulo,Gremio,1,1,1,0,2,1,1,2,3,10,9,19
1652,6667,17,17,31/8/2019,Bahia,CSA,1,1,0,0,1,1,0,2,2,15,17,32
1653,6668,17,17,31/8/2019,Chapecoense,Santos,2,4,0,0,2,4,0,6,6,17,19,36
1654,6669,17,17,31/8/2019,Athletico-PR,Ceara,1,3,0,0,1,3,0,4,4,14,15,29
1655,6670,17,17,31/8/2019,Internacional,Botafogo-RJ,4,4,0,0,4,4,0,8,8,10,6,16
1656,6671,17,17,1/9/2019,Flamengo,Palmeiras,2,2,0,1,2,3,1,4,5,15,16,31
1657,6672,17,17,1/9/2019,Fortaleza,Goias,3,2,0,1,3,3,1,5,6,21,14,35
1658,6673,17,17,1/9/2019,Cruzeiro,Vasco,3,4,0,0,3,4,0,7,7,14,15,29
1659,6674,17,17,1/9/2019,Corinthians,Atletico-MG,0,1,0,0,0,1,0,1,1,9,14,23
1660,6675,17,17,2/9/2019,Fluminense,Avai,3,1,0,0,3,1,0,4,4,14,15,29
1661,6676,17,18,7/9/2019,Vasco,Bahia,3,1,0,0,3,1,0,4,4,15,19,34
1662,6677,17,18,7/9/2019,Corinthians,Ceara,1,1,0,0,1,1,0,2,2,9,10,19
1663,6678,17,18,7/9/2019,Avai,Flamengo,1,2,1,0,2,2,1,3,4,15,9,24
1664,6679,17,18,7/9/2019,Fortaleza,Fluminense,1,2,0,0,1,2,0,3,3,13,15,28
1665,6680,17,18,7/9/2019,Internacional,Sao Paulo,1,5,0,0,1,5,0,6,6,14,16,30
1666,6681,17,18,7/9/2019,Goias,Palmeiras,5,1,0,1,5,2,1,6,7,11,21,32
1667,6682,17,18,8/9/2019,Cruzeiro,Gremio,2,1,0,0,2,1,0,3,3,11,10,21
1668,6683,17,18,8/9/2019,Santos,Athletico-PR,3,6,0,0,3,6,0,9,9,8,15,23
1669,6684,17,18,8/9/2019,Botafogo-RJ,Atletico-MG,4,3,0,1,4,4,1,7,8,14,14,28
1670,6685,17,18,8/9/2019,CSA,Chapecoense,3,2,0,2,3,4,2,5,7,22,14,36
1671,6686,17,19,14/9/2019,Flamengo,Santos,2,5,0,0,2,5,0,7,7,20,24,44
1672,6687,17,19,14/9/2019,Chapecoense,Vasco,2,5,0,0,2,5,0,7,7,14,22,36
1673,6688,17,19,14/9/2019,Palmeiras,Cruzeiro,2,3,0,0,2,3,0,5,5,20,19,39
1674,6689,17,19,14/9/2019,Ceara,Botafogo-RJ,1,1,0,0,1,1,0,2,2,11,5,16
1675,6690,17,19,15/9/2019,Athletico-PR,Avai,1,0,0,0,1,0,0,1,1,0,0,0
1676,6691,17,19,15/9/2019,Atletico-MG,Internacional,0,1,0,0,0,1,0,1,1,6,14,20
1677,6692,17,19,15/9/2019,Bahia,Fortaleza,1,1,0,0,1,1,0,2,2,16,11,27
1678,6693,17,19,15/9/2019,Gremio,Goias,0,1,0,0,0,1,0,1,1,10,10,20
1679,6694,17,19,15/9/2019,Fluminense,Corinthians,4,1,0,0,4,1,0,5,5,19,12,31
1680,6695,17,19,15/9/2019,Sao Paulo,CSA,1,3,0,0,1,3,0,4,4,14,16,30
1681,6696,17,20,21/9/2019,Botafogo-RJ,Sao Paulo,3,1,0,0,3,1,0,4,4,14,23,37
1682,6697,17,20,21/9/2019,Cruzeiro,Flamengo,2,2,0,0,2,2,0,4,4,9,14,23
1683,6698,17,20,21/9/2019,Corinthians,Bahia,2,4,0,0,2,4,0,6,6,12,15,27
1684,6699,17,20,21/9/2019,Santos,Gremio,1,4,0,0,1,4,0,5,5,13,15,28
1685,6700,17,20,22/9/2019,Internacional,Chapecoense,0,4,0,0,0,4,0,4,4,12,19,31
1686,6701,17,20,22/9/2019,Fortaleza,Palmeiras,4,1,0,0,4,1,0,5,5,16,11,27
1687,6702,17,20,22/9/2019,CSA,Ceara,1,2,0,0,1,2,0,3,3,20,9,29
1688,6703,17,20,22/9/2019,Vasco,Athletico-PR,3,3,0,0,3,3,0,6,6,0,0,0
1689,6704,17,20,22/9/2019,Goias,Fluminense,4,0,1,0,5,0,1,4,5,16,10,26
1690,6705,17,20,23/9/2019,Avai,Atletico-MG,3,1,0,0,3,1,0,4,4,11,14,25
1691,6706,17,21,25/9/2019,Ceara,Cruzeiro,2,3,0,0,2,3,0,5,5,18,17,35
1692,6707,17,21,25/9/2019,Bahia,Botafogo-RJ,1,0,0,1,1,1,1,1,2,17,9,26
1693,6708,17,21,25/9/2019,Flamengo,Internacional,1,1,0,2,1,3,2,2,4,16,6,22
1694,6709,17,21,25/9/2019,Sao Paulo,Goias,2,4,0,0,2,4,0,6,6,21,24,45
1695,6710,17,21,26/9/2019,Palmeiras,CSA,0,1,0,0,0,1,0,1,1,13,13,26
1696,6711,17,21,26/9/2019,Fluminense,Santos,2,3,2,1,4,4,3,5,8,12,15,27
1697,6712,17,21,26/9/2019,Gremio,Avai,1,1,0,0,1,1,0,2,2,18,9,27
1698,6713,17,21,26/9/2019,Athletico-PR,Fortaleza,3,0,0,0,3,0,0,3,3,11,8,19
1699,6714,17,21,2/10/2019,Atletico-MG,Vasco,3,2,0,0,3,2,0,5,5,18,22,40
1700,6715,17,21,2/10/2019,Chapecoense,Corinthians,3,2,0,0,3,2,0,5,5,19,15,34
1701,6716,17,22,28/9/2019,Flamengo,Sao Paulo,3,4,0,0,3,4,0,7,7,20,27,47
1702,6717,17,22,29/9/2019,Corinthians,Vasco,3,5,0,0,3,5,0,8,8,16,23,39
1703,6718,17,22,29/9/2019,Santos,CSA,1,2,1,0,2,2,1,3,4,13,12,25
1704,6719,17,22,29/9/2019,Internacional,Palmeiras,3,2,0,0,3,2,0,5,5,28,17,45
1705,6720,17,22,29/9/2019,Fluminense,Gremio,1,4,0,0,1,4,0,5,5,17,9,26
1706,6721,17,22,29/9/2019,Athletico-PR,Chapecoense,0,1,0,0,0,1,0,1,1,0,0,0
1707,6722,17,22,29/9/2019,Atletico-MG,Ceara,0,2,0,0,0,2,0,2,2,13,12,25
1708,6723,17,22,30/9/2019,Avai,Bahia,1,2,0,0,1,2,0,3,3,16,16,32
1709,6724,17,22,30/9/2019,Fortaleza,Botafogo-RJ,3,2,0,0,3,2,0,5,5,15,12,27
1710,6725,17,22,30/9/2019,Goias,Cruzeiro,0,3,0,0,0,3,0,3,3,20,19,39
1711,6726,17,23,5/10/2019,Vasco,Santos,4,2,0,1,4,3,1,6,7,15,17,32
1712,6727,17,23,5/10/2019,Sao Paulo,Fortaleza,3,2,0,0,3,2,0,5,5,15,14,29
1713,6728,17,23,5/10/2019,Gremio,Corinthians,3,2,0,0,3,2,0,5,5,12,12,24
1714,6729,17,23,5/10/2019,Bahia,Athletico-PR,2,3,0,0,2,3,0,5,5,9,14,23
1715,6730,17,23,5/10/2019,Cruzeiro,Internacional,5,3,0,0,5,3,0,8,8,18,14,32
1716,6731,17,23,6/10/2019,Chapecoense,Flamengo,1,0,0,0,1,0,0,1,1,16,20,36
1717,6732,17,23,6/10/2019,Ceara,Goias,1,0,0,0,1,0,0,1,1,7,12,19
1718,6733,17,23,6/10/2019,Palmeiras,Atletico-MG,3,4,0,0,3,4,0,7,7,12,20,32
1719,6734,17,23,6/10/2019,Botafogo-RJ,Fluminense,4,1,0,0,4,1,0,5,5,20,20,40
1720,6735,17,23,6/10/2019,CSA,Avai,3,3,0,0,3,3,0,6,6,10,11,21
1721,6736,17,24,9/10/2019,CSA,Internacional,2,2,0,0,2,2,0,4,4,16,9,25
1722,6737,17,24,9/10/2019,Botafogo-RJ,Goias,4,2,0,0,4,2,0,6,6,29,18,47
1723,6738,17,24,9/10/2019,Fortaleza,Chapecoense,4,2,0,0,4,2,0,6,6,18,17,35
1724,6739,17,24,9/10/2019,Bahia,Sao Paulo,2,1,0,0,2,1,0,3,3,10,15,25
1725,6740,17,24,9/10/2019,Gremio,Ceara,0,3,0,0,0,3,0,3,3,11,19,30
1726,6741,17,24,9/10/2019,Cruzeiro,Fluminense,4,3,0,0,4,3,0,7,7,17,18,35
1727,6742,17,24,9/10/2019,Santos,Palmeiras,1,2,0,1,1,3,1,3,4,16,13,29
1728,6743,17,24,10/10/2019,Corinthians,Athletico-PR,2,2,0,0,2,2,0,4,4,0,0,0
1729,6744,17,24,10/10/2019,Avai,Vasco,1,1,0,0,1,1,0,2,2,18,11,29
1730,6745,17,24,10/10/2019,Flamengo,Atletico-MG,0,3,0,0,0,3,0,3,3,10,9,19
1731,6746,17,25,12/10/2019,Goias,CSA,2,3,0,0,2,3,0,5,5,17,21,38
1732,6747,17,25,12/10/2019,Fluminense,Bahia,0,1,0,0,0,1,0,1,1,11,15,26
1733,6748,17,25,12/10/2019,Palmeiras,Botafogo-RJ,2,2,0,0,2,2,0,4,4,22,13,35
1734,6749,17,25,13/10/2019,Internacional,Santos,2,3,0,0,2,3,0,5,5,16,18,34
1735,6750,17,25,13/10/2019,Athletico-PR,Flamengo,2,4,0,0,2,4,0,6,6,0,0,0
1736,6751,17,25,13/10/2019,Ceara,Avai,1,3,0,0,1,3,0,4,4,16,16,32
1737,6752,17,25,13/10/2019,Vasco,Fortaleza,2,4,0,1,2,5,1,6,7,14,19,33
1738,6753,17,25,13/10/2019,Sao Paulo,Corinthians,0,1,0,0,0,1,0,1,1,9,10,19
1739,6754,17,25,13/10/2019,Atletico-MG,Gremio,4,1,1,0,5,1,1,5,6,17,8,25
1740,6755,17,25,13/10/2019,Chapecoense,Cruzeiro,1,1,0,0,1,1,0,2,2,12,13,25
1741,6756,17,26,16/10/2019,CSA,Atletico-MG,3,3,0,1,3,4,1,6,7,18,13,31
1742,6757,17,26,16/10/2019,Gremio,Bahia,3,2,0,0,3,2,0,5,5,13,15,28
1743,6758,17,26,16/10/2019,Fortaleza,Flamengo,1,3,0,0,1,3,0,4,4,8,16,24
1744,6759,17,26,16/10/2019,Cruzeiro,Sao Paulo,2,2,0,0,2,2,0,4,4,18,16,34
1745,6760,17,26,16/10/2019,Palmeiras,Chapecoense,1,3,0,1,1,4,1,4,5,15,14,29
1746,6761,17,26,16/10/2019,Goias,Corinthians,3,4,2,0,5,4,2,7,9,10,16,26
1747,6762,17,26,16/10/2019,Vasco,Botafogo-RJ,1,0,0,0,1,0,0,1,1,15,11,26
1748,6763,17,26,17/10/2019,Avai,Internacional,1,3,1,0,2,3,1,4,5,7,16,23
1749,6764,17,26,17/10/2019,Santos,Ceara,3,4,0,0,3,4,0,7,7,15,11,26
1750,6765,17,26,17/10/2019,Fluminense,Athletico-PR,0,1,0,0,0,1,0,1,1,0,0,0
1751,6766,17,27,19/10/2019,Fortaleza,Gremio,4,2,0,1,4,3,1,6,7,13,17,30
1752,6767,17,27,19/10/2019,Corinthians,Cruzeiro,3,1,0,0,3,1,0,4,4,15,18,33
1753,6768,17,27,20/10/2019,Internacional,Vasco,3,1,0,0,3,1,0,4,4,14,12,26
1754,6769,17,27,20/10/2019,Sao Paulo,Avai,4,1,0,1,4,2,1,5,6,23,11,34
1755,6770,17,27,20/10/2019,Atletico-MG,Santos,3,4,0,0,3,4,0,7,7,24,14,38
1756,6771,17,27,20/10/2019,Flamengo,Fluminense,3,5,0,0,3,5,0,8,8,23,13,36
1757,6772,17,27,20/10/2019,Chapecoense,Goias,2,5,0,0,2,5,0,7,7,23,14,37
1758,6773,17,27,20/10/2019,Athletico-PR,Palmeiras,1,2,0,0,1,2,0,3,3,23,11,34
1759,6774,17,27,21/10/2019,Bahia,Ceara,2,3,0,0,2,3,0,5,5,14,11,25
1760,6775,17,27,21/10/2019,Botafogo-RJ,CSA,2,2,0,1,2,3,1,4,5,18,16,34
1761,6776,17,28,26/10/2019,Corinthians,Santos,3,1,0,0,3,1,0,4,4,20,12,32
1762,6777,17,28,26/10/2019,Ceara,Vasco,3,3,0,0,3,3,0,6,6,11,14,25
1763,6778,17,28,26/10/2019,Bahia,Internacional,1,5,0,0,1,5,0,6,6,16,11,27
1764,6779,17,28,26/10/2019,Fluminense,Chapecoense,1,4,0,0,1,4,0,5,5,11,14,25
1765,6780,17,28,26/10/2019,Cruzeiro,Fortaleza,3,1,0,0,3,1,0,4,4,0,0,0
1766,6781,17,28,27/10/2019,Athletico-PR,Goias,1,1,0,0,1,1,0,2,2,0,0,0
1767,6782,17,28,27/10/2019,Gremio,Botafogo-RJ,3,2,0,0,3,2,0,5,5,13,9,22
1768,6784,17,28,27/10/2019,Avai,Palmeiras,3,2,0,0,3,2,0,5,5,18,17,35
1769,6785,17,28,27/10/2019,Flamengo,CSA,1,2,0,0,1,2,0,3,3,20,13,33
1770,6787,17,29,30/10/2019,Avai,Fortaleza,4,1,1,0,5,1,1,5,6,20,10,30
1771,6788,17,29,30/10/2019,Atletico-MG,Chapecoense,3,3,0,0,3,3,0,6,6,15,10,25
1772,6789,17,29,30/10/2019,Ceara,Fluminense,1,1,0,0,1,1,0,2,2,12,8,20
1773,6790,17,29,30/10/2019,Vasco,Gremio,2,2,0,0,2,2,0,4,4,9,13,22
1774,6791,17,29,30/10/2019,CSA,Corinthians,6,2,0,0,6,2,0,8,8,17,10,27
1775,6792,17,29,31/10/2019,Santos,Bahia,5,3,0,0,5,3,0,8,8,17,26,43
1776,6793,17,29,31/10/2019,Goias,Flamengo,5,3,0,1,5,4,1,8,9,18,15,33
1777,6794,17,29,31/10/2019,Internacional,Athletico-PR,3,2,0,0,3,2,0,5,5,14,22,36
1778,6795,17,29,31/10/2019,Botafogo-RJ,Cruzeiro,1,3,0,0,1,3,0,4,4,15,15,30
1779,6796,17,30,2/11/2019,Fortaleza,Atletico-MG,3,3,0,1,3,4,1,6,7,18,19,37
1780,6797,17,30,2/11/2019,Fluminense,Vasco,2,3,0,0,2,3,0,5,5,7,12,19
1781,6798,17,30,2/11/2019,Palmeiras,Ceara,2,2,0,0,2,2,0,4,4,14,19,33
1782,6799,17,30,2/11/2019,Chapecoense,Sao Paulo,2,2,0,0,2,2,0,4,4,19,11,30
1783,6800,17,30,3/11/2019,Flamengo,Corinthians,0,1,0,0,0,1,0,1,1,12,10,22
1784,6801,17,30,3/11/2019,Athletico-PR,CSA,3,4,0,0,3,4,0,7,7,0,0,0
1785,6802,17,30,3/11/2019,Gremio,Internacional,2,2,0,1,2,3,1,4,5,16,16,32
1786,6803,17,30,3/11/2019,Santos,Botafogo-RJ,1,0,0,0,1,0,0,1,1,16,8,24
1787,6804,17,30,3/11/2019,Cruzeiro,Bahia,3,0,1,0,4,0,1,3,4,16,11,27
1788,6805,17,30,3/11/2019,Goias,Avai,1,3,0,0,1,3,0,4,4,19,19,38
1789,6806,17,31,6/11/2019,Corinthians,Fortaleza,2,3,0,0,2,3,0,5,5,18,9,27
1790,6807,17,31,6/11/2019,Atletico-MG,Goias,0,2,0,0,0,2,0,2,2,15,16,31
1791,6808,17,31,6/11/2019,Avai,Santos,5,2,1,1,6,3,2,7,9,19,11,30
1792,6809,17,31,6/11/2019,Athletico-PR,Cruzeiro,3,1,0,1,3,2,1,4,5,0,0,0
1793,6810,17,31,6/11/2019,Vasco,Palmeiras,7,4,1,0,8,4,1,11,12,17,27,44
1794,6811,17,31,6/11/2019,Bahia,Chapecoense,1,3,0,0,1,3,0,4,4,20,16,36
1795,6812,17,31,7/11/2019,Ceara,Internacional,2,2,0,0,2,2,0,4,4,8,11,19
1796,6813,17,31,7/11/2019,Sao Paulo,Fluminense,2,1,0,0,2,1,0,3,3,6,16,22
1797,6814,17,31,7/11/2019,Botafogo-RJ,Flamengo,5,2,1,0,6,2,1,7,8,16,14,30
1798,6815,17,31,7/11/2019,Gremio,CSA,3,2,0,0,3,2,0,5,5,15,16,31
1799,6816,17,32,9/11/2019,Goias,Santos,4,2,0,0,4,2,0,6,6,19,16,35
1800,6817,17,32,9/11/2019,Palmeiras,Corinthians,2,1,0,0,2,1,0,3,3,12,18,30
1801,6818,17,32,10/11/2019,Internacional,Fluminense,3,2,0,0,3,2,0,5,5,16,9,25
1802,6819,17,32,10/11/2019,Cruzeiro,Atletico-MG,1,1,0,0,1,1,0,2,2,9,12,21
1803,6820,17,32,10/11/2019,Sao Paulo,Athletico-PR,2,2,0,0,2,2,0,4,4,0,0,0
1804,6821,17,32,10/11/2019,Flamengo,Bahia,1,0,0,0,1,0,0,1,1,10,11,21
1805,6822,17,32,10/11/2019,Chapecoense,Gremio,2,2,0,0,2,2,0,4,4,10,13,23
1806,6823,17,32,10/11/2019,Fortaleza,Ceara,4,4,0,0,4,4,0,8,8,13,17,30
1807,6824,17,32,10/11/2019,CSA,Vasco,2,2,1,0,3,2,1,4,5,17,18,35
1808,6825,17,32,11/11/2019,Botafogo-RJ,Avai,4,3,0,1,4,4,1,7,8,19,16,35
1809,6826,17,34,13/11/2019,Flamengo,Vasco,6,5,0,0,6,5,0,11,11,23,25,48
1810,6827,17,34,23/11/2019,Santos,Cruzeiro,2,2,0,0,2,2,0,4,4,16,19,35
1811,6828,17,34,24/11/2019,Palmeiras,Gremio,2,3,0,0,2,3,0,5,5,14,14,28
1812,6829,17,34,24/11/2019,Atletico-MG,Athletico-PR,3,2,0,0,3,2,0,5,5,0,0,0
1813,6830,17,34,24/11/2019,Goias,Bahia,2,2,0,0,2,2,0,4,4,14,23,37
1814,6831,17,34,24/11/2019,Botafogo-RJ,Corinthians,4,2,0,0,4,2,0,6,6,11,19,30
1815,6832,17,34,24/11/2019,Ceara,Sao Paulo,3,1,0,0,3,1,0,4,4,12,16,28
1816,6833,17,34,24/11/2019,Internacional,Fortaleza,4,2,0,0,4,2,0,6,6,16,12,28
1817,6834,17,34,24/11/2019,Avai,Chapecoense,0,1,1,1,1,2,2,1,3,11,15,26
1818,6835,17,34,25/11/2019,CSA,Fluminense,2,2,0,0,2,2,0,4,4,15,14,29
1819,6836,17,33,16/11/2019,Santos,Sao Paulo,0,3,0,0,0,3,0,3,3,14,25,39
1820,6837,17,33,16/11/2019,Fluminense,Atletico-MG,2,3,0,0,2,3,0,5,5,15,15,30
1821,6838,17,33,17/11/2019,Gremio,Flamengo,1,3,0,1,1,4,1,4,5,9,15,24
1822,6839,17,33,17/11/2019,Bahia,Palmeiras,2,0,0,0,2,0,0,2,2,17,16,33
1823,6840,17,33,17/11/2019,Chapecoense,Ceara,2,1,0,0,2,1,0,3,3,13,15,28
1824,6841,17,33,17/11/2019,Athletico-PR,Botafogo-RJ,4,1,0,0,4,1,0,5,5,0,0,0
1825,6842,17,33,17/11/2019,Corinthians,Internacional,0,2,0,0,0,2,0,2,2,9,19,28
1826,6843,17,33,17/11/2019,Fortaleza,CSA,0,1,0,0,0,1,0,1,1,10,20,30
1827,6844,17,33,18/11/2019,Vasco,Goias,2,2,0,0,2,2,0,4,4,22,16,38
1828,6845,17,33,18/11/2019,Cruzeiro,Avai,3,2,0,0,3,2,0,5,5,14,20,34
1829,6846,17,35,27/11/2019,Internacional,Goias,2,4,0,0,2,4,0,6,6,22,24,46
1830,6847,17,35,27/11/2019,Chapecoense,Botafogo-RJ,2,3,0,0,2,3,0,5,5,12,18,30
1831,6848,17,35,27/11/2019,Bahia,Atletico-MG,1,1,0,0,1,1,0,2,2,12,20,32
1832,6849,17,35,27/11/2019,Athletico-PR,Gremio,3,4,0,1,3,5,1,7,8,0,0,0
1833,6850,17,35,27/11/2019,Flamengo,Ceara,2,1,0,1,2,2,1,3,4,13,10,23
1834,6851,17,35,27/11/2019,Corinthians,Avai,0,1,0,0,0,1,0,1,1,15,13,28
1835,6852,17,35,28/11/2019,Fluminense,Palmeiras,3,4,0,0,3,4,0,7,7,15,20,35
1836,6853,17,35,28/11/2019,Fortaleza,Santos,2,8,0,2,2,10,2,10,12,16,17,33
1837,6854,17,35,28/11/2019,Sao Paulo,Vasco,4,2,0,0,4,2,0,6,6,29,16,45
1838,6855,17,35,28/11/2019,Cruzeiro,CSA,0,4,0,0,0,4,0,4,4,9,16,25
1839,6856,17,36,30/11/2019,Botafogo-RJ,Internacional,2,3,0,0,2,3,0,5,5,8,14,22
1840,6857,17,36,30/11/2019,Ceara,Athletico-PR,7,2,0,1,7,3,1,9,10,17,16,33
1841,6858,17,36,1/12/2019,Avai,Fluminense,4,5,0,0,4,5,0,9,9,26,20,46
1842,6859,17,36,1/12/2019,Palmeiras,Flamengo,1,2,0,0,1,2,0,3,3,18,21,39
1843,6860,17,36,1/12/2019,Goias,Fortaleza,1,4,0,0,1,4,0,5,5,11,15,26
1844,6861,17,36,1/12/2019,CSA,Bahia,3,4,0,1,3,5,1,7,8,9,12,21
1845,6862,17,36,1/12/2019,Atletico-MG,Corinthians,3,1,0,0,3,1,0,4,4,15,8,23
1846,6863,17,36,1/12/2019,Santos,Chapecoense,3,4,0,0,3,4,0,7,7,18,19,37
1847,6865,17,36,2/12/2019,Vasco,Cruzeiro,3,3,0,0,3,3,0,6,6,16,19,35
1848,6866,17,37,4/12/2019,Athletico-PR,Santos,2,4,0,1,2,5,1,6,7,16,9,25
1849,6867,17,37,4/12/2019,Ceara,Corinthians,3,4,1,0,4,4,1,7,8,15,14,29
1850,6868,17,37,4/12/2019,Atletico-MG,Botafogo-RJ,1,3,0,0,1,3,0,4,4,11,10,21
1851,6869,17,37,4/12/2019,Chapecoense,CSA,1,2,0,1,1,3,1,3,4,21,13,34
1852,6870,17,37,4/12/2019,Fluminense,Fortaleza,2,1,1,1,3,2,2,3,5,16,9,25
1853,6871,17,37,4/12/2019,Sao Paulo,Internacional,3,4,0,0,3,4,0,7,7,20,19,39
1854,6872,17,37,5/12/2019,Gremio,Cruzeiro,0,4,0,1,0,5,1,4,5,11,21,32
1855,6873,17,37,5/12/2019,Palmeiras,Goias,5,1,0,0,5,1,0,6,6,21,13,34
1856,6874,17,37,5/12/2019,Bahia,Vasco,3,2,1,1,4,3,2,5,7,21,11,32
1857,6875,17,37,5/12/2019,Flamengo,Avai,0,1,0,0,0,1,0,1,1,18,13,31
1858,6876,17,38,8/12/2019,Corinthians,Fluminense,1,3,0,0,1,3,0,4,4,21,14,35
1859,6877,17,38,8/12/2019,Santos,Flamengo,2,3,0,0,2,3,0,5,5,12,15,27
1860,6878,17,38,8/12/2019,Botafogo-RJ,Ceara,0,2,0,0,0,2,0,2,2,12,19,31
1861,6879,17,38,8/12/2019,CSA,Sao Paulo,1,3,0,1,1,4,1,4,5,17,24,41
1862,6880,17,38,8/12/2019,Internacional,Atletico-MG,4,1,0,0,4,1,0,5,5,11,16,27
1863,6881,17,38,8/12/2019,Cruzeiro,Palmeiras,0,1,0,0,0,1,0,1,1,11,11,22
1864,6882,17,38,8/12/2019,Goias,Gremio,1,1,0,0,1,1,0,2,2,21,8,29
1865,6883,17,38,8/12/2019,Vasco,Chapecoense,2,3,0,0,2,3,0,5,5,18,16,34
1866,6884,17,38,8/12/2019,Avai,Athletico-PR,2,1,0,0,2,1,0,3,3,0,0,0
1867,6885,17,38,8/12/2019,Fortaleza,Bahia,2,1,0,0,2,1,0,3,3,9,15,24
1868,6886,18,1,8/8/2020,Fortaleza,Athletico-PR,3,2,1,0,4,2,1,5,6,14,10,24
1869,6887,18,1,8/8/2020,Coritiba,Internacional,3,4,0,0,3,4,0,7,7,11,21,32
1870,6888,18,1,8/8/2020,Sport,Ceara,3,3,0,0,3,3,0,6,6,15,18,33
1871,6889,18,1,9/8/2020,Santos,Bragantino,0,1,0,0,0,1,0,1,1,10,19,29
1872,6890,18,1,9/8/2020,Flamengo,Atletico-MG,3,2,0,0,3,2,0,5,5,12,24,36
1873,6891,18,1,9/8/2020,Gremio,Fluminense,2,3,0,0,2,3,0,5,5,24,16,40
1874,6892,18,1,30/9/2020,Corinthians,Atletico-GO,2,0,0,0,2,0,0,2,2,18,12,30
1875,6893,18,1,30/9/2020,Botafogo-RJ,Bahia,2,3,1,0,3,3,1,5,6,18,14,32
1876,6894,18,1,3/12/2020,Goias,Sao Paulo,3,0,0,0,3,0,0,3,3,16,19,35
1877,6895,18,1,26/1/2021,Palmeiras,Vasco,1,1,0,0,1,1,0,2,2,19,11,30
1878,6896,18,2,12/8/2020,Athletico-PR,Goias,3,3,0,0,3,3,0,6,6,16,18,34
1879,6897,18,2,12/8/2020,Atletico-MG,Corinthians,0,1,0,0,0,1,0,1,1,19,11,30
1880,6898,18,2,12/8/2020,Bragantino,Botafogo-RJ,3,1,0,0,3,1,0,4,4,13,8,21
1881,6899,18,2,12/8/2020,Bahia,Coritiba,0,5,0,0,0,5,0,5,5,16,18,34
1882,6900,18,2,12/8/2020,Atletico-GO,Flamengo,1,1,0,1,1,2,1,2,3,15,19,34
1883,6901,18,2,12/8/2020,Ceara,Gremio,3,1,0,0,3,1,0,4,4,17,7,24
1884,6902,18,2,12/8/2020,Fluminense,Palmeiras,3,3,0,0,3,3,0,6,6,20,31,51
1885,6903,18,2,13/8/2020,Sao Paulo,Fortaleza,1,2,0,0,1,2,0,3,3,16,18,34
1886,6904,18,2,13/8/2020,Internacional,Santos,2,3,0,0,2,3,0,5,5,28,14,42
1887,6905,18,2,13/8/2020,Vasco,Sport,2,3,0,1,2,4,1,5,6,29,17,46
1888,6906,18,3,15/8/2020,Gremio,Corinthians,2,3,0,0,2,3,0,5,5,16,14,30
1889,6907,18,3,15/8/2020,Coritiba,Flamengo,5,3,1,0,6,3,1,8,9,25,16,41
1890,6908,18,3,15/8/2020,Palmeiras,Goias,1,3,0,0,1,3,0,4,4,11,16,27
1891,6909,18,3,16/8/2020,Atletico-MG,Ceara,2,4,0,0,2,4,0,6,6,14,16,30
1892,6910,18,3,16/8/2020,Bahia,Bragantino,1,1,0,0,1,1,0,2,2,16,16,32
1893,6911,18,3,16/8/2020,Vasco,Sao Paulo,2,5,0,0,2,5,0,7,7,16,15,31
1894,6912,18,3,16/8/2020,Fluminense,Internacional,2,2,0,0,2,2,0,4,4,13,24,37
1895,6913,18,3,16/8/2020,Atletico-GO,Sport,1,2,1,0,2,2,1,3,4,13,15,28
1896,6914,18,3,16/8/2020,Fortaleza,Botafogo-RJ,2,1,0,0,2,1,0,3,3,9,8,17
1897,6915,18,3,16/8/2020,Santos,Athletico-PR,1,1,0,0,1,1,0,2,2,9,22,31
1898,6916,18,4,19/8/2020,Flamengo,Gremio,3,3,0,0,3,3,0,6,6,17,20,37
1899,6917,18,4,19/8/2020,Bragantino,Fluminense,5,5,0,0,5,5,0,10,10,19,14,33
1900,6918,18,4,19/8/2020,Athletico-PR,Palmeiras,5,0,0,0,5,0,0,5,5,23,20,43
1901,6919,18,4,19/8/2020,Goias,Fortaleza,4,2,0,0,4,2,0,6,6,16,15,31
1902,6920,18,4,19/8/2020,Internacional,Atletico-GO,3,3,1,0,4,3,1,6,7,19,17,36
1903,6921,18,4,19/8/2020,Corinthians,Coritiba,2,1,0,1,2,2,1,3,4,15,7,22
1904,6922,18,4,19/8/2020,Botafogo-RJ,Atletico-MG,2,0,0,0,2,0,0,2,2,9,10,19
1905,6923,18,4,20/8/2020,Sport,Santos,5,2,0,0,5,2,0,7,7,23,17,40
1906,6924,18,4,20/8/2020,Ceara,Vasco,3,3,0,0,3,3,0,6,6,18,14,32
1907,6925,18,4,20/8/2020,Sao Paulo,Bahia,2,2,0,0,2,2,0,4,4,14,16,30
1908,6926,18,5,22/8/2020,Athletico-PR,Fluminense,4,3,0,0,4,3,0,7,7,21,12,33
1909,6927,18,5,22/8/2020,Internacional,Atletico-MG,1,2,0,0,1,2,0,3,3,20,21,41
1910,6928,18,5,22/8/2020,Goias,Atletico-GO,5,2,0,0,5,2,0,7,7,26,19,45
1911,6929,18,5,23/8/2020,Flamengo,Botafogo-RJ,3,3,0,0,3,3,0,6,6,15,17,32
1912,6930,18,5,23/8/2020,Vasco,Gremio,5,2,0,0,5,2,0,7,7,23,17,40
1913,6931,18,5,23/8/2020,Palmeiras,Santos,5,3,0,1,5,4,1,8,9,21,15,36
1914,6932,18,5,23/8/2020,Bragantino,Coritiba,2,0,1,0,3,0,1,2,3,17,18,35
1915,6933,18,5,23/8/2020,Sport,Sao Paulo,2,3,0,0,2,3,0,5,5,21,25,46
1916,6934,18,5,23/8/2020,Ceara,Bahia,1,2,0,0,1,2,0,3,3,21,7,28
1917,6935,18,5,26/8/2020,Corinthians,Fortaleza,0,2,0,0,0,2,0,2,2,14,12,26
1918,6936,18,11,26/8/2020,Sao Paulo,Athletico-PR,2,1,0,0,2,1,0,3,3,13,16,29
1919,6937,18,11,16/9/2020,Corinthians,Bahia,3,2,0,0,3,2,0,5,5,15,13,28
1920,6938,18,11,19/9/2020,Fortaleza,Internacional,1,3,0,0,1,3,0,4,4,9,20,29
1921,6939,18,11,19/9/2020,Bragantino,Ceara,4,3,0,0,4,3,0,7,7,24,11,35
1922,6940,18,11,19/9/2020,Atletico-GO,Atletico-MG,2,0,0,0,2,0,0,2,2,16,14,30
1923,6941,18,11,20/9/2020,Gremio,Palmeiras,2,3,0,0,2,3,0,5,5,21,21,42
1924,6942,18,11,20/9/2020,Coritiba,Vasco,1,2,0,0,1,2,0,3,3,14,15,29
1925,6943,18,11,20/9/2020,Botafogo-RJ,Santos,4,2,0,0,4,2,0,6,6,15,13,28
1926,6944,18,11,20/9/2020,Sport,Fluminense,0,1,0,0,0,1,0,1,1,10,9,19
1927,6945,18,11,13/10/2020,Flamengo,Goias,1,4,0,0,1,4,0,5,5,12,12,24
1928,6946,18,6,29/8/2020,Botafogo-RJ,Internacional,3,1,0,0,3,1,0,4,4,14,24,38
1929,6947,18,6,29/8/2020,Fluminense,Vasco,4,1,0,1,4,2,1,5,6,19,16,35
1930,6948,18,6,29/8/2020,Bahia,Palmeiras,2,2,0,0,2,2,0,4,4,15,16,31
1931,6949,18,6,29/8/2020,Fortaleza,Bragantino,2,2,0,1,2,3,1,4,5,22,10,32
1932,6950,18,6,30/8/2020,Sao Paulo,Corinthians,3,0,0,0,3,0,0,3,3,16,22,38
1933,6951,18,6,30/8/2020,Coritiba,Sport,1,4,0,0,1,4,0,5,5,14,19,33
1934,6952,18,6,30/8/2020,Santos,Flamengo,6,7,0,0,6,7,0,13,13,14,26,40
1935,6953,18,6,30/8/2020,Atletico-GO,Ceara,1,2,1,0,2,2,1,3,4,16,11,27
1936,6954,18,6,18/11/2020,Atletico-MG,Athletico-PR,1,2,0,0,1,2,0,3,3,8,24,32
1937,6955,18,6,30/11/2020,Gremio,Goias,2,2,0,0,2,2,0,4,4,15,17,32
1938,6956,18,7,2/9/2020,Ceara,Fortaleza,2,2,0,0,2,2,0,4,4,22,18,40
1939,6957,18,7,2/9/2020,Fluminense,Atletico-GO,3,1,1,0,4,1,1,4,5,14,16,30
1940,6958,18,7,2/9/2020,Goias,Corinthians,1,3,0,0,1,3,0,4,4,16,12,28
1941,6959,18,7,2/9/2020,Botafogo-RJ,Coritiba,1,1,0,0,1,1,0,2,2,23,21,44
1942,6960,18,7,2/9/2020,Athletico-PR,Bragantino,2,2,0,0,2,2,0,4,4,15,12,27
1943,6961,18,7,2/9/2020,Bahia,Flamengo,1,2,0,0,1,2,0,3,3,8,17,25
1944,6962,18,7,2/9/2020,Palmeiras,Internacional,3,5,0,0,3,5,0,8,8,21,23,44
1945,6963,18,7,2/9/2020,Santos,Vasco,2,3,0,0,2,3,0,5,5,17,21,38
1946,6964,18,7,3/9/2020,Gremio,Sport,1,5,0,0,1,5,0,6,6,10,11,21
1947,6966,18,8,5/9/2020,Flamengo,Fortaleza,1,1,0,0,1,1,0,2,2,12,21,33
1948,6967,18,8,5/9/2020,Corinthians,Botafogo-RJ,3,1,0,0,3,1,0,4,4,18,10,28
1949,6968,18,8,5/9/2020,Ceara,Santos,3,4,2,2,5,6,4,7,11,21,16,37
1950,6969,18,8,6/9/2020,Bragantino,Palmeiras,1,3,1,0,2,3,1,4,5,23,12,35
1951,6970,18,8,6/9/2020,Internacional,Bahia,2,3,0,0,2,3,0,5,5,11,12,23
1952,6971,18,8,6/9/2020,Sao Paulo,Fluminense,3,0,0,0,3,0,0,3,3,21,13,34
1953,6972,18,8,6/9/2020,Vasco,Athletico-PR,1,1,0,0,1,1,0,2,2,7,16,23
1954,6973,18,8,6/9/2020,Atletico-GO,Gremio,1,3,0,1,1,4,1,4,5,16,13,29
1955,6974,18,8,6/9/2020,Sport,Goias,1,0,0,0,1,0,0,1,1,18,17,35
1956,6975,18,8,6/9/2020,Coritiba,Atletico-MG,1,3,0,0,1,3,0,4,4,14,19,33
1957,6976,18,9,9/9/2020,Athletico-PR,Botafogo-RJ,1,0,0,0,1,0,0,1,1,19,10,29
1958,6977,18,9,9/9/2020,Fortaleza,Sport,5,1,0,0,5,1,0,6,6,27,14,41
1959,6978,18,9,9/9/2020,Goias,Coritiba,5,2,1,1,6,3,2,7,9,27,13,40
1960,6979,18,9,9/9/2020,Sao Paulo,Bragantino,4,2,0,0,4,2,0,6,6,18,18,36
1961,6980,18,9,9/9/2020,Fluminense,Flamengo,1,1,0,0,1,1,0,2,2,15,16,31
1962,6981,18,9,9/9/2020,Santos,Atletico-MG,1,2,0,1,1,3,1,3,4,11,15,26
1963,6982,18,9,10/9/2020,Internacional,Ceara,0,2,0,0,0,2,0,2,2,15,16,31
1964,6983,18,9,10/9/2020,Corinthians,Palmeiras,3,2,2,0,5,2,2,5,7,13,16,29
1965,6984,18,9,10/9/2020,Bahia,Gremio,1,3,1,1,2,4,2,4,6,12,9,21
1966,6985,18,9,10/9/2020,Vasco,Atletico-GO,2,1,1,0,3,1,1,3,4,15,23,38
1967,6986,18,10,12/9/2020,Athletico-PR,Coritiba,4,1,0,1,4,2,1,5,6,21,12,33
1968,6987,18,10,12/9/2020,Santos,Sao Paulo,3,2,0,0,3,2,0,5,5,18,20,38
1969,6988,18,10,13/9/2020,Fluminense,Corinthians,2,4,1,0,3,4,1,6,7,14,15,29
1970,6989,18,10,13/9/2020,Gremio,Fortaleza,1,2,1,1,2,3,2,3,5,11,13,24
1971,6990,18,10,13/9/2020,Atletico-MG,Bragantino,1,1,0,0,1,1,0,2,2,13,18,31
1972,6991,18,10,13/9/2020,Bahia,Atletico-GO,2,2,1,0,3,2,1,4,5,16,20,36
1973,6992,18,10,13/9/2020,Ceara,Flamengo,1,0,0,0,1,0,0,1,1,8,6,14
1974,6993,18,10,13/9/2020,Goias,Internacional,4,3,1,0,5,3,1,7,8,10,14,24
1975,6994,18,10,13/9/2020,Palmeiras,Sport,2,3,1,1,3,4,2,5,7,15,12,27
1976,6995,18,10,13/9/2020,Botafogo-RJ,Vasco,2,2,0,0,2,2,0,4,4,18,8,26
1977,6996,18,12,23/9/2020,Sport,Corinthians,3,4,0,0,3,4,0,7,7,11,15,26
1978,6997,18,12,26/9/2020,Athletico-PR,Bahia,4,1,0,0,4,1,0,5,5,20,11,31
1979,6998,18,12,26/9/2020,Internacional,Sao Paulo,2,0,1,0,3,0,1,2,3,16,16,32
1980,6999,18,12,26/9/2020,Atletico-MG,Gremio,1,1,0,0,1,1,0,2,2,20,11,31
1981,7000,18,12,27/9/2020,Vasco,Bragantino,2,1,0,0,2,1,0,3,3,9,16,25
1982,7001,18,12,27/9/2020,Palmeiras,Flamengo,4,2,0,0,4,2,0,6,6,14,16,30
1983,7002,18,12,27/9/2020,Ceara,Goias,3,4,0,0,3,4,0,7,7,13,14,27
1984,7003,18,12,27/9/2020,Atletico-GO,Botafogo-RJ,2,3,0,0,2,3,0,5,5,16,12,28
1985,7004,18,12,27/9/2020,Santos,Fortaleza,1,1,0,0,1,1,0,2,2,12,20,32
1986,7005,18,12,28/9/2020,Fluminense,Coritiba,1,1,0,1,1,2,1,2,3,16,19,35
1987,7006,18,13,3/10/2020,Gremio,Internacional,1,1,1,1,2,2,2,2,4,15,16,31
1988,7007,18,13,3/10/2020,Palmeiras,Ceara,1,4,0,0,1,4,0,5,5,10,20,30
1989,7008,18,13,3/10/2020,Bragantino,Corinthians,1,2,0,0,1,2,0,3,3,18,13,31
1990,7009,18,13,4/10/2020,Botafogo-RJ,Fluminense,0,1,0,0,0,1,0,1,1,20,21,41
1991,7010,18,13,4/10/2020,Coritiba,Sao Paulo,2,3,0,0,2,3,0,5,5,13,12,25
1992,7011,18,13,4/10/2020,Flamengo,Athletico-PR,3,4,0,0,3,4,0,7,7,18,22,40
1993,7012,18,13,4/10/2020,Fortaleza,Atletico-GO,5,5,0,0,5,5,0,10,10,8,14,22
1994,7013,18,13,4/10/2020,Goias,Santos,4,3,1,1,5,4,2,7,9,16,15,31
1995,7014,18,13,4/10/2020,Bahia,Sport,2,3,0,0,2,3,0,5,5,15,13,28
1996,7015,18,13,4/10/2020,Atletico-MG,Vasco,3,3,0,1,3,4,1,6,7,0,0,0
1997,7016,18,14,7/10/2020,Corinthians,Santos,2,2,0,0,2,2,0,4,4,19,16,35
1998,7017,18,14,7/10/2020,Flamengo,Sport,0,3,0,0,0,3,0,3,3,14,16,30
1999,7018,18,14,7/10/2020,Bahia,Vasco,4,3,0,1,4,4,1,7,8,18,15,33
2000,7019,18,14,7/10/2020,Gremio,Coritiba,2,2,0,0,2,2,0,4,4,18,21,39
2001,7020,18,14,7/10/2020,Sao Paulo,Atletico-GO,3,2,0,0,3,2,0,5,5,17,12,29
2002,7021,18,14,7/10/2020,Goias,Fluminense,3,2,0,0,3,2,0,5,5,19,15,34
2003,7022,18,14,7/10/2020,Botafogo-RJ,Palmeiras,4,4,0,0,4,4,0,8,8,16,15,31
2004,7023,18,14,7/10/2020,Fortaleza,Atletico-MG,3,3,1,0,4,3,1,6,7,9,19,28
2005,7024,18,14,8/10/2020,Athletico-PR,Ceara,3,2,0,0,3,2,0,5,5,11,12,23
2006,7025,18,14,8/10/2020,Bragantino,Internacional,3,3,1,0,4,3,1,6,7,18,22,40
2007,7026,18,15,10/10/2020,Vasco,Flamengo,2,5,0,0,2,5,0,7,7,14,25,39
2008,7027,18,15,10/10/2020,Coritiba,Fortaleza,1,0,0,0,1,0,0,1,1,20,12,32
2009,7028,18,15,10/10/2020,Palmeiras,Sao Paulo,2,1,0,0,2,1,0,3,3,15,17,32
2010,7029,18,15,10/10/2020,Atletico-MG,Goias,0,1,0,0,0,1,0,1,1,14,11,25
2011,7030,18,15,11/10/2020,Fluminense,Bahia,2,3,0,0,2,3,0,5,5,26,18,44
2012,7031,18,15,11/10/2020,Santos,Gremio,2,3,0,1,2,4,1,5,6,17,14,31
2013,7032,18,15,11/10/2020,Sport,Botafogo-RJ,3,2,0,1,3,3,1,5,6,11,15,26
2014,7033,18,15,11/10/2020,Atletico-GO,Bragantino,1,1,0,0,1,1,0,2,2,17,18,35
2015,7034,18,15,11/10/2020,Ceara,Corinthians,4,1,1,1,5,2,2,5,7,9,10,19
2016,7035,18,15,11/10/2020,Internacional,Athletico-PR,2,0,0,0,2,0,0,2,2,19,14,33
2017,7036,18,16,14/10/2020,Palmeiras,Coritiba,3,2,0,0,3,2,0,5,5,13,20,33
2018,7037,18,16,14/10/2020,Gremio,Botafogo-RJ,3,2,1,0,4,2,1,5,6,11,13,24
2019,7038,18,16,14/10/2020,Santos,Atletico-GO,3,3,0,0,3,3,0,6,6,18,21,39
2020,7039,18,16,14/10/2020,Athletico-PR,Corinthians,3,3,0,1,3,4,1,6,7,18,14,32
2021,7040,18,16,14/10/2020,Atletico-MG,Fluminense,3,1,0,0,3,1,0,4,4,11,9,20
2022,7041,18,16,14/10/2020,Sport,Internacional,3,2,0,0,3,2,0,5,5,6,19,25
2023,7042,18,16,15/10/2020,Flamengo,Bragantino,2,1,0,0,2,1,0,3,3,16,14,30
2024,7043,18,16,16/10/2020,Goias,Bahia,5,4,0,2,5,6,2,9,11,16,18,34
2025,7044,18,16,19/11/2020,Vasco,Fortaleza,2,0,0,0,2,0,0,2,2,11,20,31
2026,7045,18,16,25/11/2020,Ceara,Sao Paulo,5,3,0,0,5,3,0,8,8,20,13,33
2027,7046,18,17,17/10/2020,Atletico-GO,Athletico-PR,3,5,2,0,5,5,2,8,10,10,20,30
2028,7047,18,17,17/10/2020,Coritiba,Santos,5,2,0,0,5,2,0,7,7,18,25,43
2029,7048,18,17,17/10/2020,Fluminense,Ceara,3,3,0,0,3,3,0,6,6,17,16,33
2030,7049,18,17,17/10/2020,Sao Paulo,Gremio,4,2,0,0,4,2,0,6,6,24,15,39
2031,7050,18,17,18/10/2020,Corinthians,Flamengo,4,5,0,0,4,5,0,9,9,14,13,27
2032,7051,18,17,18/10/2020,Internacional,Vasco,1,1,0,0,1,1,0,2,2,17,11,28
2033,7052,18,17,18/10/2020,Bragantino,Sport,2,2,0,0,2,2,0,4,4,13,13,26
2034,7053,18,17,18/10/2020,Fortaleza,Palmeiras,2,3,0,1,2,4,1,5,6,14,19,33
2035,7054,18,17,19/10/2020,Bahia,Atletico-MG,4,1,0,0,4,1,0,5,5,14,14,28
2036,7055,18,17,19/10/2020,Botafogo-RJ,Goias,2,1,0,0,2,1,0,3,3,18,11,29
2037,7056,18,18,21/10/2020,Vasco,Corinthians,1,2,0,0,1,2,0,3,3,12,18,30
2038,7057,18,18,24/10/2020,Bragantino,Goias,0,3,0,0,0,3,0,3,3,17,15,32
2039,7058,18,18,24/10/2020,Ceara,Coritiba,3,1,0,0,3,1,0,4,4,22,12,34
2040,7059,18,18,24/10/2020,Atletico-MG,Sport,1,0,0,0,1,0,0,1,1,10,11,21
2041,7060,18,18,25/10/2020,Atletico-GO,Palmeiras,1,4,0,0,1,4,0,5,5,15,17,32
2042,7061,18,18,25/10/2020,Fluminense,Santos,5,4,0,0,5,4,0,9,9,13,18,31
2043,7062,18,18,25/10/2020,Athletico-PR,Gremio,3,1,0,0,3,1,0,4,4,15,11,26
2044,7063,18,18,25/10/2020,Internacional,Flamengo,6,5,0,0,6,5,0,11,11,16,16,32
2045,7064,18,18,11/11/2020,Bahia,Fortaleza,3,3,0,0,3,3,0,6,6,14,11,25
2046,7065,18,18,9/12/2020,Sao Paulo,Botafogo-RJ,0,2,0,1,0,3,1,2,3,12,8,20
2047,7066,18,19,31/10/2020,Botafogo-RJ,Ceara,4,5,1,1,5,6,2,9,11,17,19,36
2048,7067,18,19,31/10/2020,Coritiba,Atletico-GO,2,5,0,0,2,5,0,7,7,22,18,40
2049,7068,18,19,31/10/2020,Corinthians,Internacional,4,3,0,1,4,4,1,7,8,16,13,29
2050,7069,18,19,31/10/2020,Fortaleza,Fluminense,2,1,1,0,3,1,1,3,4,14,18,32
2051,7070,18,19,1/11/2020,Flamengo,Sao Paulo,4,3,0,0,4,3,0,7,7,18,18,36
2052,7071,18,19,1/11/2020,Sport,Athletico-PR,2,1,1,0,3,1,1,3,4,17,15,32
2053,7072,18,19,1/11/2020,Santos,Bahia,4,2,0,0,4,2,0,6,6,19,13,32
2054,7073,18,19,1/11/2020,Goias,Vasco,5,7,0,0,5,7,0,12,12,16,20,36
2055,7074,18,19,2/11/2020,Palmeiras,Atletico-MG,2,1,0,0,2,1,0,3,3,10,12,22
2056,7075,18,19,2/11/2020,Gremio,Bragantino,1,1,0,0,1,1,0,2,2,13,12,25
2057,7076,18,20,7/11/2020,Athletico-PR,Fortaleza,3,2,0,0,3,2,0,5,5,20,14,34
2058,7077,18,20,7/11/2020,Sao Paulo,Goias,2,1,0,1,2,2,1,3,4,9,19,28
2059,7078,18,20,7/11/2020,Atletico-GO,Corinthians,3,4,0,0,3,4,0,7,7,22,25,47
2060,7079,18,20,8/11/2020,Vasco,Palmeiras,1,3,0,0,1,3,0,4,4,17,19,36
2061,7080,18,20,8/11/2020,Internacional,Coritiba,2,3,1,0,3,3,1,5,6,9,13,22
2062,7081,18,20,8/11/2020,Bragantino,Santos,1,4,0,0,1,4,0,5,5,15,20,35
2063,7082,18,20,8/11/2020,Atletico-MG,Flamengo,5,4,0,0,5,4,0,9,9,21,13,34
2064,7083,18,20,8/11/2020,Bahia,Botafogo-RJ,2,3,0,0,2,3,0,5,5,19,17,36
2065,7084,18,20,8/11/2020,Fluminense,Gremio,0,1,0,0,0,1,0,1,1,12,13,25
2066,7085,18,20,8/11/2020,Ceara,Sport,0,3,0,0,0,3,0,3,3,17,13,30
2067,7086,18,21,14/11/2020,Sport,Vasco,0,2,0,0,0,2,0,2,2,14,21,35
2068,7087,18,21,14/11/2020,Santos,Internacional,1,2,0,0,1,2,0,3,3,24,18,42
2069,7088,18,21,14/11/2020,Goias,Athletico-PR,5,1,0,0,5,1,0,6,6,14,12,26
2070,7089,18,21,14/11/2020,Corinthians,Atletico-MG,3,5,0,0,3,5,0,8,8,29,11,40
2071,7090,18,21,14/11/2020,Fortaleza,Sao Paulo,2,4,0,0,2,4,0,6,6,15,18,33
2072,7091,18,21,14/11/2020,Gremio,Ceara,1,2,0,0,1,2,0,3,3,8,14,22
2073,7092,18,21,14/11/2020,Palmeiras,Fluminense,2,2,0,0,2,2,0,4,4,15,8,23
2074,7093,18,21,14/11/2020,Flamengo,Atletico-GO,2,1,0,0,2,1,0,3,3,15,16,31
2075,7094,18,21,16/11/2020,Coritiba,Bahia,3,4,0,0,3,4,0,7,7,12,12,24
2076,7095,18,21,16/11/2020,Botafogo-RJ,Bragantino,0,3,0,0,0,3,0,3,3,16,18,34
2077,7096,18,22,20/11/2020,Bragantino,Bahia,2,4,0,0,2,4,0,6,6,16,13,29
2078,7097,18,22,21/11/2020,Athletico-PR,Santos,0,2,0,0,0,2,0,2,2,22,13,35
2079,7098,18,22,21/11/2020,Flamengo,Coritiba,1,3,0,0,1,3,0,4,4,16,18,34
2080,7099,18,22,21/11/2020,Goias,Palmeiras,2,2,0,1,2,3,1,4,5,20,15,35
2081,7100,18,22,22/11/2020,Sao Paulo,Vasco,2,4,0,0,2,4,0,6,6,7,19,26
2082,7101,18,22,22/11/2020,Ceara,Atletico-MG,4,1,0,1,4,2,1,5,6,11,12,23
2083,7102,18,22,22/11/2020,Internacional,Fluminense,2,4,0,0,2,4,0,6,6,20,20,40
2084,7103,18,22,22/11/2020,Botafogo-RJ,Fortaleza,1,1,0,0,1,1,0,2,2,18,15,33
2085,7104,18,22,22/11/2020,Corinthians,Gremio,2,1,2,0,4,1,2,3,5,12,14,26
2086,7105,18,22,23/11/2020,Sport,Atletico-GO,1,3,0,0,1,3,0,4,4,17,16,33
2087,7106,18,23,25/11/2020,Atletico-MG,Botafogo-RJ,2,4,0,0,2,4,0,6,6,25,19,44
2088,7107,18,23,25/11/2020,Coritiba,Corinthians,2,2,0,0,2,2,0,4,4,13,25,38
2089,7108,18,23,26/11/2020,Fortaleza,Goias,2,0,0,0,2,0,0,2,2,17,19,36
2090,7109,18,23,28/11/2020,Palmeiras,Athletico-PR,2,1,0,0,2,1,0,3,3,16,15,31
2091,7110,18,23,28/11/2020,Santos,Sport,3,3,0,0,3,3,0,6,6,17,24,41
2092,7111,18,23,28/11/2020,Bahia,Sao Paulo,0,2,0,0,0,2,0,2,2,12,15,27
2093,7112,18,23,28/11/2020,Atletico-GO,Internacional,1,3,0,1,1,4,1,4,5,19,18,37
2094,7113,18,23,30/11/2020,Vasco,Ceara,3,2,0,0,3,2,0,5,5,15,18,33
2095,7114,18,23,30/11/2020,Fluminense,Bragantino,2,3,0,0,2,3,0,5,5,15,21,36
2096,7115,18,23,28/1/2021,Gremio,Flamengo,5,3,0,0,5,3,0,8,8,15,24,39
2097,7116,18,24,2/12/2020,Fortaleza,Corinthians,2,2,1,1,3,3,2,4,6,12,15,27
2098,7117,18,24,5/12/2020,Santos,Palmeiras,3,3,0,1,3,4,1,6,7,14,16,30
2099,7118,18,24,5/12/2020,Botafogo-RJ,Flamengo,1,1,1,1,2,2,2,2,4,16,26,42
2100,7119,18,24,5/12/2020,Fluminense,Athletico-PR,4,3,0,1,4,4,1,7,8,16,18,34
2101,7120,18,24,5/12/2020,Bahia,Ceara,2,2,0,0,2,2,0,4,4,12,17,29
2102,7121,18,24,5/12/2020,Coritiba,Bragantino,4,3,0,0,4,3,0,7,7,17,26,43
2103,7122,18,24,6/12/2020,Sao Paulo,Sport,4,4,0,0,4,4,0,8,8,17,17,34
2104,7123,18,24,6/12/2020,Gremio,Vasco,2,1,0,0,2,1,0,3,3,9,8,17
2105,7124,18,24,6/12/2020,Atletico-MG,Internacional,2,6,0,0,2,6,0,8,8,18,14,32
2106,7125,18,24,7/12/2020,Atletico-GO,Goias,3,3,0,0,3,3,0,6,6,17,21,38
2107,7126,18,25,12/12/2020,Athletico-PR,Atletico-MG,2,2,0,0,2,2,0,4,4,20,13,33
2108,7127,18,25,12/12/2020,Bragantino,Fortaleza,3,2,0,0,3,2,0,5,5,17,18,35
2109,7128,18,25,12/12/2020,Internacional,Botafogo-RJ,4,5,0,0,4,5,0,9,9,23,19,42
2110,7129,18,25,12/12/2020,Palmeiras,Bahia,2,3,0,0,2,3,0,5,5,11,20,31
2111,7130,18,25,12/12/2020,Goias,Gremio,4,1,0,0,4,1,0,5,5,12,10,22
2112,7131,18,25,12/12/2020,Ceara,Atletico-GO,0,3,0,0,0,3,0,3,3,13,15,28
2113,7132,18,25,13/12/2020,Flamengo,Santos,2,1,0,0,2,1,0,3,3,12,11,23
2114,7133,18,25,13/12/2020,Corinthians,Sao Paulo,0,1,0,0,0,1,0,1,1,12,8,20
2115,7134,18,25,13/12/2020,Sport,Coritiba,0,1,0,0,0,1,0,1,1,20,14,34
2116,7135,18,25,13/12/2020,Vasco,Fluminense,6,2,0,0,6,2,0,8,8,21,14,35
2117,7136,18,26,16/12/2020,Sao Paulo,Atletico-MG,2,3,0,1,2,4,1,5,6,9,10,19
2118,7137,18,26,16/12/2020,Atletico-GO,Fluminense,3,4,0,0,3,4,0,7,7,17,18,35
2119,7138,18,26,19/12/2020,Sport,Gremio,2,2,0,1,2,3,1,4,5,21,9,30
2120,7139,18,26,19/12/2020,Internacional,Palmeiras,4,2,0,0,4,2,0,6,6,13,23,36
2121,7140,18,26,19/12/2020,Coritiba,Botafogo-RJ,3,1,0,0,3,1,0,4,4,14,18,32
2122,7141,18,26,20/12/2020,Bragantino,Athletico-PR,2,5,0,0,2,5,0,7,7,8,17,25
2123,7142,18,26,20/12/2020,Vasco,Santos,2,0,0,0,2,0,0,2,2,26,15,41
2124,7143,18,26,20/12/2020,Flamengo,Bahia,1,3,1,1,2,4,2,4,6,17,22,39
2125,7144,18,26,20/12/2020,Fortaleza,Ceara,1,1,1,0,2,1,1,2,3,18,17,35
2126,7145,18,26,21/12/2020,Corinthians,Goias,1,0,0,0,1,0,0,1,1,11,15,26
2127,7147,18,27,26/12/2020,Goias,Sport,4,1,0,0,4,1,0,5,5,22,18,40
2128,7148,18,27,26/12/2020,Fortaleza,Flamengo,3,3,0,0,3,3,0,6,6,22,14,36
2129,7149,18,27,26/12/2020,Fluminense,Sao Paulo,3,1,0,0,3,1,0,4,4,17,22,39
2130,7150,18,27,27/12/2020,Botafogo-RJ,Corinthians,1,1,0,0,1,1,0,2,2,19,20,39
2131,7151,18,27,27/12/2020,Bahia,Internacional,3,1,0,0,3,1,0,4,4,18,12,30
2132,7152,18,27,27/12/2020,Athletico-PR,Vasco,0,1,0,0,0,1,0,1,1,14,11,25
2133,7153,18,27,27/12/2020,Palmeiras,Bragantino,3,0,0,0,3,0,0,3,3,10,6,16
2134,7154,18,27,27/12/2020,Santos,Ceara,2,3,0,0,2,3,0,5,5,15,24,39
2135,7155,18,27,27/12/2020,Gremio,Atletico-GO,2,3,0,0,2,3,0,5,5,11,15,26
2136,7156,18,28,6/1/2021,Gremio,Bahia,2,4,0,0,2,4,0,6,6,11,17,28
2137,7157,18,28,6/1/2021,Botafogo-RJ,Athletico-PR,3,2,0,0,3,2,0,5,5,14,21,35
2138,7158,18,28,6/1/2021,Coritiba,Goias,4,3,0,0,4,3,0,7,7,13,17,30
2139,7159,18,28,6/1/2021,Sport,Fortaleza,3,1,0,0,3,1,0,4,4,14,12,26
2140,7160,18,28,6/1/2021,Flamengo,Fluminense,1,4,0,0,1,4,0,5,5,12,22,34
2141,7161,18,28,6/1/2021,Bragantino,Sao Paulo,2,2,0,1,2,3,1,4,5,17,4,21
2142,7162,18,28,7/1/2021,Ceara,Internacional,6,4,0,0,6,4,0,10,10,18,16,34
2143,7163,18,28,7/1/2021,Atletico-GO,Vasco,3,2,0,0,3,2,0,5,5,19,17,36
2144,7164,18,28,18/1/2021,Palmeiras,Corinthians,2,3,0,1,2,4,1,5,6,14,11,25
2145,7165,18,28,26/1/2021,Atletico-MG,Santos,1,1,0,0,1,1,0,2,2,10,14,24
2146,7166,18,29,9/1/2021,Sport,Palmeiras,5,3,0,0,5,3,0,8,8,15,21,36
2147,7167,18,29,9/1/2021,Coritiba,Athletico-PR,2,1,0,0,2,1,0,3,3,11,10,21
2148,7168,18,29,9/1/2021,Fortaleza,Gremio,4,2,0,0,4,2,0,6,6,17,12,29
2149,7169,18,29,10/1/2021,Sao Paulo,Santos,2,4,0,0,2,4,0,6,6,19,21,40
2150,7170,18,29,10/1/2021,Flamengo,Ceara,3,1,0,0,3,1,0,4,4,10,12,22
2151,7171,18,29,10/1/2021,Atletico-GO,Bahia,2,0,0,0,2,0,0,2,2,20,18,38
2152,7172,18,29,10/1/2021,Internacional,Goias,0,2,0,0,0,2,0,2,2,14,14,28
2153,7173,18,29,10/1/2021,Vasco,Botafogo-RJ,1,0,0,0,1,0,0,1,1,11,13,24
2154,7174,18,29,11/1/2021,Bragantino,Atletico-MG,4,0,0,0,4,0,0,4,4,15,11,26
2155,7175,18,29,13/1/2021,Corinthians,Fluminense,1,2,0,0,1,2,0,3,3,17,15,32
2156,7176,18,30,15/1/2021,Palmeiras,Gremio,3,1,0,0,3,1,0,4,4,22,10,32
2157,7177,18,30,16/1/2021,Fluminense,Sport,1,1,0,1,1,2,1,2,3,23,18,41
2158,7178,18,30,16/1/2021,Vasco,Coritiba,2,2,1,0,3,2,1,4,5,10,13,23
2159,7179,18,30,17/1/2021,Athletico-PR,Sao Paulo,2,1,0,0,2,1,0,3,3,10,14,24
2160,7180,18,30,17/1/2021,Santos,Botafogo-RJ,2,1,0,0,2,1,0,3,3,8,24,32
2161,7181,18,30,17/1/2021,Atletico-MG,Atletico-GO,2,3,0,0,2,3,0,5,5,13,14,27
2162,7182,18,30,17/1/2021,Ceara,Bragantino,1,2,0,0,1,2,0,3,3,13,16,29
2163,7183,18,30,17/1/2021,Internacional,Fortaleza,0,3,0,0,0,3,0,3,3,24,17,41
2164,7184,18,30,18/1/2021,Goias,Flamengo,5,1,0,0,5,1,0,6,6,24,13,37
2165,7185,18,30,28/1/2021,Bahia,Corinthians,3,1,0,0,3,1,0,4,4,24,19,43
2166,7186,18,31,20/1/2021,Botafogo-RJ,Atletico-GO,2,3,0,0,2,3,0,5,5,17,14,31
2167,7187,18,31,20/1/2021,Bahia,Athletico-PR,2,0,0,0,2,0,0,2,2,15,14,29
2168,7188,18,31,20/1/2021,Gremio,Atletico-MG,1,1,0,0,1,1,0,2,2,11,7,18
2169,7189,18,31,20/1/2021,Coritiba,Fluminense,1,4,1,1,2,5,2,5,7,21,10,31
2170,7190,18,31,20/1/2021,Sao Paulo,Internacional,2,1,0,0,2,1,0,3,3,15,19,34
2171,7192,18,31,21/1/2021,Flamengo,Palmeiras,2,2,0,0,2,2,0,4,4,26,15,41
2172,7193,18,31,21/1/2021,Fortaleza,Santos,3,0,0,0,3,0,0,3,3,20,14,34
2173,7194,18,31,21/1/2021,Goias,Ceara,1,0,0,0,1,0,0,1,1,12,11,23
2174,7195,18,31,21/1/2021,Corinthians,Sport,1,0,0,0,1,0,0,1,1,9,7,16
2175,7196,18,32,23/1/2021,Sao Paulo,Coritiba,1,2,0,0,1,2,0,3,3,19,16,35
2176,7197,18,32,23/1/2021,Vasco,Atletico-MG,4,1,0,0,4,1,0,5,5,15,11,26
2177,7198,18,32,24/1/2021,Internacional,Gremio,2,2,0,0,2,2,0,4,4,19,15,34
2178,7199,18,32,24/1/2021,Athletico-PR,Flamengo,2,0,0,0,2,0,0,2,2,20,11,31
2179,7200,18,32,24/1/2021,Ceara,Palmeiras,3,5,1,0,4,5,1,8,9,9,16,25
2180,7201,18,32,24/1/2021,Atletico-GO,Fortaleza,2,2,0,1,2,3,1,4,5,12,13,25
2181,7202,18,32,24/1/2021,Sport,Bahia,3,0,0,0,3,0,0,3,3,16,8,24
2182,7203,18,32,24/1/2021,Santos,Goias,4,4,0,0,4,4,0,8,8,11,19,30
2183,7204,18,32,24/1/2021,Fluminense,Botafogo-RJ,2,1,0,0,2,1,0,3,3,20,20,40
2184,7205,18,32,25/1/2021,Corinthians,Bragantino,5,4,0,0,5,4,0,9,9,16,14,30
2185,7206,18,33,31/1/2021,Vasco,Bahia,1,3,1,0,2,3,1,4,5,15,16,31
2186,7207,18,33,31/1/2021,Ceara,Athletico-PR,0,2,0,0,0,2,0,2,2,15,18,33
2187,7208,18,33,31/1/2021,Atletico-GO,Sao Paulo,3,1,0,0,3,1,0,4,4,13,9,22
2188,7209,18,33,31/1/2021,Coritiba,Gremio,3,3,0,0,3,3,0,6,6,26,12,38
2189,7210,18,33,31/1/2021,Atletico-MG,Fortaleza,0,1,0,0,0,1,0,1,1,16,15,31
2190,7211,18,33,31/1/2021,Internacional,Bragantino,3,0,0,0,3,0,0,3,3,11,12,23
2191,7212,18,33,31/1/2021,Fluminense,Goias,1,2,0,0,1,2,0,3,3,9,15,24
2192,7213,18,33,1/2/2021,Sport,Flamengo,2,2,0,0,2,2,0,4,4,15,20,35
2193,7214,18,33,2/2/2021,Palmeiras,Botafogo-RJ,2,1,0,0,2,1,0,3,3,16,10,26
2194,7216,18,34,3/2/2021,Gremio,Santos,5,2,0,1,5,3,1,7,8,12,20,32
2195,7217,18,34,3/2/2021,Bragantino,Atletico-GO,3,3,0,0,3,3,0,6,6,15,7,22
2196,7219,18,34,3/2/2021,Goias,Atletico-MG,3,3,0,0,3,3,0,6,6,13,13,26
2197,7220,18,34,3/2/2021,Bahia,Fluminense,1,1,0,0,1,1,0,2,2,15,11,26
2198,7221,18,34,4/2/2021,Fortaleza,Coritiba,2,5,0,2,2,7,2,7,9,18,15,33
2199,7222,18,34,4/2/2021,Flamengo,Vasco,1,3,0,0,1,3,0,4,4,19,15,34
2200,7223,18,34,4/2/2021,Athletico-PR,Internacional,3,2,0,0,3,2,0,5,5,15,20,35
2201,7224,18,34,5/2/2021,Botafogo-RJ,Sport,1,3,0,0,1,3,0,4,4,11,19,30
2202,7225,18,34,19/2/2021,Sao Paulo,Palmeiras,2,1,0,0,2,1,0,3,3,16,14,30
2203,7226,18,35,6/2/2021,Bahia,Goias,3,4,1,0,4,4,1,7,8,18,13,31
2204,7227,18,35,6/2/2021,Atletico-GO,Santos,2,2,1,0,3,2,1,4,5,18,13,31
2205,7228,18,35,7/2/2021,Bragantino,Flamengo,4,2,0,0,4,2,0,6,6,20,16,36
2206,7230,18,35,10/2/2021,Internacional,Sport,2,3,2,0,4,3,2,5,7,12,11,23
2207,7231,18,35,10/2/2021,Fortaleza,Vasco,2,3,0,0,2,3,0,5,5,15,14,29
2208,7232,18,35,10/2/2021,Sao Paulo,Ceara,4,4,0,0,4,4,0,8,8,11,17,28
2209,7233,18,35,10/2/2021,Fluminense,Atletico-MG,0,1,0,0,0,1,0,1,1,8,13,21
2210,7234,18,35,10/2/2021,Corinthians,Athletico-PR,3,0,0,0,3,0,0,3,3,19,12,31
2211,7235,18,35,17/2/2021,Coritiba,Palmeiras,2,3,0,1,2,4,1,5,6,16,20,36
2212,7236,18,36,13/2/2021,Goias,Botafogo-RJ,4,3,0,1,4,4,1,7,8,22,26,48
2213,7237,18,36,13/2/2021,Atletico-MG,Bahia,1,1,0,0,1,1,0,2,2,10,9,19
2214,7238,18,36,13/2/2021,Santos,Coritiba,0,4,0,0,0,4,0,4,4,15,16,31
2215,7239,18,36,14/2/2021,Flamengo,Corinthians,1,5,0,0,1,5,0,6,6,21,16,37
2216,7240,18,36,14/2/2021,Vasco,Internacional,1,6,0,0,1,6,0,7,7,9,20,29
2217,7241,18,36,14/2/2021,Athletico-PR,Atletico-GO,3,1,0,0,3,1,0,4,4,14,9,23
2218,7242,18,36,14/2/2021,Palmeiras,Fortaleza,0,3,0,0,0,3,0,3,3,16,11,27
2219,7243,18,36,14/2/2021,Gremio,Sao Paulo,5,4,1,0,6,4,1,9,10,19,18,37
2220,7244,18,36,15/2/2021,Ceara,Fluminense,1,1,0,0,1,1,0,2,2,18,8,26
2221,7245,18,36,15/2/2021,Sport,Bragantino,3,0,0,0,3,0,0,3,3,8,10,18
2222,7246,18,37,20/2/2021,Coritiba,Ceara,1,0,0,0,1,0,0,1,1,14,9,23
2223,7247,18,37,20/2/2021,Fortaleza,Bahia,4,3,1,0,5,3,1,7,8,15,13,28
2224,7248,18,37,21/2/2021,Sport,Atletico-MG,4,4,0,0,4,4,0,8,8,16,13,29
2225,7249,18,37,21/2/2021,Corinthians,Vasco,1,2,0,0,1,2,0,3,3,23,18,41
2226,7250,18,37,21/2/2021,Flamengo,Internacional,4,0,0,1,4,1,1,4,5,21,14,35
2227,7251,18,37,21/2/2021,Santos,Fluminense,3,4,0,1,3,5,1,7,8,20,19,39
2228,7252,18,37,21/2/2021,Gremio,Athletico-PR,3,1,0,2,3,3,2,4,6,19,17,36
2229,7253,18,37,21/2/2021,Goias,Bragantino,2,0,0,0,2,0,0,2,2,18,20,38
2230,7254,18,37,22/2/2021,Palmeiras,Atletico-GO,2,1,0,0,2,1,0,3,3,20,13,33
2231,7255,18,37,22/2/2021,Botafogo-RJ,Sao Paulo,3,5,0,1,3,6,1,8,9,12,15,27
2232,7256,18,38,25/2/2021,Bragantino,Gremio,4,0,0,0,4,0,0,4,4,24,12,36
2233,7258,18,38,25/2/2021,Athletico-PR,Sport,0,1,0,0,0,1,0,1,1,15,10,25
2234,7259,18,38,25/2/2021,Atletico-GO,Coritiba,0,1,0,0,0,1,0,1,1,8,9,17
2235,7260,18,38,25/2/2021,Internacional,Corinthians,0,2,0,0,0,2,0,2,2,13,16,29
2236,7261,18,38,25/2/2021,Ceara,Botafogo-RJ,3,0,1,0,4,0,1,3,4,7,4,11
2237,7262,18,38,25/2/2021,Sao Paulo,Flamengo,6,3,0,0,6,3,0,9,9,27,24,51
2238,7263,18,38,25/2/2021,Atletico-MG,Palmeiras,3,0,0,0,3,0,0,3,3,22,17,39
2239,7264,18,38,25/2/2021,Vasco,Goias,1,2,0,0,1,2,0,3,3,12,18,30
2240,7266,19,1,29/5/2021,Cuiaba,Juventude,1,3,0,0,1,3,0,4,4,14,14,28
2241,7267,19,1,29/5/2021,Bahia,Santos,3,3,0,0,3,3,0,6,6,18,9,27
2242,7268,19,1,29/5/2021,Sao Paulo,Fluminense,1,2,0,0,1,2,0,3,3,10,12,22
2243,7269,19,1,30/5/2021,Atletico-MG,Fortaleza,2,4,0,0,2,4,0,6,6,16,19,35
2244,7270,19,1,30/5/2021,Flamengo,Palmeiras,2,3,0,0,2,3,0,5,5,25,21,46
2245,7271,19,1,30/5/2021,Ceara,Gremio,3,3,0,0,3,3,0,6,6,17,18,35
2246,7272,19,1,30/5/2021,Corinthians,Atletico-GO,5,3,0,0,5,3,0,8,8,18,14,32
2247,7273,19,1,30/5/2021,Chapecoense,Bragantino,1,0,0,0,1,0,0,1,1,9,12,21
2248,7274,19,1,30/5/2021,Athletico-PR,America-MG,1,2,0,0,1,2,0,3,3,18,9,27
2249,7275,19,1,30/5/2021,Internacional,Sport,4,2,0,0,4,2,0,6,6,24,15,39
2250,7276,19,2,5/6/2021,Atletico-GO,Sao Paulo,4,5,0,0,4,5,0,9,9,16,14,30
2251,7277,19,2,5/6/2021,Santos,Ceara,3,1,0,0,3,1,0,4,4,18,19,37
2252,7278,19,2,5/6/2021,Bragantino,Bahia,2,4,0,0,2,4,0,6,6,12,13,25
2253,7279,19,2,6/6/2021,Fluminense,Cuiaba,2,1,0,0,2,1,0,3,3,22,15,37
2254,7280,19,2,6/6/2021,America-MG,Corinthians,2,3,0,0,2,3,0,5,5,12,19,31
2255,7281,19,2,6/6/2021,Fortaleza,Internacional,1,4,0,2,1,6,2,5,7,19,21,40
2256,7282,19,2,6/6/2021,Juventude,Athletico-PR,0,2,0,0,0,2,0,2,2,14,27,41
2257,7283,19,2,6/6/2021,Palmeiras,Chapecoense,2,0,0,0,2,0,0,2,2,10,11,21
2258,7284,19,2,6/6/2021,Sport,Atletico-MG,3,2,0,0,3,2,0,5,5,18,15,33
2259,7285,19,2,23/11/2021,Gremio,Flamengo,3,2,2,0,5,2,2,5,7,14,14,28
2260,7286,19,3,12/6/2021,Santos,Juventude,2,3,0,0,2,3,0,5,5,14,20,34
2261,7287,19,3,12/6/2021,Palmeiras,Corinthians,3,0,0,0,3,0,0,3,3,14,14,28
2262,7288,19,3,13/6/2021,Atletico-MG,Sao Paulo,0,1,0,0,0,1,0,1,1,14,22,36
2263,7289,19,3,13/6/2021,Gremio,Athletico-PR,5,4,0,0,5,4,0,9,9,21,12,33
2264,7291,19,3,13/6/2021,Bahia,Internacional,4,4,0,1,4,5,1,8,9,14,16,30
2265,7292,19,3,13/6/2021,Fortaleza,Sport,3,3,0,1,3,4,1,6,7,22,16,38
2266,7293,19,3,13/6/2021,Bragantino,Fluminense,3,1,0,0,3,1,0,4,4,11,8,19
2267,7294,19,3,13/6/2021,Chapecoense,Ceara,2,2,0,0,2,2,0,4,4,16,14,30
2268,7295,19,3,21/7/2021,Cuiaba,Atletico-GO,5,4,0,1,5,5,1,9,10,17,14,31
2269,7296,19,4,16/6/2021,Internacional,Atletico-MG,3,1,0,0,3,1,0,4,4,13,13,26
2270,7297,19,4,16/6/2021,Sao Paulo,Chapecoense,3,2,1,0,4,2,1,5,6,9,13,22
2271,7298,19,4,16/6/2021,Corinthians,Bragantino,2,0,0,0,2,0,0,2,2,13,15,28
2272,7299,19,4,16/6/2021,Juventude,Palmeiras,0,3,0,0,0,3,0,3,3,11,24,35
2273,7300,19,4,17/6/2021,America-MG,Cuiaba,1,1,0,0,1,1,0,2,2,16,16,32
2274,7301,19,4,17/6/2021,Ceara,Bahia,3,5,0,0,3,5,0,8,8,19,16,35
2275,7302,19,4,17/6/2021,Sport,Gremio,5,4,0,0,5,4,0,9,9,16,11,27
2276,7303,19,4,17/6/2021,Atletico-GO,Fortaleza,3,1,0,0,3,1,0,4,4,18,13,31
2277,7304,19,4,17/6/2021,Fluminense,Santos,4,3,0,0,4,3,0,7,7,14,9,23
2278,7305,19,4,2/11/2021,Athletico-PR,Flamengo,4,2,0,0,4,2,0,6,6,8,15,23
2279,7306,19,5,19/6/2021,Flamengo,Bragantino,2,3,0,0,2,3,0,5,5,15,13,28
2280,7307,19,5,20/6/2021,Palmeiras,America-MG,3,4,0,0,3,4,0,7,7,15,10,25
2281,7308,19,5,20/6/2021,Bahia,Corinthians,1,3,0,0,1,3,0,4,4,10,18,28
2282,7309,19,5,20/6/2021,Internacional,Ceara,2,3,0,0,2,3,0,5,5,16,23,39
2283,7310,19,5,20/6/2021,Fortaleza,Fluminense,3,0,0,0,3,0,0,3,3,14,17,31
2284,7311,19,5,20/6/2021,Athletico-PR,Atletico-GO,2,2,0,0,2,2,0,4,4,17,15,32
2285,7312,19,5,20/6/2021,Santos,Sao Paulo,2,4,0,0,2,4,0,6,6,22,20,42
2286,7313,19,5,20/6/2021,Juventude,Sport,4,0,0,0,4,0,0,4,4,16,9,25
2287,7314,19,5,21/6/2021,Atletico-MG,Chapecoense,1,1,0,0,1,1,0,2,2,9,10,19
2288,7315,19,5,18/8/2021,Cuiaba,Gremio,1,5,0,0,1,5,0,6,6,12,10,22
2289,7316,19,6,23/6/2021,Atletico-GO,Fluminense,3,3,0,0,3,3,0,6,6,22,17,39
2290,7317,19,6,23/6/2021,Sao Paulo,Cuiaba,1,1,0,0,1,1,0,2,2,18,14,32
2291,7318,19,6,23/6/2021,Flamengo,Fortaleza,1,1,0,0,1,1,0,2,2,18,15,33
2292,7319,19,6,23/6/2021,Bragantino,Palmeiras,3,3,0,0,3,3,0,6,6,13,13,26
2293,7320,19,6,24/6/2021,America-MG,Juventude,2,2,1,0,3,2,1,4,5,17,16,33
2294,7321,19,6,24/6/2021,Chapecoense,Internacional,2,3,1,2,3,5,3,5,8,12,19,31
2295,7322,19,6,24/6/2021,Corinthians,Sport,0,3,0,0,0,3,0,3,3,8,17,25
2296,7323,19,6,24/6/2021,Ceara,Atletico-MG,3,4,0,0,3,4,0,7,7,16,16,32
2297,7324,19,6,24/6/2021,Bahia,Athletico-PR,2,1,0,2,2,3,2,3,5,12,8,20
2298,7325,19,6,24/6/2021,Gremio,Santos,2,3,0,0,2,3,0,5,5,21,14,35
2299,7326,19,7,27/6/2021,Juventude,Flamengo,2,1,0,0,2,1,0,3,3,17,12,29
2300,7327,19,7,27/6/2021,Fluminense,Corinthians,3,1,1,0,4,1,1,4,5,14,11,25
2301,7328,19,7,27/6/2021,Palmeiras,Bahia,3,4,0,0,3,4,0,7,7,10,16,26
2302,7329,19,7,27/6/2021,Athletico-PR,Chapecoense,1,1,0,0,1,1,0,2,2,12,15,27
2303,7330,19,7,27/6/2021,Gremio,Fortaleza,2,4,1,0,3,4,1,6,7,13,12,25
2304,7331,19,7,27/6/2021,Santos,Atletico-MG,4,3,0,1,4,4,1,7,8,20,16,36
2305,7332,19,7,27/6/2021,America-MG,Internacional,2,3,0,0,2,3,0,5,5,16,20,36
2306,7333,19,7,27/6/2021,Sport,Cuiaba,0,1,0,0,0,1,0,1,1,11,17,28
2307,7334,19,7,27/6/2021,Ceara,Sao Paulo,4,6,0,0,4,6,0,10,10,20,12,32
2308,7335,19,7,28/6/2021,Atletico-GO,Bragantino,2,2,0,0,2,2,0,4,4,24,16,40
2309,7336,19,8,30/6/2021,Fluminense,Athletico-PR,1,2,0,0,1,2,0,3,3,16,15,31
2310,7337,19,8,30/6/2021,Fortaleza,Chapecoense,3,3,1,0,4,3,1,6,7,17,24,41
2311,7338,19,8,30/6/2021,Internacional,Palmeiras,3,2,0,1,3,3,1,5,6,14,13,27
2312,7339,19,8,30/6/2021,Bahia,America-MG,4,0,0,0,4,0,0,4,4,6,9,15
2313,7340,19,8,30/6/2021,Santos,Sport,1,4,0,0,1,4,0,5,5,11,19,30
2314,7341,19,8,30/6/2021,Corinthians,Sao Paulo,1,1,0,0,1,1,0,2,2,15,26,41
2315,7342,19,8,30/6/2021,Juventude,Gremio,3,0,0,0,3,0,0,3,3,15,12,27
2316,7343,19,8,1/7/2021,Bragantino,Ceara,1,3,0,1,1,4,1,4,5,11,17,28
2317,7344,19,8,1/7/2021,Atletico-MG,Atletico-GO,0,2,0,0,0,2,0,2,2,13,12,25
2318,7345,19,8,1/7/2021,Cuiaba,Flamengo,3,5,0,0,3,5,0,8,8,18,26,44
2319,7346,19,9,3/7/2021,Athletico-PR,Fortaleza,3,3,0,0,3,3,0,6,6,18,14,32
2320,7347,19,9,3/7/2021,America-MG,Santos,4,3,0,0,4,3,0,7,7,13,6,19
2321,7348,19,9,3/7/2021,Corinthians,Internacional,2,2,0,0,2,2,0,4,4,11,17,28
2322,7349,19,9,4/7/2021,Chapecoense,Bahia,2,1,0,0,2,1,0,3,3,14,13,27
2323,7350,19,9,4/7/2021,Flamengo,Fluminense,2,1,0,0,2,1,0,3,3,11,15,26
2324,7351,19,9,4/7/2021,Sport,Palmeiras,2,1,0,0,2,1,0,3,3,23,13,36
2325,7352,19,9,4/7/2021,Ceara,Juventude,2,2,0,1,2,3,1,4,5,23,15,38
2326,7353,19,9,4/7/2021,Sao Paulo,Bragantino,1,2,0,0,1,2,0,3,3,25,14,39
2327,7354,19,9,4/7/2021,Cuiaba,Atletico-MG,5,2,0,0,5,2,0,7,7,14,15,29
2328,7355,19,9,4/7/2021,Gremio,Atletico-GO,3,0,0,0,3,0,0,3,3,16,9,25
2329,7356,19,10,6/7/2021,Santos,Athletico-PR,2,2,0,0,2,2,0,4,4,17,13,30
2330,7357,19,10,7/7/2021,Bahia,Juventude,2,3,0,0,2,3,0,5,5,19,19,38
2331,7358,19,10,7/7/2021,Bragantino,Cuiaba,3,2,0,0,3,2,0,5,5,15,21,36
2332,7359,19,10,7/7/2021,Fortaleza,America-MG,2,1,0,0,2,1,0,3,3,18,16,34
2333,7360,19,10,7/7/2021,Palmeiras,Gremio,2,2,0,0,2,2,0,4,4,15,16,31
2334,7361,19,10,7/7/2021,Atletico-MG,Flamengo,1,1,0,0,1,1,0,2,2,19,10,29
2335,7362,19,10,7/7/2021,Atletico-GO,Sport,4,1,0,0,4,1,0,5,5,16,9,25
2336,7363,19,10,7/7/2021,Internacional,Sao Paulo,2,3,0,0,2,3,0,5,5,21,24,45
2337,7364,19,10,7/7/2021,Fluminense,Ceara,2,3,0,0,2,3,0,5,5,24,21,45
2338,7365,19,10,8/7/2021,Chapecoense,Corinthians,3,0,0,0,3,0,0,3,3,17,10,27
2339,7366,19,11,10/7/2021,Palmeiras,Santos,1,6,0,0,1,6,0,7,7,19,21,40
2340,7367,19,11,10/7/2021,Gremio,Internacional,1,2,0,0,1,2,0,3,3,12,19,31
2341,7368,19,11,10/7/2021,Athletico-PR,Bragantino,0,4,0,0,0,4,0,4,4,18,16,34
2342,7369,19,11,10/7/2021,Sport,Fluminense,1,3,0,0,1,3,0,4,4,16,13,29
2343,7370,19,11,10/7/2021,Sao Paulo,Bahia,0,1,0,0,0,1,0,1,1,16,15,31
2344,7371,19,11,10/7/2021,America-MG,Atletico-MG,1,1,0,0,1,1,0,2,2,15,17,32
2345,7372,19,11,11/7/2021,Juventude,Atletico-GO,2,2,0,0,2,2,0,4,4,17,23,40
2346,7373,19,11,11/7/2021,Cuiaba,Ceara,1,2,1,0,2,2,1,3,4,9,13,22
2347,7374,19,11,11/7/2021,Flamengo,Chapecoense,3,3,0,0,3,3,0,6,6,19,16,35
2348,7375,19,11,11/7/2021,Fortaleza,Corinthians,4,3,0,0,4,3,0,7,7,13,14,27
2349,7376,19,12,17/7/2021,Ceara,Athletico-PR,4,3,0,0,4,3,0,7,7,11,15,26
2350,7377,19,12,17/7/2021,Sao Paulo,Fortaleza,3,2,0,0,3,2,0,5,5,18,20,38
2351,7378,19,12,17/7/2021,Corinthians,Atletico-MG,0,2,0,0,0,2,0,2,2,9,22,31
2352,7379,19,12,17/7/2021,Fluminense,Gremio,1,4,0,0,1,4,0,5,5,13,12,25
2353,7380,19,12,18/7/2021,Chapecoense,Cuiaba,2,2,0,0,2,2,0,4,4,15,13,28
2354,7381,19,12,18/7/2021,Atletico-GO,Palmeiras,2,1,0,0,2,1,0,3,3,8,16,24
2355,7382,19,12,18/7/2021,Bahia,Flamengo,5,1,0,0,5,1,0,6,6,18,8,26
2356,7383,19,12,18/7/2021,Internacional,Juventude,4,4,0,1,4,5,1,8,9,19,14,33
2357,7384,19,12,18/7/2021,Bragantino,Santos,3,6,0,0,3,6,0,9,9,17,15,32
2358,7385,19,12,19/7/2021,America-MG,Sport,1,3,0,0,1,3,0,4,4,19,22,41
2359,7386,19,13,24/7/2021,Gremio,America-MG,3,3,0,0,3,3,0,6,6,20,16,36
2360,7387,19,13,24/7/2021,Palmeiras,Fluminense,1,2,0,0,1,2,0,3,3,13,9,22
2361,7388,19,13,25/7/2021,Atletico-MG,Bahia,2,1,0,0,2,1,0,3,3,17,14,31
2362,7389,19,13,25/7/2021,Fortaleza,Bragantino,4,2,0,0,4,2,0,6,6,21,14,35
2363,7390,19,13,25/7/2021,Flamengo,Sao Paulo,3,6,0,0,3,6,0,9,9,23,16,39
2364,7391,19,13,25/7/2021,Santos,Atletico-GO,2,2,0,0,2,2,0,4,4,14,7,21
2365,7392,19,13,25/7/2021,Athletico-PR,Internacional,4,3,0,0,4,3,0,7,7,14,13,27
2366,7393,19,13,25/7/2021,Sport,Ceara,4,1,0,0,4,1,0,5,5,12,13,25
2367,7394,19,13,26/7/2021,Juventude,Chapecoense,5,1,0,0,5,1,0,6,6,16,15,31
2368,7395,19,13,26/7/2021,Cuiaba,Corinthians,2,1,1,0,3,1,1,3,4,16,12,28
2369,7396,19,14,31/7/2021,Sao Paulo,Palmeiras,3,3,1,0,4,3,1,6,7,20,15,35
2370,7397,19,14,31/7/2021,Internacional,Cuiaba,2,3,1,0,3,3,1,5,6,20,18,38
2371,7398,19,14,31/7/2021,Bragantino,Gremio,1,2,0,0,1,2,0,3,3,13,19,32
2372,7399,19,14,1/8/2021,Corinthians,Flamengo,1,1,0,0,1,1,0,2,2,7,13,20
2373,7400,19,14,1/8/2021,Atletico-MG,Athletico-PR,3,3,1,0,4,3,1,6,7,14,12,26
2374,7402,19,14,1/8/2021,Bahia,Sport,2,3,0,0,2,3,0,5,5,16,18,34
2375,7403,19,14,1/8/2021,Atletico-GO,America-MG,4,0,0,0,4,0,0,4,4,21,14,35
2376,7404,19,14,1/8/2021,Ceara,Fortaleza,2,3,0,0,2,3,0,5,5,13,12,25
2377,7405,19,14,2/9/2021,Fluminense,Juventude,2,1,0,0,2,1,0,3,3,23,18,41
2378,7406,19,15,6/8/2021,Sport,Bragantino,3,1,0,0,3,1,0,4,4,17,14,31
2379,7407,19,15,7/8/2021,Athletico-PR,Sao Paulo,2,4,0,1,2,5,1,6,7,12,16,28
2380,7408,19,15,7/8/2021,Palmeiras,Fortaleza,5,2,1,1,6,3,2,7,9,22,13,35
2381,7409,19,15,7/8/2021,Cuiaba,Bahia,1,2,1,0,2,2,1,3,4,15,17,32
2382,7410,19,15,8/8/2021,Juventude,Atletico-MG,1,3,0,0,1,3,0,4,4,17,14,31
2383,7411,19,15,8/8/2021,America-MG,Fluminense,2,2,0,0,2,2,0,4,4,17,13,30
2384,7412,19,15,8/8/2021,Santos,Corinthians,1,1,0,0,1,1,0,2,2,17,9,26
2385,7413,19,15,8/8/2021,Ceara,Atletico-GO,2,2,0,0,2,2,0,4,4,18,15,33
2386,7414,19,15,8/8/2021,Flamengo,Internacional,2,2,1,0,3,2,1,4,5,9,15,24
2387,7415,19,15,9/8/2021,Gremio,Chapecoense,1,3,0,0,1,3,0,4,4,14,10,24
2388,7416,19,16,14/8/2021,Bragantino,Juventude,4,4,0,0,4,4,0,8,8,14,14,28
2389,7417,19,16,14/8/2021,Atletico-MG,Palmeiras,2,1,0,1,2,2,1,3,4,14,14,28
2390,7418,19,16,14/8/2021,Sao Paulo,Gremio,3,1,0,0,3,1,0,4,4,14,16,30
2391,7419,19,16,15/8/2021,Flamengo,Sport,4,1,0,0,4,1,0,5,5,14,11,25
2392,7420,19,16,15/8/2021,Corinthians,Ceara,1,1,0,0,1,1,0,2,2,7,16,23
2393,7421,19,16,15/8/2021,Bahia,Atletico-GO,2,0,0,0,2,0,0,2,2,18,11,29
2394,7422,19,16,15/8/2021,Cuiaba,Athletico-PR,1,1,0,0,1,1,0,2,2,15,20,35
2395,7423,19,16,15/8/2021,Fortaleza,Santos,2,1,0,0,2,1,0,3,3,17,13,30
2396,7424,19,16,15/8/2021,Internacional,Fluminense,2,0,0,0,2,0,0,2,2,14,8,22
2397,7425,19,16,16/8/2021,Chapecoense,America-MG,1,1,1,0,2,1,1,2,3,10,11,21
2398,7426,19,17,21/8/2021,Atletico-GO,Chapecoense,2,5,1,0,3,5,1,7,8,13,24,37
2399,7427,19,17,21/8/2021,Gremio,Bahia,1,1,0,0,1,1,0,2,2,12,15,27
2400,7428,19,17,21/8/2021,Juventude,Fortaleza,1,1,0,0,1,1,0,2,2,8,9,17
2401,7429,19,17,22/8/2021,Palmeiras,Cuiaba,1,1,0,0,1,1,0,2,2,8,14,22
2402,7430,19,17,22/8/2021,Ceara,Flamengo,0,2,0,0,0,2,0,2,2,13,12,25
2403,7431,19,17,22/8/2021,Athletico-PR,Corinthians,1,0,1,0,2,0,1,1,2,12,7,19
2404,7432,19,17,22/8/2021,Santos,Internacional,2,2,0,0,2,2,0,4,4,19,14,33
2405,7433,19,17,22/8/2021,Sport,Sao Paulo,2,2,0,0,2,2,0,4,4,15,17,32
2406,7434,19,17,23/8/2021,America-MG,Bragantino,2,0,0,0,2,0,0,2,2,14,15,29
2407,7435,19,17,23/8/2021,Fluminense,Atletico-MG,3,3,0,0,3,3,0,6,6,16,16,32
2408,7436,19,18,28/8/2021,Sport,Chapecoense,1,1,1,0,2,1,1,2,3,17,17,34
2409,7437,19,18,28/8/2021,Santos,Flamengo,4,4,0,0,4,4,0,8,8,14,14,28
2410,7438,19,18,28/8/2021,Gremio,Corinthians,1,2,1,0,2,2,1,3,4,17,7,24
2411,7439,19,18,28/8/2021,Palmeiras,Athletico-PR,3,0,0,0,3,0,0,3,3,10,16,26
2412,7440,19,18,29/8/2021,America-MG,Ceara,1,2,0,0,1,2,0,3,3,19,13,32
2413,7441,19,18,29/8/2021,Juventude,Sao Paulo,2,5,0,0,2,5,0,7,7,15,21,36
2414,7442,19,18,29/8/2021,Atletico-GO,Internacional,1,2,0,0,1,2,0,3,3,13,15,28
2415,7443,19,18,29/8/2021,Bragantino,Atletico-MG,3,4,0,0,3,4,0,7,7,16,18,34
2416,7444,19,18,30/8/2021,Fluminense,Bahia,2,4,0,0,2,4,0,6,6,19,21,40
2417,7445,19,18,30/8/2021,Fortaleza,Cuiaba,2,5,0,0,2,5,0,7,7,15,17,32
2418,7446,19,19,4/9/2021,Bahia,Fortaleza,3,1,0,0,3,1,0,4,4,25,7,32
2419,7447,19,19,4/9/2021,Cuiaba,Santos,3,1,0,0,3,1,0,4,4,11,11,22
2420,7448,19,19,5/9/2021,Athletico-PR,Sport,1,2,0,1,1,3,1,3,4,10,9,19
2421,7449,19,19,7/9/2021,Corinthians,Juventude,3,4,0,0,3,4,0,7,7,15,20,35
2422,7451,19,19,22/9/2021,Sao Paulo,America-MG,3,1,0,0,3,1,0,4,4,17,18,35
2423,7452,19,19,20/10/2021,Ceara,Palmeiras,4,2,0,0,4,2,0,6,6,19,11,30
2424,7453,19,19,21/10/2021,Internacional,Bragantino,5,2,0,0,5,2,0,7,7,18,13,31
2425,7454,19,19,3/11/2021,Atletico-MG,Gremio,5,6,0,0,5,6,0,11,11,10,14,24
2426,7455,19,19,5/11/2021,Flamengo,Atletico-GO,2,1,0,0,2,1,0,3,3,10,15,25
2427,7456,19,20,11/9/2021,America-MG,Athletico-PR,1,1,0,0,1,1,0,2,2,14,17,31
2428,7457,19,20,11/9/2021,Juventude,Cuiaba,3,5,0,1,3,6,1,8,9,12,13,25
2429,7458,19,20,11/9/2021,Bragantino,Chapecoense,4,2,1,0,5,2,1,6,7,17,13,30
2430,7459,19,20,11/9/2021,Santos,Bahia,1,4,0,0,1,4,0,5,5,16,20,36
2431,7461,19,20,12/9/2021,Fortaleza,Atletico-MG,1,2,0,0,1,2,0,3,3,13,18,31
2432,7462,19,20,12/9/2021,Palmeiras,Flamengo,0,2,1,0,1,2,1,2,3,14,15,29
2433,7463,19,20,12/9/2021,Atletico-GO,Corinthians,4,2,0,0,4,2,0,6,6,10,10,20
2434,7464,19,20,12/9/2021,Fluminense,Sao Paulo,5,4,0,0,5,4,0,9,9,16,16,32
2435,7465,19,20,13/9/2021,Sport,Internacional,4,1,0,0,4,1,0,5,5,21,20,41
2436,7466,19,21,18/9/2021,Chapecoense,Palmeiras,2,2,0,0,2,2,0,4,4,16,14,30
2437,7467,19,21,18/9/2021,Athletico-PR,Juventude,5,1,0,1,5,2,1,6,7,18,7,25
2438,7468,19,21,18/9/2021,Atletico-MG,Sport,2,3,0,0,2,3,0,5,5,18,13,31
2439,7469,19,21,18/9/2021,Bahia,Bragantino,1,4,0,0,1,4,0,5,5,16,13,29
2440,7470,19,21,18/9/2021,Ceara,Santos,3,2,0,0,3,2,0,5,5,17,13,30
2441,7471,19,21,19/9/2021,Internacional,Fortaleza,3,1,1,1,4,2,2,4,6,12,15,27
2442,7472,19,21,19/9/2021,Sao Paulo,Atletico-GO,1,2,0,0,1,2,0,3,3,18,11,29
2443,7473,19,21,19/9/2021,Corinthians,America-MG,1,0,1,0,2,0,1,1,2,8,13,21
2444,7474,19,21,19/9/2021,Flamengo,Gremio,3,4,0,0,3,4,0,7,7,16,17,33
2445,7475,19,21,20/9/2021,Cuiaba,Fluminense,2,2,1,0,3,2,1,4,5,15,16,31
2446,7476,19,22,25/9/2021,Ceara,Chapecoense,0,3,0,1,0,4,1,3,4,8,18,26
2447,7477,19,22,25/9/2021,Corinthians,Palmeiras,1,1,0,0,1,1,0,2,2,8,11,19
2448,7478,19,22,25/9/2021,Sao Paulo,Atletico-MG,1,1,0,0,1,1,0,2,2,14,12,26
2449,7479,19,22,26/9/2021,America-MG,Flamengo,1,1,0,0,1,1,0,2,2,9,12,21
2450,7480,19,22,26/9/2021,Internacional,Bahia,2,2,0,0,2,2,0,4,4,19,15,34
2451,7481,19,22,26/9/2021,Fluminense,Bragantino,2,2,0,0,2,2,0,4,4,11,19,30
2452,7482,19,22,26/9/2021,Juventude,Santos,3,0,0,0,3,0,0,3,3,15,16,31
2453,7483,19,22,26/9/2021,Sport,Fortaleza,5,2,0,0,5,2,0,7,7,19,14,33
2454,7484,19,22,26/9/2021,Athletico-PR,Gremio,1,5,0,0,1,5,0,6,6,17,18,35
2455,7485,19,22,26/9/2021,Atletico-GO,Cuiaba,1,4,0,0,1,4,0,5,5,10,16,26
2456,7486,19,23,2/10/2021,Cuiaba,America-MG,1,2,0,0,1,2,0,3,3,13,20,33
2457,7487,19,23,2/10/2021,Fortaleza,Atletico-GO,1,4,0,0,1,4,0,5,5,14,20,34
2458,7489,19,23,2/10/2021,Atletico-MG,Internacional,4,2,0,0,4,2,0,6,6,16,15,31
2459,7490,19,23,3/10/2021,Flamengo,Athletico-PR,2,2,0,0,2,2,0,4,4,13,14,27
2460,7491,19,23,3/10/2021,Chapecoense,Sao Paulo,1,1,0,0,1,1,0,2,2,11,11,22
2461,7492,19,23,3/10/2021,Palmeiras,Juventude,1,1,0,0,1,1,0,2,2,19,13,32
2462,7493,19,23,3/10/2021,Gremio,Sport,2,1,0,0,2,1,0,3,3,21,18,39
2463,7494,19,23,27/10/2021,Santos,Fluminense,2,2,0,0,2,2,0,4,4,18,10,28
2464,7495,19,23,27/10/2021,Bahia,Ceara,3,2,0,1,3,3,1,5,6,19,13,32
2465,7496,19,24,5/10/2021,Corinthians,Bahia,0,1,0,1,0,2,1,1,2,14,18,32
2466,7497,19,24,6/10/2021,Chapecoense,Atletico-MG,2,1,0,0,2,1,0,3,3,12,17,29
2467,7498,19,24,6/10/2021,Atletico-GO,Athletico-PR,3,3,0,0,3,3,0,6,6,12,16,28
2468,7499,19,24,6/10/2021,Sport,Juventude,2,2,0,0,2,2,0,4,4,11,11,22
2469,7500,19,24,6/10/2021,Ceara,Internacional,5,2,0,0,5,2,0,7,7,22,16,38
2470,7501,19,24,6/10/2021,Bragantino,Flamengo,1,3,0,0,1,3,0,4,4,13,20,33
2471,7502,19,24,6/10/2021,Fluminense,Fortaleza,2,2,0,0,2,2,0,4,4,13,16,29
2472,7503,19,24,6/10/2021,America-MG,Palmeiras,2,3,0,0,2,3,0,5,5,14,17,31
2473,7504,19,24,6/10/2021,Gremio,Cuiaba,2,2,0,0,2,2,0,4,4,15,10,25
2474,7505,19,24,7/10/2021,Sao Paulo,Santos,2,4,0,0,2,4,0,6,6,19,13,32
2475,7506,19,25,9/10/2021,Fluminense,Atletico-GO,2,2,0,0,2,2,0,4,4,15,17,32
2476,7507,19,25,9/10/2021,Atletico-MG,Ceara,1,3,0,0,1,3,0,4,4,12,10,22
2477,7508,19,25,9/10/2021,Sport,Corinthians,3,0,0,0,3,0,0,3,3,14,7,21
2478,7509,19,25,9/10/2021,Fortaleza,Flamengo,0,2,1,0,1,2,1,2,3,10,17,27
2479,7510,19,25,9/10/2021,Athletico-PR,Bahia,1,2,0,0,1,2,0,3,3,14,9,23
2480,7511,19,25,9/10/2021,Palmeiras,Bragantino,1,2,0,0,1,2,0,3,3,14,15,29
2481,7512,19,25,9/10/2021,Juventude,America-MG,6,3,0,0,6,3,0,9,9,24,26,50
2482,7513,19,25,10/10/2021,Internacional,Chapecoense,3,1,0,0,3,1,0,4,4,16,14,30
2483,7514,19,25,10/10/2021,Santos,Gremio,4,6,0,1,4,7,1,10,11,14,25,39
2484,7515,19,25,11/10/2021,Cuiaba,Sao Paulo,2,2,0,0,2,2,0,4,4,14,16,30
2485,7516,19,26,12/10/2021,Bragantino,Atletico-GO,2,4,1,0,3,4,1,6,7,12,13,25
2486,7517,19,26,12/10/2021,Bahia,Palmeiras,4,2,0,1,4,3,1,6,7,22,13,35
2487,7518,19,26,13/10/2021,Atletico-MG,Santos,2,7,0,0,2,7,0,9,9,10,13,23
2488,7519,19,26,13/10/2021,Chapecoense,Athletico-PR,4,5,0,0,4,5,0,9,9,17,13,30
2489,7520,19,26,13/10/2021,Flamengo,Juventude,2,3,0,0,2,3,0,5,5,17,14,31
2490,7521,19,26,13/10/2021,Fortaleza,Gremio,2,2,0,0,2,2,0,4,4,13,17,30
2491,7522,19,26,13/10/2021,Corinthians,Fluminense,1,1,0,0,1,1,0,2,2,4,9,13
2492,7523,19,26,13/10/2021,Internacional,America-MG,1,2,0,0,1,2,0,3,3,21,23,44
2493,7524,19,26,14/10/2021,Sao Paulo,Ceara,3,3,0,0,3,3,0,6,6,18,14,32
2494,7525,19,26,14/10/2021,Cuiaba,Sport,4,0,0,0,4,0,0,4,4,14,8,22
2495,7526,19,27,16/10/2021,Chapecoense,Fortaleza,3,1,0,0,3,1,0,4,4,20,12,32
2496,7527,19,27,16/10/2021,America-MG,Bahia,1,2,0,0,1,2,0,3,3,12,22,34
2497,7528,19,27,17/10/2021,Athletico-PR,Fluminense,2,1,0,0,2,1,0,3,3,22,15,37
2498,7529,19,27,17/10/2021,Palmeiras,Internacional,3,4,0,1,3,5,1,7,8,13,21,34
2499,7530,19,27,17/10/2021,Ceara,Bragantino,2,7,0,0,2,7,0,9,9,13,14,27
2500,7531,19,27,17/10/2021,Gremio,Juventude,1,3,0,0,1,3,0,4,4,24,15,39
2501,7532,19,27,17/10/2021,Atletico-GO,Atletico-MG,1,0,0,0,1,0,0,1,1,8,7,15
2502,7533,19,27,17/10/2021,Sport,Santos,1,3,0,0,1,3,0,4,4,14,11,25
2503,7534,19,27,17/10/2021,Flamengo,Cuiaba,1,1,0,0,1,1,0,2,2,12,7,19
2504,7535,19,27,18/10/2021,Sao Paulo,Corinthians,3,2,0,0,3,2,0,5,5,21,8,29
2505,7536,19,28,23/10/2021,Santos,America-MG,1,2,1,0,2,2,1,3,4,10,12,22
2506,7537,19,28,23/10/2021,Juventude,Ceara,1,2,0,0,1,2,0,3,3,15,20,35
2507,7538,19,28,23/10/2021,Fluminense,Flamengo,6,3,0,0,6,3,0,9,9,22,16,38
2508,7539,19,28,23/10/2021,Fortaleza,Athletico-PR,2,2,0,0,2,2,0,4,4,13,12,25
2509,7540,19,28,24/10/2021,Internacional,Corinthians,3,3,1,1,4,4,2,6,8,23,11,34
2510,7542,19,28,24/10/2021,Bragantino,Sao Paulo,3,0,0,0,3,0,0,3,3,14,19,33
2511,7543,19,28,24/10/2021,Bahia,Chapecoense,1,1,0,0,1,1,0,2,2,6,11,17
2512,7544,19,28,25/10/2021,Atletico-GO,Gremio,2,7,0,1,2,8,1,9,10,11,17,28
2513,7545,19,28,25/10/2021,Palmeiras,Sport,1,3,0,0,1,3,0,4,4,10,20,30
2514,7546,19,34,28/10/2021,Bragantino,Sport,3,6,0,0,3,6,0,9,9,17,14,31
2515,7547,19,34,20/11/2021,Atletico-MG,Juventude,1,2,0,0,1,2,0,3,3,20,13,33
2516,7548,19,34,20/11/2021,Fortaleza,Palmeiras,3,2,0,0,3,2,0,5,5,22,12,34
2517,7549,19,34,20/11/2021,Chapecoense,Gremio,1,1,0,0,1,1,0,2,2,19,18,37
2518,7550,19,34,20/11/2021,Atletico-GO,Ceara,0,3,0,0,0,3,0,3,3,10,21,31
2519,7551,19,34,20/11/2021,Internacional,Flamengo,2,1,0,0,2,1,0,3,3,14,13,27
2520,7552,19,34,21/11/2021,Corinthians,Santos,1,0,0,0,1,0,0,1,1,6,8,14
2521,7553,19,34,21/11/2021,Fluminense,America-MG,1,2,0,0,1,2,0,3,3,21,17,38
2522,7554,19,34,21/11/2021,Bahia,Cuiaba,1,0,0,0,1,0,0,1,1,12,9,21
2523,7555,19,34,24/11/2021,Sao Paulo,Athletico-PR,3,2,0,0,3,2,0,5,5,14,15,29
2524,7556,19,29,30/10/2021,Athletico-PR,Santos,1,2,0,0,1,2,0,3,3,11,9,20
2525,7557,19,29,30/10/2021,Flamengo,Atletico-MG,4,2,0,0,4,2,0,6,6,22,19,41
2526,7558,19,29,30/10/2021,Juventude,Bahia,2,1,0,0,2,1,0,3,3,13,17,30
2527,7559,19,29,30/10/2021,America-MG,Fortaleza,0,5,0,0,0,5,0,5,5,13,19,32
2528,7560,19,29,31/10/2021,Gremio,Palmeiras,5,2,0,0,5,2,0,7,7,26,12,38
2529,7561,19,29,31/10/2021,Ceara,Fluminense,4,2,1,0,5,2,1,6,7,8,7,15
2530,7562,19,29,31/10/2021,Sao Paulo,Internacional,0,2,0,0,0,2,0,2,2,17,13,30
2531,7563,19,29,31/10/2021,Sport,Atletico-GO,4,3,0,0,4,3,0,7,7,15,13,28
2532,7564,19,29,1/11/2021,Cuiaba,Bragantino,2,3,0,0,2,3,0,5,5,8,16,24
2533,7565,19,29,1/11/2021,Corinthians,Chapecoense,1,4,0,0,1,4,0,5,5,12,19,31
2534,7566,19,31,4/11/2021,Cuiaba,Chapecoense,1,1,0,0,1,1,0,2,2,13,15,28
2535,7567,19,31,9/11/2021,Gremio,Fluminense,3,1,0,0,3,1,0,4,4,18,9,27
2536,7568,19,31,10/11/2021,Athletico-PR,Ceara,4,3,0,1,4,4,1,7,8,9,10,19
2537,7569,19,31,10/11/2021,Atletico-MG,Corinthians,2,2,0,0,2,2,0,4,4,20,4,24
2538,7570,19,31,10/11/2021,Santos,Bragantino,2,1,0,0,2,1,0,3,3,11,10,21
2539,7571,19,31,10/11/2021,Palmeiras,Atletico-GO,1,3,0,0,1,3,0,4,4,10,13,23
2540,7572,19,31,10/11/2021,Fortaleza,Sao Paulo,4,5,0,0,4,5,0,9,9,15,11,26
2541,7573,19,31,10/11/2021,Sport,America-MG,2,3,1,0,3,3,1,5,6,11,14,25
2542,7574,19,31,10/11/2021,Juventude,Internacional,2,4,0,0,2,4,0,6,6,19,15,34
2543,7575,19,31,11/11/2021,Flamengo,Bahia,0,2,1,2,1,4,3,2,5,14,9,23
2544,7576,19,30,6/11/2021,Corinthians,Fortaleza,3,3,0,0,3,3,0,6,6,18,26,44
2545,7577,19,30,6/11/2021,Internacional,Gremio,1,3,1,1,2,4,2,4,6,19,17,36
2546,7578,19,30,6/11/2021,Fluminense,Sport,1,1,0,0,1,1,0,2,2,11,12,23
2547,7579,19,30,7/11/2021,Bragantino,Athletico-PR,2,3,0,0,2,3,0,5,5,16,25,41
2548,7580,19,30,7/11/2021,Atletico-MG,America-MG,3,2,0,0,3,2,0,5,5,21,10,31
2549,7581,19,30,7/11/2021,Santos,Palmeiras,3,2,0,0,3,2,0,5,5,14,17,31
2550,7582,19,30,7/11/2021,Bahia,Sao Paulo,1,2,0,0,1,2,0,3,3,11,18,29
2551,7583,19,30,7/11/2021,Ceara,Cuiaba,3,1,0,0,3,1,0,4,4,15,13,28
2552,7584,19,30,8/11/2021,Chapecoense,Flamengo,3,3,1,1,4,4,2,6,8,14,11,25
2553,7585,19,30,23/11/2021,Atletico-GO,Juventude,1,2,0,0,1,2,0,3,3,19,16,35
2554,7586,19,32,13/11/2021,Atletico-GO,Santos,2,3,0,0,2,3,0,5,5,13,13,26
2555,7587,19,32,13/11/2021,America-MG,Gremio,3,1,0,0,3,1,0,4,4,14,16,30
2556,7588,19,32,13/11/2021,Bragantino,Fortaleza,3,4,0,0,3,4,0,7,7,25,12,37
2557,7589,19,32,13/11/2021,Internacional,Athletico-PR,7,3,0,0,7,3,0,10,10,17,13,30
2558,7590,19,32,13/11/2021,Corinthians,Cuiaba,1,1,0,0,1,1,0,2,2,15,9,24
2559,7591,19,32,14/11/2021,Sao Paulo,Flamengo,1,1,1,0,2,1,1,2,3,6,9,15
2560,7592,19,32,14/11/2021,Fluminense,Palmeiras,4,6,1,2,5,8,3,10,13,12,20,32
2561,7593,19,32,14/11/2021,Ceara,Sport,1,2,0,0,1,2,0,3,3,12,17,29
2562,7594,19,32,14/11/2021,Chapecoense,Juventude,3,3,0,0,3,3,0,6,6,15,17,32
2563,7595,19,32,2/12/2021,Bahia,Atletico-MG,2,3,0,0,2,3,0,5,5,13,12,25
2564,7596,19,33,16/11/2021,Athletico-PR,Atletico-MG,1,2,0,0,1,2,0,3,3,15,14,29
2565,7597,19,33,16/11/2021,Gremio,Bragantino,0,2,0,0,0,2,0,2,2,15,17,32
2566,7598,19,33,17/11/2021,America-MG,Atletico-GO,1,1,0,0,1,1,0,2,2,7,14,21
2567,7599,19,33,17/11/2021,Santos,Chapecoense,1,2,0,0,1,2,0,3,3,14,14,28
2568,7600,19,33,17/11/2021,Cuiaba,Internacional,4,1,0,0,4,1,0,5,5,14,17,31
2569,7601,19,33,17/11/2021,Fortaleza,Ceara,1,4,0,0,1,4,0,5,5,14,14,28
2570,7602,19,33,17/11/2021,Palmeiras,Sao Paulo,1,2,0,0,1,2,0,3,3,12,19,31
2571,7603,19,33,17/11/2021,Juventude,Fluminense,2,1,0,0,2,1,0,3,3,20,19,39
2572,7604,19,33,17/11/2021,Flamengo,Corinthians,1,2,0,0,1,2,0,3,3,15,8,23
2573,7605,19,33,18/11/2021,Sport,Bahia,1,3,0,0,1,3,0,4,4,19,14,33
2574,7606,19,35,23/11/2021,Palmeiras,Atletico-MG,4,3,0,0,4,3,0,7,7,16,22,38
2575,7607,19,35,24/11/2021,Fluminense,Internacional,5,5,0,1,5,6,1,10,11,20,18,38
2576,7608,19,35,25/11/2021,Santos,Fortaleza,3,2,0,0,3,2,0,5,5,15,15,30
2577,7609,19,35,25/11/2021,Ceara,Corinthians,3,4,0,0,3,4,0,7,7,16,13,29
2578,7610,19,35,29/11/2021,Atletico-GO,Bahia,5,3,0,1,5,4,1,8,9,16,20,36
2579,7611,19,35,30/11/2021,Juventude,Bragantino,3,3,0,0,3,3,0,6,6,15,25,40
2580,7612,19,35,30/11/2021,America-MG,Chapecoense,2,2,0,0,2,2,0,4,4,10,11,21
2581,7613,19,35,2/12/2021,Gremio,Sao Paulo,3,2,0,0,3,2,0,5,5,17,13,30
2582,7614,19,35,3/12/2021,Athletico-PR,Cuiaba,4,6,0,1,4,7,1,10,11,15,14,29
2583,7615,19,35,3/12/2021,Sport,Flamengo,2,3,0,0,2,3,0,5,5,13,11,24
2584,7616,19,36,26/11/2021,Bahia,Gremio,3,3,0,0,3,3,0,6,6,15,15,30
2585,7617,19,36,27/11/2021,Bragantino,America-MG,3,2,0,0,3,2,0,5,5,21,14,35
2586,7618,19,36,27/11/2021,Sao Paulo,Sport,0,1,0,0,0,1,0,1,1,16,14,30
2587,7619,19,36,28/11/2021,Corinthians,Athletico-PR,5,3,0,0,5,3,0,8,8,14,19,33
2588,7620,19,36,28/11/2021,Atletico-MG,Fluminense,6,3,0,0,6,3,0,9,9,22,18,40
2589,7621,19,36,28/11/2021,Internacional,Santos,1,2,0,0,1,2,0,3,3,16,17,33
2590,7622,19,36,30/11/2021,Flamengo,Ceara,6,1,0,0,6,1,0,7,7,20,19,39
2591,7623,19,36,30/11/2021,Cuiaba,Palmeiras,4,2,0,1,4,3,1,6,7,15,10,25
2592,7624,19,36,3/12/2021,Chapecoense,Atletico-GO,2,3,0,0,2,3,0,5,5,17,17,34
2593,7625,19,36,3/12/2021,Fortaleza,Juventude,2,0,0,0,2,0,0,2,2,20,14,34
2594,7626,19,37,5/12/2021,Bahia,Fluminense,2,5,1,1,3,6,2,7,9,14,20,34
2595,7627,19,37,5/12/2021,Corinthians,Gremio,1,3,0,0,1,3,0,4,4,7,22,29
2596,7628,19,37,5/12/2021,Atletico-MG,Bragantino,1,2,0,0,1,2,0,3,3,5,10,15
2597,7629,19,37,5/12/2021,Ceara,America-MG,0,2,0,0,0,2,0,2,2,14,13,27
2598,7630,19,37,6/12/2021,Sao Paulo,Juventude,5,3,0,0,5,3,0,8,8,25,13,38
2599,7631,19,37,6/12/2021,Athletico-PR,Palmeiras,1,1,0,0,1,1,0,2,2,11,10,21
2600,7632,19,37,6/12/2021,Cuiaba,Fortaleza,1,3,0,0,1,3,0,4,4,22,23,45
2601,7633,19,37,6/12/2021,Internacional,Atletico-GO,3,2,0,0,3,2,0,5,5,14,9,23
2602,7634,19,37,6/12/2021,Flamengo,Santos,3,3,0,0,3,3,0,6,6,23,14,37
2603,7635,19,37,6/12/2021,Chapecoense,Sport,3,4,1,0,4,4,1,7,8,16,27,43
2604,7636,19,38,9/12/2021,Fortaleza,Bahia,4,2,0,0,4,2,0,6,6,15,17,32
2605,7637,19,38,9/12/2021,Atletico-GO,Flamengo,4,2,0,0,4,2,0,6,6,15,7,22
2606,7638,19,38,9/12/2021,Palmeiras,Ceara,2,0,0,0,2,0,0,2,2,18,4,22
2607,7639,19,38,9/12/2021,Fluminense,Chapecoense,3,2,0,0,3,2,0,5,5,12,10,22
2608,7640,19,38,9/12/2021,America-MG,Sao Paulo,2,2,0,0,2,2,0,4,4,18,18,36
2609,7641,19,38,9/12/2021,Bragantino,Internacional,4,5,0,0,4,5,0,9,9,23,26,49
2610,7642,19,38,9/12/2021,Sport,Athletico-PR,1,1,0,0,1,1,0,2,2,17,14,31
2611,7643,19,38,9/12/2021,Juventude,Corinthians,1,2,0,1,1,3,1,3,4,10,22,32
2612,7644,19,38,9/12/2021,Gremio,Atletico-MG,3,1,0,0,3,1,0,4,4,15,11,26
2613,7645,19,38,9/12/2021,Santos,Cuiaba,1,2,0,0,1,2,0,3,3,17,15,32
2614,7646,20,1,9/4/2022,Fluminense,Santos,1,0,0,0,1,0,0,1,1,14,18,32
2615,7647,20,1,9/4/2022,Atletico-GO,Flamengo,3,2,0,0,3,2,0,5,5,7,11,18
2616,7648,20,1,9/4/2022,Palmeiras,Ceara,4,9,0,1,4,10,1,13,14,17,14,31
2617,7649,20,1,10/4/2022,Coritiba,Goias,2,4,0,0,2,4,0,6,6,10,12,22
2618,7650,20,1,10/4/2022,Botafogo-RJ,Corinthians,1,4,0,0,1,4,0,5,5,6,18,24
2619,7651,20,1,10/4/2022,Atletico-MG,Internacional,2,4,0,0,2,4,0,6,6,12,18,30
2620,7652,20,1,10/4/2022,Fortaleza,Cuiaba,2,3,0,0,2,3,0,5,5,22,23,45
2621,7653,20,1,10/4/2022,Avai,America-MG,3,3,0,2,3,5,2,6,8,20,18,38
2622,7654,20,1,10/4/2022,Sao Paulo,Athletico-PR,1,3,0,0,1,3,0,4,4,17,14,31
2623,7655,20,1,11/4/2022,Juventude,Bragantino,4,5,0,0,4,5,0,9,9,16,17,33
2624,7656,20,2,16/4/2022,Goias,Palmeiras,4,0,0,0,4,0,0,4,4,16,7,23
2625,7657,20,2,16/4/2022,America-MG,Juventude,3,0,0,1,3,1,1,3,4,19,11,30
2626,7658,20,2,16/4/2022,Corinthians,Avai,1,1,0,0,1,1,0,2,2,22,12,34
2627,7659,20,2,16/4/2022,Cuiaba,Fluminense,2,1,0,0,2,1,0,3,3,18,14,32
2628,7660,20,2,17/4/2022,Santos,Coritiba,2,4,0,0,2,4,0,6,6,22,10,32
2629,7661,20,2,17/4/2022,Flamengo,Sao Paulo,2,6,0,0,2,6,0,8,8,17,25,42
2630,7662,20,2,17/4/2022,Athletico-PR,Atletico-MG,2,3,0,0,2,3,0,5,5,9,14,23
2631,7663,20,2,17/4/2022,Internacional,Fortaleza,5,5,0,0,5,5,0,10,10,15,13,28
2632,7664,20,2,17/4/2022,Bragantino,Atletico-GO,1,4,0,0,1,4,0,5,5,12,9,21
2633,7665,20,2,17/4/2022,Ceara,Botafogo-RJ,1,4,1,0,2,4,1,5,6,16,15,31
2634,7666,20,4,20/4/2022,Flamengo,Palmeiras,3,4,0,0,3,4,0,7,7,15,21,36
2635,7667,20,4,30/4/2022,Ceara,Bragantino,1,5,0,1,1,6,1,6,7,11,20,31
2636,7668,20,4,30/4/2022,America-MG,Athletico-PR,1,0,0,0,1,0,0,1,1,19,12,31
2637,7669,20,4,30/4/2022,Goias,Atletico-MG,5,4,0,0,5,4,0,9,9,20,15,35
2638,7670,20,4,30/4/2022,Cuiaba,Atletico-GO,2,0,0,0,2,0,0,2,2,12,14,26
2639,7671,20,4,1/5/2022,Botafogo-RJ,Juventude,2,5,0,0,2,5,0,7,7,14,18,32
2640,7672,20,4,1/5/2022,Corinthians,Fortaleza,1,3,0,0,1,3,0,4,4,14,14,28
2641,7673,20,4,1/5/2022,Coritiba,Fluminense,0,3,0,1,0,4,1,3,4,13,16,29
2642,7674,20,4,1/5/2022,Internacional,Avai,2,4,0,0,2,4,0,6,6,15,16,31
2643,7675,20,4,2/5/2022,Sao Paulo,Santos,2,4,0,0,2,4,0,6,6,15,8,23
2644,7676,20,3,23/4/2022,Bragantino,Sao Paulo,5,2,0,0,5,2,0,7,7,13,12,25
2645,7677,20,3,23/4/2022,Athletico-PR,Flamengo,4,2,0,0,4,2,0,6,6,15,10,25
2646,7678,20,3,23/4/2022,Palmeiras,Corinthians,1,2,0,0,1,2,0,3,3,13,14,27
2647,7679,20,3,23/4/2022,Fluminense,Internacional,5,3,0,0,5,3,0,8,8,15,12,27
2648,7680,20,3,23/4/2022,Atletico-MG,Coritiba,2,1,0,0,2,1,0,3,3,10,8,18
2649,7681,20,3,24/4/2022,Santos,America-MG,2,0,0,0,2,0,0,2,2,16,8,24
2650,7682,20,3,24/4/2022,Juventude,Cuiaba,2,4,1,0,3,4,1,6,7,18,19,37
2651,7683,20,3,24/4/2022,Atletico-GO,Botafogo-RJ,2,1,0,0,2,1,0,3,3,11,5,16
2652,7684,20,3,25/4/2022,Avai,Goias,5,5,1,0,6,5,1,10,11,20,20,40
2653,7685,20,3,1/6/2022,Fortaleza,Ceara,5,4,1,0,6,4,1,9,10,18,18,36
2654,7686,20,5,7/5/2022,Atletico-MG,America-MG,4,4,0,1,4,5,1,8,9,7,22,29
2655,7687,20,5,7/5/2022,Athletico-PR,Ceara,5,4,0,0,5,4,0,9,9,19,8,27
2656,7688,20,5,8/5/2022,Flamengo,Botafogo-RJ,1,3,0,0,1,3,0,4,4,13,18,31
2657,7689,20,5,8/5/2022,Palmeiras,Fluminense,1,2,0,0,1,2,0,3,3,10,13,23
2658,7690,20,5,8/5/2022,Atletico-GO,Goias,4,3,0,1,4,4,1,7,8,12,11,23
2659,7691,20,5,8/5/2022,Bragantino,Corinthians,1,2,0,0,1,2,0,3,3,11,9,20
2660,7692,20,5,8/5/2022,Santos,Cuiaba,1,2,0,0,1,2,0,3,3,14,12,26
2661,7693,20,5,8/5/2022,Juventude,Internacional,5,5,0,0,5,5,0,10,10,22,13,35
2662,7694,20,5,8/5/2022,Fortaleza,Sao Paulo,2,3,0,0,2,3,0,5,5,16,14,30
2663,7695,20,5,9/5/2022,Avai,Coritiba,3,3,0,0,3,3,0,6,6,14,13,27
2664,7696,20,7,11/5/2022,Bragantino,Atletico-MG,3,2,1,0,4,2,1,5,6,13,5,18
2665,7697,20,7,21/5/2022,Atletico-GO,Coritiba,4,1,0,2,4,3,2,5,7,14,13,27
2666,7698,20,7,21/5/2022,Flamengo,Goias,1,3,0,0,1,3,0,4,4,14,19,33
2667,7699,20,7,21/5/2022,Santos,Ceara,1,5,0,1,1,6,1,6,7,9,13,22
2668,7700,20,7,21/5/2022,Juventude,Palmeiras,3,0,0,0,3,0,0,3,3,20,6,26
2669,7701,20,7,21/5/2022,Cuiaba,Internacional,2,7,2,0,4,7,2,9,11,9,12,21
2670,7702,20,7,21/5/2022,America-MG,Botafogo-RJ,2,1,0,0,2,1,0,3,3,19,9,28
2671,7703,20,7,22/5/2022,Corinthians,Sao Paulo,2,3,0,0,2,3,0,5,5,11,12,23
2672,7704,20,7,22/5/2022,Fortaleza,Fluminense,1,1,0,0,1,1,0,2,2,13,14,27
2673,7705,20,7,22/5/2022,Athletico-PR,Avai,2,6,0,0,2,6,0,8,8,23,17,40
2674,7706,20,6,14/5/2022,Palmeiras,Bragantino,2,2,0,0,2,2,0,4,4,11,14,25
2675,7707,20,6,14/5/2022,Ceara,Flamengo,5,5,0,0,5,5,0,10,10,18,22,40
2676,7708,20,6,14/5/2022,Internacional,Corinthians,2,2,0,0,2,2,0,4,4,8,7,15
2677,7709,20,6,14/5/2022,Atletico-MG,Atletico-GO,1,2,0,0,1,2,0,3,3,16,14,30
2678,7710,20,6,14/5/2022,Fluminense,Athletico-PR,3,2,0,0,3,2,0,5,5,12,12,24
2679,7711,20,6,15/5/2022,Sao Paulo,Cuiaba,2,1,0,1,2,2,1,3,4,5,15,20
2680,7712,20,6,15/5/2022,Coritiba,America-MG,1,5,0,1,1,6,1,6,7,11,23,34
2681,7713,20,6,15/5/2022,Botafogo-RJ,Fortaleza,3,1,0,1,3,2,1,4,5,14,15,29
2682,7714,20,6,15/5/2022,Avai,Juventude,2,5,0,2,2,7,2,7,9,18,16,34
2683,7716,20,8,28/5/2022,Goias,Bragantino,2,3,0,1,2,4,1,5,6,18,22,40
2684,7717,20,8,28/5/2022,Sao Paulo,Ceara,3,5,1,0,4,5,1,8,9,19,10,29
2685,7718,20,8,28/5/2022,Fortaleza,Juventude,2,3,0,0,2,3,0,5,5,10,16,26
2686,7719,20,8,29/5/2022,Coritiba,Botafogo-RJ,5,3,0,0,5,3,0,8,8,10,12,22
2687,7720,20,8,29/5/2022,Santos,Palmeiras,5,1,0,0,5,1,0,6,6,19,15,34
2688,7721,20,8,29/5/2022,Cuiaba,Athletico-PR,5,0,0,0,5,0,0,5,5,9,17,26
2689,7722,20,8,29/5/2022,Corinthians,America-MG,2,1,0,0,2,1,0,3,3,13,19,32
2690,7723,20,8,29/5/2022,Fluminense,Flamengo,3,5,1,1,4,6,2,8,10,9,16,25
2691,7724,20,8,29/5/2022,Atletico-MG,Avai,3,2,0,1,3,3,1,5,6,14,10,24
2692,7725,20,8,30/5/2022,Internacional,Atletico-GO,1,2,0,0,1,2,0,3,3,7,16,23
2693,7726,20,9,4/6/2022,America-MG,Cuiaba,0,1,0,0,0,1,0,1,1,11,11,22
2694,7727,20,9,4/6/2022,Athletico-PR,Santos,5,3,0,0,5,3,0,8,8,21,11,32
2695,7728,20,9,4/6/2022,Ceara,Coritiba,1,4,0,0,1,4,0,5,5,14,9,23
2696,7729,20,9,4/6/2022,Avai,Sao Paulo,2,2,0,0,2,2,0,4,4,11,23,34
2697,7730,20,9,4/6/2022,Atletico-GO,Corinthians,3,3,0,0,3,3,0,6,6,9,11,20
2698,7731,20,9,5/6/2022,Juventude,Fluminense,3,4,0,1,3,5,1,7,8,21,10,31
2699,7732,20,9,5/6/2022,Flamengo,Fortaleza,3,4,0,0,3,4,0,7,7,9,21,30
2700,7733,20,9,5/6/2022,Palmeiras,Atletico-MG,1,3,0,0,1,3,0,4,4,8,19,27
2701,7734,20,9,5/6/2022,Bragantino,Internacional,3,3,0,0,3,3,0,6,6,20,12,32
2702,7735,20,9,6/6/2022,Botafogo-RJ,Goias,2,2,0,0,2,2,0,4,4,11,22,33
2703,7736,20,10,7/6/2022,Cuiaba,Corinthians,1,2,1,0,2,2,1,3,4,10,11,21
2704,7737,20,10,8/6/2022,America-MG,Ceara,2,3,0,0,2,3,0,5,5,18,20,38
2705,7738,20,10,8/6/2022,Juventude,Athletico-PR,2,4,0,0,2,4,0,6,6,9,10,19
2706,7739,20,10,8/6/2022,Atletico-GO,Avai,1,4,0,1,1,5,1,5,6,12,12,24
2707,7740,20,10,8/6/2022,Bragantino,Flamengo,1,4,1,0,2,4,1,5,6,11,16,27
2708,7741,20,10,8/6/2022,Fluminense,Atletico-MG,3,3,0,0,3,3,0,6,6,13,15,28
2709,7742,20,10,8/6/2022,Santos,Internacional,2,1,0,0,2,1,0,3,3,11,16,27
2710,7743,20,10,9/6/2022,Palmeiras,Botafogo-RJ,1,1,0,0,1,1,0,2,2,16,14,30
2711,7744,20,10,9/6/2022,Coritiba,Sao Paulo,3,3,0,0,3,3,0,6,6,12,13,25
2712,7745,20,10,9/6/2022,Fortaleza,Goias,1,2,0,0,1,2,0,3,3,12,18,30
2713,7746,20,11,11/6/2022,Corinthians,Juventude,1,4,0,0,1,4,0,5,5,15,12,27
2714,7747,20,11,11/6/2022,Atletico-MG,Santos,4,4,0,1,4,5,1,8,9,11,16,27
2715,7748,20,11,11/6/2022,Fluminense,Atletico-GO,3,2,1,0,4,2,1,5,6,10,13,23
2716,7749,20,11,11/6/2022,Cuiaba,Bragantino,1,3,0,0,1,3,0,4,4,14,15,29
2717,7750,20,11,11/6/2022,Internacional,Flamengo,3,3,0,0,3,3,0,6,6,15,14,29
2718,7751,20,11,12/6/2022,Goias,Ceara,6,2,0,1,6,3,1,8,9,20,14,34
2719,7752,20,11,12/6/2022,Sao Paulo,America-MG,2,2,0,0,2,2,0,4,4,14,16,30
2720,7753,20,11,12/6/2022,Coritiba,Palmeiras,1,2,1,0,2,2,1,3,4,11,13,24
2721,7754,20,11,12/6/2022,Fortaleza,Athletico-PR,1,3,0,0,1,3,0,4,4,13,12,25
2722,7755,20,11,13/6/2022,Botafogo-RJ,Avai,4,5,0,1,4,6,1,9,10,19,22,41
2723,7756,20,12,14/6/2022,Juventude,Santos,1,2,1,0,2,2,1,3,4,19,14,33
2724,7757,20,12,15/6/2022,Ceara,Atletico-MG,2,3,0,0,2,3,0,5,5,14,17,31
2725,7758,20,12,15/6/2022,Bragantino,Coritiba,2,1,0,0,2,1,0,3,3,13,12,25
2726,7759,20,12,15/6/2022,Goias,Internacional,4,3,0,0,4,3,0,7,7,11,14,25
2727,7760,20,12,15/6/2022,Flamengo,Cuiaba,1,2,0,0,1,2,0,3,3,17,14,31
2728,7761,20,12,15/6/2022,Athletico-PR,Corinthians,2,2,1,1,3,3,2,4,6,12,9,21
2729,7762,20,12,15/6/2022,America-MG,Fluminense,3,1,1,0,4,1,1,4,5,12,9,21
2730,7763,20,12,16/6/2022,Botafogo-RJ,Sao Paulo,6,3,0,0,6,3,0,9,9,17,17,34
2731,7764,20,12,16/6/2022,Palmeiras,Atletico-GO,2,1,0,1,2,2,1,3,4,12,16,28
2732,7765,20,12,16/6/2022,Avai,Fortaleza,1,3,0,0,1,3,0,4,4,16,17,33
2733,7766,20,13,18/6/2022,Cuiaba,Ceara,0,2,0,0,0,2,0,2,2,15,10,25
2734,7767,20,13,18/6/2022,Santos,Bragantino,4,3,0,0,4,3,0,7,7,13,18,31
2735,7768,20,13,19/6/2022,Atletico-MG,Flamengo,4,1,0,0,4,1,0,5,5,18,13,31
2736,7769,20,13,19/6/2022,Coritiba,Athletico-PR,5,6,2,0,7,6,2,11,13,12,11,23
2737,7770,20,13,19/6/2022,Corinthians,Goias,1,4,0,0,1,4,0,5,5,7,13,20
2738,7771,20,13,19/6/2022,Internacional,Botafogo-RJ,5,6,2,2,7,8,4,11,15,13,13,26
2739,7772,20,13,19/6/2022,Fortaleza,America-MG,1,0,0,0,1,0,0,1,1,8,5,13
2740,7773,20,13,19/6/2022,Atletico-GO,Juventude,3,4,0,1,3,5,1,7,8,15,11,26
2741,7774,20,13,19/6/2022,Fluminense,Avai,0,3,0,0,0,3,0,3,3,8,15,23
2742,7775,20,13,20/6/2022,Sao Paulo,Palmeiras,3,1,0,0,3,1,0,4,4,17,9,26
2743,7776,20,14,24/6/2022,Internacional,Coritiba,2,4,0,0,2,4,0,6,6,9,16,25
2744,7777,20,14,25/6/2022,Athletico-PR,Bragantino,4,1,0,0,4,1,0,5,5,14,11,25
2745,7778,20,14,25/6/2022,Flamengo,America-MG,1,2,0,0,1,2,0,3,3,17,13,30
2746,7779,20,14,25/6/2022,Corinthians,Santos,3,3,0,0,3,3,0,6,6,20,10,30
2747,7780,20,14,25/6/2022,Atletico-MG,Fortaleza,0,5,0,0,0,5,0,5,5,14,15,29
2748,7781,20,14,26/6/2022,Avai,Palmeiras,4,1,0,0,4,1,0,5,5,18,17,35
2749,7782,20,14,26/6/2022,Botafogo-RJ,Fluminense,3,2,0,0,3,2,0,5,5,18,14,32
2750,7783,20,14,26/6/2022,Goias,Cuiaba,3,4,0,1,3,5,1,7,8,14,16,30
2751,7784,20,14,26/6/2022,Ceara,Atletico-GO,2,2,0,0,2,2,0,4,4,16,18,34
2752,7785,20,14,26/6/2022,Sao Paulo,Juventude,3,4,0,0,3,4,0,7,7,15,7,22
2753,7786,20,15,2/7/2022,Juventude,Atletico-MG,2,1,0,0,2,1,0,3,3,11,11,22
2754,7787,20,15,2/7/2022,Fluminense,Corinthians,0,3,0,0,0,3,0,3,3,11,12,23
2755,7788,20,15,2/7/2022,Santos,Flamengo,4,2,0,0,4,2,0,6,6,15,13,28
2756,7789,20,15,2/7/2022,Ceara,Internacional,4,3,0,1,4,4,1,7,8,24,20,44
2757,7790,20,15,2/7/2022,Palmeiras,Athletico-PR,1,2,1,0,2,2,1,3,4,12,15,27
2758,7792,20,15,3/7/2022,Atletico-GO,Sao Paulo,5,7,0,0,5,7,0,12,12,9,20,29
2759,7793,20,15,3/7/2022,America-MG,Goias,2,2,0,0,2,2,0,4,4,14,8,22
2760,7794,20,15,3/7/2022,Coritiba,Fortaleza,2,3,1,0,3,3,1,5,6,11,22,33
2761,7795,20,15,4/7/2022,Bragantino,Botafogo-RJ,1,4,1,0,2,4,1,5,6,11,19,30
2762,7796,20,16,9/7/2022,Bragantino,Avai,1,3,0,0,1,3,0,4,4,5,6,11
2763,7797,20,16,9/7/2022,Fluminense,Ceara,2,3,0,0,2,3,0,5,5,16,17,33
2764,7798,20,16,9/7/2022,Goias,Athletico-PR,2,1,0,0,2,1,0,3,3,15,10,25
2765,7799,20,16,10/7/2022,Coritiba,Juventude,1,2,0,0,1,2,0,3,3,19,11,30
2766,7800,20,16,10/7/2022,Corinthians,Flamengo,2,4,0,0,2,4,0,6,6,7,12,19
2767,7801,20,16,10/7/2022,Santos,Atletico-GO,5,4,0,0,5,4,0,9,9,13,18,31
2768,7802,20,16,10/7/2022,Fortaleza,Palmeiras,0,1,0,0,0,1,0,1,1,9,15,24
2769,7803,20,16,10/7/2022,Atletico-MG,Sao Paulo,1,1,0,0,1,1,0,2,2,12,16,28
2770,7804,20,16,10/7/2022,Cuiaba,Botafogo-RJ,1,2,0,2,1,4,2,3,5,7,11,18
2771,7805,20,16,11/7/2022,Internacional,America-MG,0,5,0,0,0,5,0,5,5,5,8,13
2772,7806,20,17,16/7/2022,Athletico-PR,Internacional,1,2,0,0,1,2,0,3,3,7,13,20
2773,7807,20,17,16/7/2022,Flamengo,Coritiba,0,1,0,0,0,1,0,1,1,13,11,24
2774,7808,20,17,16/7/2022,Avai,Santos,5,3,0,0,5,3,0,8,8,17,12,29
2775,7809,20,17,16/7/2022,Ceara,Corinthians,1,1,0,0,1,1,0,2,2,18,5,23
2776,7810,20,17,17/7/2022,Juventude,Goias,2,3,0,0,2,3,0,5,5,16,16,32
2777,7811,20,17,17/7/2022,Sao Paulo,Fluminense,4,2,0,0,4,2,0,6,6,17,7,24
2778,7812,20,17,17/7/2022,Botafogo-RJ,Atletico-MG,4,3,0,0,4,3,0,7,7,21,18,39
2779,7813,20,17,17/7/2022,Atletico-GO,Fortaleza,1,0,0,0,1,0,0,1,1,7,9,16
2780,7814,20,17,17/7/2022,America-MG,Bragantino,3,1,0,0,3,1,0,4,4,8,18,26
2781,7815,20,17,18/7/2022,Palmeiras,Cuiaba,3,1,0,0,3,1,0,4,4,17,12,29
2782,7816,20,18,19/7/2022,Ceara,Avai,0,2,0,0,0,2,0,2,2,17,14,31
2783,7817,20,18,20/7/2022,Bragantino,Fortaleza,4,3,0,0,4,3,0,7,7,14,18,32
2784,7818,20,18,20/7/2022,Goias,Fluminense,2,0,0,0,2,0,0,2,2,19,9,28
2785,7819,20,18,20/7/2022,Athletico-PR,Atletico-GO,3,0,0,0,3,0,0,3,3,15,8,23
2786,7820,20,18,20/7/2022,Flamengo,Juventude,3,3,0,1,3,4,1,6,7,14,13,27
2787,7821,20,18,20/7/2022,Internacional,Sao Paulo,4,5,0,0,4,5,0,9,9,11,10,21
2788,7822,20,18,20/7/2022,Santos,Botafogo-RJ,2,2,0,0,2,2,0,4,4,15,18,33
2789,7823,20,18,20/7/2022,Corinthians,Coritiba,1,3,0,0,1,3,0,4,4,16,15,31
2790,7824,20,18,21/7/2022,Cuiaba,Atletico-MG,1,1,0,0,1,1,0,2,2,7,10,17
2791,7825,20,18,21/7/2022,America-MG,Palmeiras,5,3,0,0,5,3,0,8,8,16,6,22
2792,7826,20,19,23/7/2022,Sao Paulo,Goias,2,5,0,0,2,5,0,7,7,7,11,18
2793,7827,20,19,23/7/2022,Botafogo-RJ,Athletico-PR,0,2,0,0,0,2,0,2,2,16,15,31
2794,7828,20,19,24/7/2022,Avai,Flamengo,1,1,0,0,1,1,0,2,2,19,19,38
2795,7829,20,19,24/7/2022,Fluminense,Bragantino,5,2,1,0,6,2,1,7,8,11,20,31
2796,7830,20,19,24/7/2022,Palmeiras,Internacional,0,1,0,0,0,1,0,1,1,13,15,28
2797,7831,20,19,24/7/2022,Juventude,Ceara,1,3,0,0,1,3,0,4,4,20,14,34
2798,7832,20,19,24/7/2022,Atletico-MG,Corinthians,2,1,0,0,2,1,0,3,3,11,12,23
2799,7833,20,19,24/7/2022,Atletico-GO,America-MG,0,1,0,0,0,1,0,1,1,4,12,16
2800,7834,20,19,24/7/2022,Fortaleza,Santos,4,4,0,0,4,4,0,8,8,11,11,22
2801,7835,20,19,25/7/2022,Coritiba,Cuiaba,5,3,1,0,6,3,1,8,9,16,12,28
2802,7836,20,20,30/7/2022,Goias,Coritiba,1,2,0,1,1,3,1,3,4,18,11,29
2803,7837,20,20,30/7/2022,Ceara,Palmeiras,3,3,1,0,4,3,1,6,7,14,11,25
2804,7839,20,20,30/7/2022,Flamengo,Atletico-GO,0,7,0,1,0,8,1,7,8,12,16,28
2805,7840,20,20,31/7/2022,Athletico-PR,Sao Paulo,3,4,0,0,3,4,0,7,7,15,13,28
2806,7841,20,20,31/7/2022,Internacional,Atletico-MG,1,1,0,0,1,1,0,2,2,13,12,25
2807,7842,20,20,31/7/2022,Cuiaba,Fortaleza,2,4,0,0,2,4,0,6,6,11,10,21
2808,7843,20,20,31/7/2022,America-MG,Avai,1,0,0,0,1,0,0,1,1,16,17,33
2809,7844,20,20,31/7/2022,Bragantino,Juventude,1,1,0,0,1,1,0,2,2,11,15,26
2810,7845,20,20,1/8/2022,Santos,Fluminense,2,5,0,0,2,5,0,7,7,14,12,26
2811,7846,20,21,6/8/2022,Juventude,America-MG,1,2,0,0,1,2,0,3,3,12,18,30
2812,7847,20,21,6/8/2022,Botafogo-RJ,Ceara,3,4,0,0,3,4,0,7,7,23,9,32
2813,7848,20,21,6/8/2022,Avai,Corinthians,2,1,0,0,2,1,0,3,3,11,12,23
2814,7849,20,21,6/8/2022,Atletico-GO,Bragantino,2,1,0,0,2,1,0,3,3,10,10,20
2815,7850,20,21,6/8/2022,Sao Paulo,Flamengo,2,2,0,0,2,2,0,4,4,12,7,19
2816,7851,20,21,7/8/2022,Fluminense,Cuiaba,2,1,0,0,2,1,0,3,3,11,14,25
2817,7852,20,21,7/8/2022,Palmeiras,Goias,2,3,0,0,2,3,0,5,5,12,10,22
2818,7853,20,21,7/8/2022,Fortaleza,Internacional,1,5,1,0,2,5,1,6,7,12,15,27
2819,7854,20,21,7/8/2022,Atletico-MG,Athletico-PR,1,2,0,0,1,2,0,3,3,10,14,24
2820,7855,20,21,8/8/2022,Coritiba,Santos,3,3,0,0,3,3,0,6,6,23,10,33
2821,7856,20,22,13/8/2022,Goias,Avai,1,2,1,0,2,2,1,3,4,13,10,23
2822,7857,20,22,13/8/2022,Corinthians,Palmeiras,2,2,0,0,2,2,0,4,4,15,10,25
2823,7858,20,22,13/8/2022,Cuiaba,Juventude,4,5,0,1,4,6,1,9,10,14,14,28
2824,7859,20,22,13/8/2022,Botafogo-RJ,Atletico-GO,1,3,1,0,2,3,1,4,5,18,10,28
2825,7860,20,22,14/8/2022,Coritiba,Atletico-MG,3,0,0,0,3,0,0,3,3,7,20,27
2826,7861,20,22,14/8/2022,Ceara,Fortaleza,3,4,0,0,3,4,0,7,7,9,13,22
2827,7862,20,22,14/8/2022,Flamengo,Athletico-PR,3,2,0,0,3,2,0,5,5,13,14,27
2828,7863,20,22,14/8/2022,Sao Paulo,Bragantino,1,0,0,0,1,0,0,1,1,17,10,27
2829,7864,20,22,14/8/2022,America-MG,Santos,1,0,0,0,1,0,0,1,1,16,9,25
2830,7865,20,22,14/8/2022,Internacional,Fluminense,1,1,0,0,1,1,0,2,2,21,12,33
2831,7867,20,23,20/8/2022,Fluminense,Coritiba,1,2,0,0,1,2,0,3,3,13,13,26
2832,7868,20,23,21/8/2022,Juventude,Botafogo-RJ,2,2,0,0,2,2,0,4,4,19,11,30
2833,7869,20,23,21/8/2022,Palmeiras,Flamengo,0,2,0,0,0,2,0,2,2,11,16,27
2834,7871,20,23,21/8/2022,Atletico-GO,Cuiaba,2,2,1,0,3,2,1,4,5,14,8,22
2835,7872,20,23,21/8/2022,Fortaleza,Corinthians,1,2,0,0,1,2,0,3,3,14,7,21
2836,7873,20,23,21/8/2022,Bragantino,Ceara,3,4,0,0,3,4,0,7,7,23,16,39
2837,7874,20,23,21/8/2022,Santos,Sao Paulo,4,2,0,0,4,2,0,6,6,12,9,21
2838,7875,20,23,22/8/2022,Avai,Internacional,5,1,0,0,5,1,0,6,6,15,9,24
2839,7876,20,24,27/8/2022,Goias,Atletico-GO,2,2,1,1,3,3,2,4,6,14,9,23
2840,7877,20,24,27/8/2022,Coritiba,Avai,4,3,0,0,4,3,0,7,7,14,14,28
2841,7878,20,24,27/8/2022,Fluminense,Palmeiras,3,3,0,0,3,3,0,6,6,16,16,32
2842,7879,20,24,27/8/2022,Ceara,Athletico-PR,0,1,0,0,0,1,0,1,1,9,15,24
2843,7880,20,24,28/8/2022,Sao Paulo,Fortaleza,2,2,0,0,2,2,0,4,4,10,10,20
2844,7881,20,24,28/8/2022,America-MG,Atletico-MG,4,4,0,0,4,4,0,8,8,23,14,37
2845,7882,20,24,28/8/2022,Botafogo-RJ,Flamengo,3,2,0,0,3,2,0,5,5,19,14,33
2846,7884,20,24,29/8/2022,Internacional,Juventude,0,3,0,0,0,3,0,3,3,4,10,14
2847,7885,20,24,29/8/2022,Corinthians,Bragantino,1,1,0,0,1,1,0,2,2,12,8,20
2848,7886,20,25,3/9/2022,Juventude,Avai,6,6,0,0,6,6,0,12,12,18,15,33
2849,7887,20,25,3/9/2022,Bragantino,Palmeiras,4,4,0,0,4,4,0,8,8,14,12,26
2850,7888,20,25,3/9/2022,Athletico-PR,Fluminense,2,0,0,0,2,0,0,2,2,15,7,22
2851,7889,20,25,3/9/2022,America-MG,Coritiba,2,3,0,0,2,3,0,5,5,19,8,27
2852,7890,20,25,4/9/2022,Flamengo,Ceara,4,6,1,1,5,7,2,10,12,12,19,31
2853,7891,20,25,4/9/2022,Corinthians,Internacional,2,2,0,0,2,2,0,4,4,10,14,24
2854,7892,20,25,4/9/2022,Fortaleza,Botafogo-RJ,1,2,0,0,1,2,0,3,3,15,14,29
2855,7893,20,25,4/9/2022,Atletico-GO,Atletico-MG,1,2,0,0,1,2,0,3,3,12,6,18
2856,7894,20,25,4/9/2022,Cuiaba,Sao Paulo,3,2,0,1,3,3,1,5,6,18,9,27
2857,7895,20,25,5/9/2022,Santos,Goias,1,2,0,0,1,2,0,3,3,8,16,24
2858,7896,20,26,7/9/2022,Atletico-MG,Bragantino,1,2,0,0,1,2,0,3,3,8,10,18
2859,7897,20,26,10/9/2022,Internacional,Cuiaba,1,3,0,0,1,3,0,4,4,16,14,30
2860,7898,20,26,10/9/2022,Ceara,Santos,4,3,0,0,4,3,0,7,7,24,17,41
2861,7899,20,26,10/9/2022,Fluminense,Fortaleza,1,2,0,0,1,2,0,3,3,7,19,26
2862,7900,20,26,10/9/2022,Palmeiras,Juventude,0,3,0,0,0,3,0,3,3,6,15,21
2863,7901,20,26,11/9/2022,Avai,Athletico-PR,3,4,0,1,3,5,1,7,8,17,20,37
2864,7902,20,26,11/9/2022,Botafogo-RJ,America-MG,1,5,0,0,1,5,0,6,6,11,20,31
2865,7903,20,26,11/9/2022,Sao Paulo,Corinthians,3,1,0,0,3,1,0,4,4,11,14,25
2866,7904,20,26,11/9/2022,Coritiba,Atletico-GO,6,3,0,1,6,4,1,9,10,16,11,27
2867,7905,20,26,11/9/2022,Goias,Flamengo,3,1,0,0,3,1,0,4,4,14,14,28
2868,7906,20,27,17/9/2022,Avai,Atletico-MG,4,3,0,0,4,3,0,7,7,16,20,36
2869,7907,20,27,17/9/2022,Botafogo-RJ,Coritiba,2,4,0,0,2,4,0,6,6,12,17,29
2870,7908,20,27,18/9/2022,Bragantino,Goias,0,5,0,0,0,5,0,5,5,14,16,30
2871,7909,20,27,18/9/2022,Flamengo,Fluminense,1,5,2,3,3,8,5,6,11,12,10,22
2872,7910,20,27,18/9/2022,Ceara,Sao Paulo,5,2,2,0,7,2,2,7,9,15,11,26
2873,7911,20,27,18/9/2022,America-MG,Corinthians,1,3,0,0,1,3,0,4,4,14,12,26
2874,7912,20,27,18/9/2022,Juventude,Fortaleza,2,3,0,0,2,3,0,5,5,14,17,31
2875,7913,20,27,18/9/2022,Palmeiras,Santos,3,4,1,0,4,4,1,7,8,12,12,24
2876,7914,20,27,18/9/2022,Athletico-PR,Cuiaba,3,2,0,1,3,3,1,5,6,9,10,19
2877,7915,20,27,19/9/2022,Atletico-GO,Internacional,3,2,0,0,3,2,0,5,5,19,13,32
2878,7916,20,28,25/9/2022,Sao Paulo,Avai,2,4,0,0,2,4,0,6,6,13,8,21
2879,7917,20,28,27/9/2022,Santos,Athletico-PR,3,3,0,0,3,3,0,6,6,19,21,40
2880,7918,20,28,28/9/2022,Coritiba,Ceara,2,4,0,0,2,4,0,6,6,12,9,21
2881,7919,20,28,28/9/2022,Corinthians,Atletico-GO,0,3,0,0,0,3,0,3,3,5,14,19
2882,7920,20,28,28/9/2022,Fluminense,Juventude,1,1,0,0,1,1,0,2,2,5,9,14
2883,7921,20,28,28/9/2022,Fortaleza,Flamengo,2,5,0,0,2,5,0,7,7,15,15,30
2884,7922,20,28,28/9/2022,Cuiaba,America-MG,1,6,0,0,1,6,0,7,7,13,14,27
2885,7923,20,28,28/9/2022,Internacional,Bragantino,1,2,0,0,1,2,0,3,3,14,15,29
2886,7924,20,28,28/9/2022,Atletico-MG,Palmeiras,3,3,0,0,3,3,0,6,6,11,13,24
2887,7925,20,28,28/9/2022,Goias,Botafogo-RJ,4,4,0,0,4,4,0,8,8,16,14,30
2888,7926,20,29,1/10/2022,Atletico-MG,Fluminense,2,3,0,1,2,4,1,5,6,16,4,20
2889,7927,20,29,1/10/2022,Internacional,Santos,1,4,0,0,1,4,0,5,5,7,13,20
2890,7928,20,29,1/10/2022,Ceara,America-MG,3,4,0,0,3,4,0,7,7,15,23,38
2891,7929,20,29,1/10/2022,Avai,Atletico-GO,2,4,0,0,2,4,0,6,6,7,13,20
2892,7930,20,29,1/10/2022,Athletico-PR,Juventude,3,5,0,0,3,5,0,8,8,12,11,23
2893,7931,20,29,1/10/2022,Flamengo,Bragantino,1,0,0,1,1,1,1,1,2,7,6,13
2894,7932,20,29,1/10/2022,Goias,Fortaleza,3,2,0,0,3,2,0,5,5,11,15,26
2895,7933,20,29,1/10/2022,Corinthians,Cuiaba,1,0,0,0,1,0,0,1,1,11,5,16
2896,7934,20,29,3/10/2022,Botafogo-RJ,Palmeiras,4,2,0,1,4,3,1,6,7,16,14,30
2897,7935,20,29,20/10/2022,Sao Paulo,Coritiba,2,6,0,0,2,6,0,8,8,12,12,24
2898,7936,20,30,4/10/2022,Juventude,Corinthians,1,2,0,0,1,2,0,3,3,9,7,16
2899,7937,20,30,5/10/2022,Atletico-GO,Fluminense,4,0,0,0,4,0,0,4,4,16,13,29
2900,7938,20,30,5/10/2022,Ceara,Goias,4,4,1,0,5,4,1,8,9,19,24,43
2901,7939,20,30,5/10/2022,Bragantino,Cuiaba,2,3,0,0,2,3,0,5,5,14,10,24
2902,7940,20,30,5/10/2022,Athletico-PR,Fortaleza,2,1,0,0,2,1,0,3,3,11,10,21
2903,7941,20,30,5/10/2022,Flamengo,Internacional,3,2,0,0,3,2,0,5,5,13,8,21
2904,7942,20,30,5/10/2022,Santos,Atletico-MG,2,4,1,0,3,4,1,6,7,18,18,36
2905,7943,20,30,6/10/2022,Palmeiras,Coritiba,1,2,0,0,1,2,0,3,3,16,13,29
2906,7944,20,30,6/10/2022,America-MG,Sao Paulo,2,4,0,0,2,4,0,6,6,13,13,26
2907,7945,20,30,6/10/2022,Avai,Botafogo-RJ,2,4,0,0,2,4,0,6,6,17,20,37
2908,7946,20,31,8/10/2022,Cuiaba,Flamengo,2,2,0,0,2,2,0,4,4,14,11,25
2909,7947,20,31,8/10/2022,Corinthians,Athletico-PR,1,0,0,0,1,0,0,1,1,10,16,26
2910,7948,20,31,9/10/2022,Internacional,Goias,1,7,0,0,1,7,0,8,8,15,23,38
2911,7949,20,31,9/10/2022,Sao Paulo,Botafogo-RJ,3,2,1,0,4,2,1,5,6,16,8,24
2912,7950,20,31,9/10/2022,Fortaleza,Avai,1,1,0,0,1,1,0,2,2,16,11,27
2913,7951,20,31,9/10/2022,Coritiba,Bragantino,0,3,1,0,1,3,1,3,4,7,12,19
2914,7952,20,31,9/10/2022,Atletico-MG,Ceara,3,5,0,0,3,5,0,8,8,12,18,30
2915,7953,20,31,9/10/2022,Fluminense,America-MG,1,3,0,0,1,3,0,4,4,8,18,26
2916,7954,20,31,10/10/2022,Atletico-GO,Palmeiras,4,2,0,0,4,2,0,6,6,15,8,23
2917,7955,20,31,10/10/2022,Santos,Juventude,2,0,0,0,2,0,0,2,2,13,10,23
2918,7956,20,32,15/10/2022,Flamengo,Atletico-MG,4,0,0,0,4,0,0,4,4,12,12,24
2919,7957,20,32,15/10/2022,America-MG,Fortaleza,1,3,0,1,1,4,1,4,5,10,24,34
2920,7958,20,32,16/10/2022,Ceara,Cuiaba,4,5,0,1,4,6,1,9,10,11,20,31
2921,7959,20,32,16/10/2022,Palmeiras,Sao Paulo,3,3,0,2,3,5,2,6,8,9,14,23
2922,7960,20,32,16/10/2022,Juventude,Atletico-GO,2,1,0,0,2,1,0,3,3,10,19,29
2923,7961,20,32,16/10/2022,Botafogo-RJ,Internacional,3,5,0,0,3,5,0,8,8,15,13,28
2924,7962,20,32,16/10/2022,Avai,Fluminense,2,0,0,0,2,0,0,2,2,12,15,27
2925,7963,20,32,16/10/2022,Athletico-PR,Coritiba,3,2,0,0,3,2,0,5,5,21,11,32
2926,7964,20,32,17/10/2022,Bragantino,Santos,3,4,1,0,4,4,1,7,8,21,11,32
2927,7965,20,32,29/10/2022,Goias,Corinthians,2,3,0,0,2,3,0,5,5,11,11,22
2928,7966,20,33,22/10/2022,Bragantino,Athletico-PR,0,3,0,0,0,3,0,3,3,16,13,29
2929,7967,20,33,22/10/2022,America-MG,Flamengo,1,1,0,0,1,1,0,2,2,17,10,27
2930,7968,20,33,22/10/2022,Santos,Corinthians,2,4,1,1,3,5,2,6,8,15,11,26
2931,7969,20,33,22/10/2022,Palmeiras,Avai,2,2,0,0,2,2,0,4,4,12,7,19
2932,7970,20,33,23/10/2022,Fluminense,Botafogo-RJ,3,2,0,0,3,2,0,5,5,15,11,26
2933,7971,20,33,23/10/2022,Juventude,Sao Paulo,2,2,0,0,2,2,0,4,4,6,10,16
2934,7972,20,33,23/10/2022,Coritiba,Internacional,3,1,0,0,3,1,0,4,4,16,10,26
2935,7973,20,33,23/10/2022,Atletico-GO,Ceara,3,2,0,0,3,2,0,5,5,20,13,33
2936,7974,20,33,23/10/2022,Cuiaba,Goias,3,4,0,0,3,4,0,7,7,11,16,27
2937,7975,20,33,24/10/2022,Fortaleza,Atletico-MG,4,1,0,0,4,1,0,5,5,22,10,32
2938,7976,20,34,25/10/2022,Flamengo,Santos,3,4,0,0,3,4,0,7,7,14,16,30
2939,7977,20,34,25/10/2022,Athletico-PR,Palmeiras,3,5,1,0,4,5,1,8,9,7,10,17
2940,7978,20,34,26/10/2022,Botafogo-RJ,Bragantino,1,4,0,0,1,4,0,5,5,12,12,24
2941,7979,20,34,26/10/2022,Corinthians,Fluminense,2,3,0,0,2,3,0,5,5,16,9,25
2942,7980,20,34,26/10/2022,Internacional,Ceara,0,2,0,0,0,2,0,2,2,8,15,23
2943,7981,20,34,26/10/2022,Goias,America-MG,2,3,0,0,2,3,0,5,5,14,23,37
2944,7982,20,34,27/10/2022,Fortaleza,Coritiba,1,1,0,1,1,2,1,2,3,15,12,27
2945,7983,20,34,27/10/2022,Sao Paulo,Atletico-GO,2,4,0,1,2,5,1,6,7,10,12,22
2946,7984,20,34,27/10/2022,Atletico-MG,Juventude,2,1,0,0,2,1,0,3,3,13,13,26
2947,7985,20,34,27/10/2022,Cuiaba,Avai,1,1,0,0,1,1,0,2,2,15,11,26
2948,7986,20,35,31/10/2022,Ceara,Fluminense,2,2,1,0,3,2,1,4,5,11,8,19
2949,7987,20,35,1/11/2022,Botafogo-RJ,Cuiaba,1,1,0,0,1,1,0,2,2,4,18,22
2950,7988,20,35,1/11/2022,Sao Paulo,Atletico-MG,3,5,0,0,3,5,0,8,8,10,16,26
2951,7989,20,35,2/11/2022,Athletico-PR,Goias,2,1,0,0,2,1,0,3,3,10,11,21
2952,7991,20,35,2/11/2022,Juventude,Coritiba,3,4,0,0,3,4,0,7,7,11,18,29
2953,7992,20,35,2/11/2022,Avai,Bragantino,2,1,0,0,2,1,0,3,3,17,17,34
2954,7993,20,35,2/11/2022,Atletico-GO,Santos,3,2,0,0,3,2,0,5,5,15,10,25
2955,7994,20,35,2/11/2022,Palmeiras,Fortaleza,3,1,0,0,3,1,0,4,4,11,16,27
2956,7995,20,35,2/11/2022,Flamengo,Corinthians,0,1,0,0,0,1,0,1,1,9,14,23
2957,7996,20,36,5/11/2022,Santos,Avai,3,0,0,0,3,0,0,3,3,14,13,27
2958,7997,20,36,5/11/2022,Fluminense,Sao Paulo,1,1,0,1,1,2,1,2,3,16,16,32
2959,7998,20,36,5/11/2022,Bragantino,America-MG,6,2,0,0,6,2,0,8,8,17,9,26
2960,7999,20,36,5/11/2022,Goias,Juventude,4,6,0,0,4,6,0,10,10,15,22,37
2961,8000,20,36,5/11/2022,Corinthians,Ceara,4,4,0,0,4,4,0,8,8,10,12,22
2962,8001,20,36,5/11/2022,Internacional,Athletico-PR,0,1,0,1,0,2,1,1,2,5,20,25
2963,8002,20,36,6/11/2022,Fortaleza,Atletico-GO,2,5,0,1,2,6,1,7,8,9,12,21
2964,8003,20,36,6/11/2022,Coritiba,Flamengo,5,3,0,0,5,3,0,8,8,13,11,24
2965,8004,20,36,6/11/2022,Cuiaba,Palmeiras,2,0,0,0,2,0,0,2,2,13,8,21
2966,8005,20,36,7/11/2022,Atletico-MG,Botafogo-RJ,2,5,0,0,2,5,0,7,7,10,19,29
2967,8006,20,37,8/11/2022,Sao Paulo,Internacional,4,5,0,0,4,5,0,9,9,11,12,23
2968,8007,20,37,9/11/2022,Coritiba,Corinthians,4,5,0,1,4,6,1,9,10,15,8,23
2969,8008,20,37,9/11/2022,Fluminense,Goias,3,2,0,2,3,4,2,5,7,10,11,21
2970,8009,20,37,9/11/2022,Avai,Ceara,4,5,0,0,4,5,0,9,9,17,21,38
2971,8010,20,37,9/11/2022,Fortaleza,Bragantino,1,4,0,0,1,4,0,5,5,17,12,29
2972,8011,20,37,9/11/2022,Juventude,Flamengo,7,3,0,0,7,3,0,10,10,17,14,31
2973,8012,20,37,9/11/2022,Palmeiras,America-MG,4,2,0,0,4,2,0,6,6,11,11,22
2974,8013,20,37,9/11/2022,Atletico-GO,Athletico-PR,1,0,0,0,1,0,0,1,1,8,12,20
2975,8014,20,37,10/11/2022,Botafogo-RJ,Santos,2,4,0,1,2,5,1,6,7,15,17,32
2976,8015,20,37,10/11/2022,Atletico-MG,Cuiaba,1,4,0,0,1,4,0,5,5,12,11,23
2977,8016,20,38,12/11/2022,Flamengo,Avai,0,1,0,0,0,1,0,1,1,14,11,25
2978,8017,20,38,13/11/2022,Athletico-PR,Botafogo-RJ,1,1,0,0,1,1,0,2,2,19,13,32
2979,8018,20,38,13/11/2022,Ceara,Juventude,4,4,0,0,4,4,0,8,8,16,16,32
2980,8019,20,38,13/11/2022,America-MG,Atletico-GO,3,2,0,1,3,3,1,5,6,14,12,26
2981,8020,20,38,13/11/2022,Santos,Fortaleza,1,3,0,0,1,3,0,4,4,17,14,31
2982,8021,20,38,13/11/2022,Cuiaba,Coritiba,1,4,0,1,1,5,1,5,6,9,8,17
2983,8022,20,38,13/11/2022,Bragantino,Fluminense,3,2,0,0,3,2,0,5,5,16,15,31
2984,8023,20,38,13/11/2022,Corinthians,Atletico-MG,3,6,0,0,3,6,0,9,9,11,19,30
2985,8024,20,38,13/11/2022,Internacional,Palmeiras,2,3,0,0,2,3,0,5,5,13,17,30
2986,8025,20,38,13/11/2022,Goias,Sao Paulo,2,1,0,0,2,1,0,3,3,12,14,26
2987,5037,13,6,6/6/2015,Atletico-MG,Cruzeiro,0,0,0,0,0,0,0,0,0,12,13,25
2988,5128,13,15,25/7/2015,Gremio,Sport,0,0,0,0,0,0,0,0,0,6,8,14
2989,5149,13,17,9/8/2015,Athletico-PR,Sport,0,0,0,0,0,0,0,0,0,6,11,17
2990,5174,13,19,16/8/2015,Sport,Ponte Preta,0,0,0,0,0,0,0,0,0,7,16,23
2991,5207,13,23,5/9/2015,Sao Paulo,Internacional,0,0,0,0,0,0,0,0,0,10,10,20
2992,5334,13,35,19/11/2015,Sao Paulo,Atletico-MG,0,0,0,0,0,0,0,0,0,7,9,16
2993,5364,13,38,6/12/2015,Atletico-MG,Chapecoense,0,0,0,0,0,0,0,0,0,7,11,18
2994,5375,14,1,15/5/2016,America-MG,Fluminense,0,0,0,0,0,0,0,0,0,8,9,17
2995,5444,14,8,15/6/2016,Cruzeiro,Flamengo,0,0,0,0,0,0,0,0,0,9,9,18
2996,5486,14,12,30/6/2016,Atletico-MG,Botafogo-RJ,0,0,0,0,0,0,0,0,0,15,9,24
2997,5650,14,29,5/10/2016,Santos,Fluminense,0,0,0,0,0,0,0,0,0,16,10,26
2998,5663,14,30,13/10/2016,Atletico-MG,America-MG,0,0,0,0,0,0,0,0,0,8,11,19
2999,5686,14,32,24/10/2016,America-MG,Athletico-PR,0,0,0,0,0,0,0,0,0,8,9,17
3000,5702,14,34,6/11/2016,Palmeiras,Internacional,0,0,0,0,0,0,0,0,0,10,19,29
3001,5824,15,8,18/6/2017,Sport,Vitoria,0,0,0,0,0,0,0,0,0,10,19,29
3002,5876,15,14,15/7/2017,Corinthians,Athletico-PR,0,0,0,0,0,0,0,0,0,5,11,16
3003,5931,15,19,6/8/2017,Coritiba,Chapecoense,0,0,0,0,0,0,0,0,0,13,21,34
3004,5974,15,23,10/9/2017,Botafogo-RJ,Flamengo,0,0,0,0,0,0,0,0,0,10,16,26
3005,6019,15,27,11/10/2017,Gremio,Cruzeiro,0,0,0,0,0,0,0,0,0,15,13,28
3006,6062,15,32,5/11/2017,Gremio,Flamengo,0,0,0,0,0,0,0,0,0,12,14,26
3007,6132,16,1,15/4/2018,Corinthians,Fluminense,0,0,0,0,0,0,0,0,0,14,15,29
3008,6246,16,13,18/7/2018,Ceara,Sport,0,0,0,0,0,0,0,0,0,15,12,27
3009,6416,16,30,20/10/2018,America-MG,Gremio,0,0,0,0,0,0,0,0,0,17,8,25
3010,6517,17,2,1/5/2019,CSA,Palmeiras,0,0,0,0,0,0,0,0,0,0,0,0
3011,6522,17,2,1/5/2019,Vasco,Atletico-MG,0,0,0,0,0,0,0,0,0,12,9,21
3012,6574,17,7,2/6/2019,Internacional,Avai,0,0,0,0,0,0,0,0,0,11,12,23
3013,6603,17,10,14/7/2019,Cruzeiro,Botafogo-RJ,0,0,0,0,0,0,0,0,0,11,8,19
3014,6650,17,15,17/8/2019,Gremio,Palmeiras,0,0,0,0,0,0,0,0,0,13,14,27
3015,6783,17,28,27/10/2019,Sao Paulo,Atletico-MG,0,0,0,0,0,0,0,0,0,9,11,20
3016,6786,17,29,30/10/2019,Palmeiras,Sao Paulo,0,0,0,0,0,0,0,0,0,12,14,26
3017,6864,17,36,1/12/2019,Gremio,Sao Paulo,0,0,0,0,0,0,0,0,0,15,16,31
3018,6965,18,7,3/9/2020,Atletico-MG,Sao Paulo,0,0,0,0,0,0,0,0,0,18,11,29
3019,7146,18,27,26/12/2020,Atletico-MG,Coritiba,0,0,0,0,0,0,0,0,0,15,13,28
3020,7191,18,31,20/1/2021,Bragantino,Vasco,0,0,0,0,0,0,0,0,0,12,17,29
3021,7218,18,34,3/2/2021,Corinthians,Ceara,0,0,0,0,0,0,0,0,0,18,14,32
3022,7229,18,35,8/2/2021,Botafogo-RJ,Gremio,0,0,0,0,0,0,0,0,0,14,18,32
3023,7215,18,33,17/2/2021,Santos,Corinthians,0,0,0,0,0,0,0,0,0,24,25,49
3024,7257,18,38,25/2/2021,Bahia,Santos,0,0,0,0,0,0,0,0,0,11,13,24
3025,7265,18,38,25/2/2021,Fluminense,Fortaleza,0,0,0,0,0,0,0,0,0,10,12,22
3026,7290,19,3,13/6/2021,Flamengo,America-MG,0,0,0,0,0,0,0,0,0,17,18,35
3027,7401,19,14,1/8/2021,Chapecoense,Santos,2,1,2,0,4,1,2,3,5,17,13,30
3028,7450,19,19,7/9/2021,Chapecoense,Fluminense,0,0,0,0,0,0,0,0,0,18,4,22
3029,7460,19,20,12/9/2021,Gremio,Ceara,0,0,0,0,0,0,0,0,0,22,9,31
3030,7488,19,23,2/10/2021,Bragantino,Corinthians,0,0,0,0,0,0,0,0,0,10,6,16
3031,7541,19,28,24/10/2021,Atletico-MG,Cuiaba,0,0,0,0,0,0,0,0,0,12,13,25
3032,7715,20,6,15/5/2022,Goias,Santos,0,0,0,0,0,0,0,0,0,14,11,25
3033,7791,20,15,3/7/2022,Avai,Cuiaba,0,0,0,0,0,0,0,0,0,10,12,22
3034,7838,20,20,30/7/2022,Corinthians,Botafogo-RJ,0,0,0,0,0,0,0,0,0,6,6,12
3035,7866,20,23,20/8/2022,Atletico-MG,Goias,0,0,0,0,0,0,0,0,0,10,13,23
3036,7870,20,23,21/8/2022,Athletico-PR,America-MG,0,0,0,0,0,0,0,0,0,10,10,20
3037,7883,20,24,28/8/2022,Cuiaba,Santos,0,0,0,0,0,0,0,0,0,13,6,19
3038,7990,20,35,2/11/2022,America-MG,Internacional,0,0,0,0,0,0,0,0,0,9,12,21
