,ID,clube_mandante,qtd_cartao_amarelo_mandante,qtd_cartao_vermelho_mandante,clube_visitante,qtd_cartao_amarelo_visitante,qtd_cartao_vermelho_visitante,total_cartoes_mandante,total_cartoes_visitante,total_cartoes_amarelos,total_cartoes_vermelhos,total_cartoes_partida
0,4607,Fluminense,0,0,Figueirense,2,0,0,2,2,0,2
1,4608,Internacional,2,0,Vitoria,3,0,2,3,5,0,5
2,4609,Chapecoense,0,0,Coritiba,1,0,0,1,1,0,1
3,4610,Athletico-PR,1,0,Gremio,2,0,1,2,3,0,3
4,4611,Sao Paulo,1,0,Botafogo-RJ,2,0,1,2,3,0,3
5,4612,Bahia,4,0,Cruzeiro,4,0,4,4,8,0,8
6,4614,Flamengo,4,0,Goias,2,0,4,2,6,0,6
7,4615,Santos,1,0,Sport,3,0,1,3,4,0,4
8,4616,Criciuma,3,0,Palmeiras,5,0,3,5,8,0,8
9,4617,Coritiba,3,0,Santos,4,0,3,4,7,0,7
10,4618,Palmeiras,1,0,Fluminense,2,0,1,2,3,0,3
11,4619,Botafogo-RJ,2,1,Internacional,4,0,3,4,6,1,7
12,4620,Vitoria,1,0,Athletico-PR,1,0,1,1,2,0,2
13,4621,Corinthians,2,0,Flamengo,1,1,2,2,3,1,4
14,4622,Cruzeiro,2,0,Sao Paulo,1,0,2,1,3,0,3
15,4623,Figueirense,3,0,Bahia,2,0,3,2,5,0,5
16,4624,Gremio,3,1,Atletico-MG,3,0,4,3,6,1,7
17,4625,Goias,0,0,Criciuma,1,0,0,1,1,0,1
18,4626,Sport,1,0,Chapecoense,1,0,1,1,2,0,2
19,4627,Santos,1,0,Gremio,1,0,1,1,2,0,2
20,4628,Athletico-PR,3,1,Cruzeiro,3,0,4,3,6,1,7
21,4629,Sao Paulo,3,0,Coritiba,3,0,3,3,6,0,6
22,4630,Fluminense,1,0,Vitoria,1,0,1,1,2,0,2
23,4631,Criciuma,1,0,Figueirense,5,1,1,6,6,1,7
24,4632,Internacional,2,0,Sport,2,0,2,2,4,0,4
25,4633,Bahia,4,0,Botafogo-RJ,4,0,4,4,8,0,8
26,4634,Flamengo,2,0,Palmeiras,4,0,2,4,6,0,6
27,4635,Chapecoense,3,0,Corinthians,3,0,3,3,6,0,6
28,4636,Atletico-MG,2,0,Goias,1,0,2,1,3,0,3
29,4637,Internacional,3,0,Athletico-PR,1,0,3,1,4,0,4
30,4638,Palmeiras,5,0,Goias,4,0,5,4,9,0,9
31,4639,Botafogo-RJ,1,0,Criciuma,5,0,1,5,6,0,6
32,4640,Chapecoense,2,0,Gremio,4,0,2,4,6,0,6
33,4641,Fluminense,2,0,Flamengo,4,0,2,4,6,0,6
34,4642,Atletico-MG,5,0,Cruzeiro,2,2,5,4,7,2,9
35,4643,Sao Paulo,3,0,Corinthians,2,0,3,2,5,0,5
36,4644,Figueirense,2,1,Santos,1,1,3,2,3,2,5
37,4645,Coritiba,3,0,Sport,1,0,3,1,4,0,4
38,4646,Bahia,3,1,Vitoria,3,1,4,4,6,2,8
39,4647,Goias,3,0,Botafogo-RJ,0,0,3,0,3,0,3
40,4648,Cruzeiro,2,0,Coritiba,1,0,2,1,3,0,3
41,4649,Gremio,3,0,Fluminense,2,1,3,3,5,1,6
42,4650,Corinthians,4,0,Figueirense,3,0,4,3,7,0,7
43,4651,Flamengo,1,0,Sao Paulo,1,0,1,1,2,0,2
44,4652,Athletico-PR,2,0,Chapecoense,2,0,2,2,4,0,4
45,4654,Criciuma,2,1,Internacional,3,0,3,3,5,1,6
46,4655,Santos,3,0,Atletico-MG,3,0,3,3,6,0,6
47,4656,Sport,6,0,Bahia,4,2,6,6,10,2,12
48,4657,Coritiba,3,0,Internacional,6,0,3,6,9,0,9
49,4658,Flamengo,3,0,Bahia,1,0,3,1,4,0,4
50,4660,Criciuma,1,0,Chapecoense,0,0,1,0,1,0,1
51,4661,Corinthians,1,0,Athletico-PR,5,0,1,5,6,0,6
52,4662,Fluminense,1,0,Sao Paulo,4,0,1,4,5,0,5
53,4663,Gremio,2,0,Botafogo-RJ,3,0,2,3,5,0,5
54,4664,Palmeiras,2,0,Figueirense,3,0,2,3,5,0,5
55,4665,Goias,3,0,Santos,2,0,3,2,5,0,5
56,4666,Vitoria,2,0,Atletico-MG,2,0,2,2,4,0,4
57,4667,Bahia,1,0,Fluminense,0,0,1,0,1,0,1
58,4668,Sao Paulo,4,0,Gremio,2,0,4,2,6,0,6
59,4669,Santos,2,1,Flamengo,3,0,3,3,5,1,6
60,4670,Figueirense,1,0,Goias,2,0,1,2,3,0,3
61,4671,Sport,3,2,Corinthians,1,0,5,1,4,2,6
62,4672,Athletico-PR,3,0,Coritiba,5,0,3,5,8,0,8
63,4673,Internacional,1,0,Cruzeiro,2,0,1,2,3,0,3
64,4674,Botafogo-RJ,4,0,Vitoria,4,0,4,4,8,0,8
65,4675,Chapecoense,2,0,Palmeiras,2,0,2,2,4,0,4
66,4676,Atletico-MG,2,0,Criciuma,2,0,2,2,4,0,4
67,4677,Criciuma,5,0,Coritiba,5,0,5,5,10,0,10
68,4678,Palmeiras,1,1,Botafogo-RJ,3,0,2,3,4,1,5
69,4679,Sport,1,0,Gremio,2,0,1,2,3,0,3
70,4680,Internacional,2,0,Chapecoense,4,0,2,4,6,0,6
71,4682,Corinthians,2,0,Cruzeiro,0,0,2,0,2,0,2
72,4683,Athletico-PR,2,0,Sao Paulo,1,0,2,1,3,0,3
73,4684,Atletico-MG,7,0,Fluminense,4,1,7,5,11,1,12
74,4685,Flamengo,0,0,Figueirense,1,0,0,1,1,0,1
75,4686,Bahia,4,0,Santos,2,0,4,2,6,0,6
76,4687,Coritiba,4,0,Goias,2,0,4,2,6,0,6
77,4688,Sao Paulo,3,0,Atletico-MG,2,0,3,2,5,0,5
78,4689,Vitoria,4,0,Sport,3,0,4,3,7,0,7
79,4690,Gremio,3,0,Palmeiras,5,0,3,5,8,0,8
80,4691,Chapecoense,4,0,Bahia,3,0,4,3,7,0,7
81,4692,Cruzeiro,0,0,Flamengo,1,0,0,1,1,0,1
82,4693,Fluminense,2,0,Internacional,3,0,2,3,5,0,5
83,4694,Santos,2,0,Criciuma,4,0,2,4,6,0,6
84,4695,Figueirense,4,0,Athletico-PR,4,0,4,4,8,0,8
85,4696,Botafogo-RJ,3,1,Corinthians,2,0,4,2,5,1,6
86,4697,Corinthians,0,0,Botafogo-RJ,3,0,0,3,3,0,3
87,4698,Goias,2,0,Coritiba,2,0,2,2,4,0,4
88,4699,Palmeiras,1,0,Gremio,5,1,1,6,6,1,7
89,4700,Flamengo,2,0,Cruzeiro,2,0,2,2,4,0,4
90,4701,Bahia,1,0,Chapecoense,2,1,1,3,3,1,4
91,4702,Internacional,3,0,Fluminense,3,0,3,3,6,0,6
92,4703,Atletico-MG,0,0,Sao Paulo,1,0,0,1,1,0,1
93,4704,Athletico-PR,2,0,Figueirense,3,0,2,3,5,0,5
94,4705,Sport,2,0,Vitoria,4,0,2,4,6,0,6
95,4706,Criciuma,4,0,Santos,1,0,4,1,5,0,5
96,4707,Gremio,1,0,Goias,4,0,1,4,5,0,5
97,4708,Coritiba,1,0,Figueirense,2,0,1,2,3,0,3
98,4709,Sport,1,0,Botafogo-RJ,2,0,1,2,3,0,3
99,4710,Criciuma,2,0,Fluminense,2,0,2,2,4,0,4
100,4711,Bahia,4,0,Sao Paulo,4,0,4,4,8,0,8
101,4712,Flamengo,1,0,Athletico-PR,3,0,1,3,4,0,4
102,4713,Corinthians,3,0,Internacional,4,0,3,4,7,0,7
103,4714,Santos,1,0,Palmeiras,3,0,1,3,4,0,4
104,4715,Cruzeiro,0,0,Vitoria,3,0,0,3,3,0,3
105,4716,Chapecoense,1,0,Atletico-MG,1,0,1,1,2,0,2
106,4717,Sao Paulo,3,0,Chapecoense,3,0,3,3,6,0,6
107,4718,Figueirense,1,1,Gremio,6,0,2,6,7,1,8
108,4719,Atletico-MG,3,0,Bahia,4,0,3,4,7,0,7
109,4720,Botafogo-RJ,2,0,Coritiba,1,0,2,1,3,0,3
110,4721,Internacional,0,0,Flamengo,1,1,0,2,1,1,2
111,4722,Palmeiras,3,0,Cruzeiro,5,0,3,5,8,0,8
112,4723,Vitoria,1,0,Corinthians,1,0,1,1,2,0,2
113,4724,Athletico-PR,1,0,Criciuma,1,0,1,1,2,0,2
114,4725,Fluminense,2,0,Santos,1,0,2,1,3,0,3
115,4726,Goias,1,0,Sport,3,0,1,3,4,0,4
116,4727,Santos,2,0,Chapecoense,1,0,2,1,3,0,3
117,4728,Cruzeiro,0,0,Figueirense,2,0,0,2,2,0,2
118,4729,Criciuma,3,1,Vitoria,3,0,4,3,6,1,7
119,4730,Bahia,2,0,Internacional,2,0,2,2,4,0,4
120,4731,Goias,2,0,Sao Paulo,1,0,2,1,3,0,3
121,4732,Athletico-PR,3,0,Fluminense,1,0,3,1,4,0,4
122,4733,Corinthians,1,0,Palmeiras,2,0,1,2,3,0,3
123,4734,Sport,0,0,Atletico-MG,3,0,0,3,3,0,3
124,4735,Flamengo,3,1,Botafogo-RJ,4,0,4,4,7,1,8
125,4736,Gremio,1,0,Coritiba,2,0,1,2,3,0,3
126,4737,Botafogo-RJ,2,0,Cruzeiro,1,0,2,1,3,0,3
127,4738,Sao Paulo,1,0,Criciuma,1,0,1,1,2,0,2
128,4740,Palmeiras,3,0,Bahia,3,0,3,3,6,0,6
129,4741,Chapecoense,4,0,Flamengo,1,0,4,1,5,0,5
130,4742,Coritiba,3,0,Corinthians,2,1,3,3,5,1,6
131,4743,Figueirense,1,0,Sport,1,0,1,1,2,0,2
132,4744,Internacional,4,1,Santos,2,1,5,3,6,2,8
133,4745,Fluminense,1,0,Goias,1,0,1,1,2,0,2
134,4746,Atletico-MG,2,0,Athletico-PR,3,0,2,3,5,0,5
135,4747,Criciuma,3,0,Cruzeiro,1,0,3,1,4,0,4
136,4748,Bahia,4,0,Goias,2,0,4,2,6,0,6
137,4749,Fluminense,3,0,Coritiba,1,0,3,1,4,0,4
138,4750,Flamengo,2,0,Sport,1,0,2,1,3,0,3
139,4751,Santos,3,1,Corinthians,3,0,4,3,6,1,7
140,4752,Athletico-PR,0,0,Botafogo-RJ,3,0,0,3,3,0,3
141,4753,Internacional,3,0,Gremio,5,0,3,5,8,0,8
142,4754,Atletico-MG,2,0,Palmeiras,2,0,2,2,4,0,4
143,4755,Chapecoense,2,0,Figueirense,2,0,2,2,4,0,4
144,4756,Sao Paulo,5,0,Vitoria,2,0,5,2,7,0,7
145,4757,Goias,1,0,Internacional,1,0,1,1,2,0,2
146,4758,Corinthians,1,0,Bahia,4,0,1,4,5,0,5
147,4759,Coritiba,2,1,Flamengo,4,0,3,4,6,1,7
148,4760,Palmeiras,2,0,Sao Paulo,4,0,2,4,6,0,6
149,4761,Gremio,1,0,Criciuma,2,0,1,2,3,0,3
150,4762,Cruzeiro,3,0,Santos,1,0,3,1,4,0,4
151,4763,Vitoria,1,0,Chapecoense,1,0,1,1,2,0,2
152,4764,Botafogo-RJ,4,0,Fluminense,2,0,4,2,6,0,6
153,4765,Sport,4,0,Athletico-PR,3,0,4,3,7,0,7
154,4766,Figueirense,6,0,Atletico-MG,5,0,6,5,11,0,11
155,4767,Sport,0,0,Palmeiras,1,0,0,1,1,0,1
156,4768,Figueirense,1,0,Botafogo-RJ,2,0,1,2,3,0,3
157,4769,Santos,0,0,Athletico-PR,2,0,0,2,2,0,2
158,4770,Coritiba,3,0,Vitoria,1,0,3,1,4,0,4
159,4771,Bahia,2,0,Criciuma,5,0,2,5,7,0,7
160,4772,Chapecoense,2,0,Fluminense,3,1,2,4,5,1,6
161,4773,Flamengo,2,0,Atletico-MG,2,0,2,2,4,0,4
162,4774,Internacional,1,0,Sao Paulo,1,0,1,1,2,0,2
163,4775,Corinthians,1,0,Goias,3,0,1,3,4,0,4
164,4776,Cruzeiro,5,0,Gremio,3,0,5,3,8,0,8
165,4777,Atletico-MG,3,0,Internacional,2,0,3,2,5,0,5
166,4778,Botafogo-RJ,2,0,Chapecoense,1,0,2,1,3,0,3
167,4779,Palmeiras,6,0,Coritiba,4,1,6,5,10,1,11
168,4780,Gremio,2,0,Corinthians,3,1,2,4,5,1,6
169,4781,Criciuma,2,1,Flamengo,0,0,3,0,2,1,3
170,4782,Vitoria,2,0,Figueirense,2,0,2,2,4,0,4
171,4783,Sao Paulo,5,0,Santos,3,0,5,3,8,0,8
172,4784,Fluminense,1,0,Sport,0,0,1,0,1,0,1
173,4785,Goias,4,0,Cruzeiro,3,0,4,3,7,0,7
174,4786,Athletico-PR,1,0,Bahia,1,0,1,1,2,0,2
175,4787,Palmeiras,2,0,Internacional,3,0,2,3,5,0,5
176,4788,Cruzeiro,4,0,Chapecoense,3,0,4,3,7,0,7
177,4789,Corinthians,3,0,Fluminense,2,0,3,2,5,0,5
178,4790,Coritiba,2,0,Atletico-MG,4,0,2,4,6,0,6
179,4791,Sport,3,0,Criciuma,4,0,3,4,7,0,7
180,4792,Figueirense,1,0,Sao Paulo,2,1,1,3,3,1,4
181,4793,Botafogo-RJ,2,0,Santos,2,0,2,2,4,0,4
182,4794,Gremio,4,0,Bahia,3,0,4,3,7,0,7
183,4796,Vitoria,2,0,Flamengo,3,0,2,3,5,0,5
184,4797,Santos,1,0,Vitoria,6,0,1,6,7,0,7
185,4798,Flamengo,1,0,Gremio,2,0,1,2,3,0,3
186,4799,Chapecoense,2,0,Goias,1,0,2,1,3,0,3
187,4800,Sao Paulo,0,0,Sport,2,0,0,2,2,0,2
188,4801,Criciuma,5,0,Corinthians,3,0,5,3,8,0,8
189,4802,Atletico-MG,3,0,Botafogo-RJ,3,1,3,4,6,1,7
190,4803,Fluminense,1,0,Cruzeiro,4,0,1,4,5,0,5
191,4804,Bahia,6,0,Coritiba,2,0,6,2,8,0,8
192,4805,Athletico-PR,3,0,Palmeiras,0,1,3,1,3,1,4
193,4806,Internacional,3,0,Figueirense,4,1,3,5,7,1,8
194,4807,Gremio,2,0,Athletico-PR,3,0,2,3,5,0,5
195,4808,Palmeiras,4,0,Criciuma,3,0,4,3,7,0,7
196,4809,Figueirense,3,1,Fluminense,2,1,4,3,5,2,7
197,4810,Sport,5,0,Santos,1,0,5,1,6,0,6
198,4811,Coritiba,3,0,Chapecoense,2,0,3,2,5,0,5
199,4813,Botafogo-RJ,1,1,Sao Paulo,2,0,2,2,3,1,4
200,4814,Vitoria,1,0,Internacional,1,0,1,1,2,0,2
201,4815,Corinthians,3,0,Atletico-MG,1,0,3,1,4,0,4
202,4816,Cruzeiro,1,0,Bahia,4,2,1,6,5,2,7
203,4817,Fluminense,1,0,Palmeiras,4,0,1,4,5,0,5
204,4818,Chapecoense,1,0,Sport,2,0,1,2,3,0,3
205,4819,Santos,4,0,Coritiba,3,0,4,3,7,0,7
206,4820,Bahia,2,0,Figueirense,1,0,2,1,3,0,3
207,4821,Internacional,2,0,Botafogo-RJ,3,0,2,3,5,0,5
208,4822,Flamengo,2,0,Corinthians,1,0,2,1,3,0,3
209,4823,Sao Paulo,3,0,Cruzeiro,2,0,3,2,5,0,5
210,4824,Athletico-PR,1,0,Vitoria,2,0,1,2,3,0,3
211,4825,Atletico-MG,1,0,Gremio,2,0,1,2,3,0,3
212,4826,Criciuma,3,0,Goias,5,0,3,5,8,0,8
213,4827,Vitoria,1,0,Fluminense,0,0,1,0,1,0,1
214,4828,Cruzeiro,1,0,Athletico-PR,0,0,1,0,1,0,1
215,4829,Sport,4,0,Internacional,1,0,4,1,5,0,5
216,4830,Figueirense,2,0,Criciuma,4,0,2,4,6,0,6
217,4831,Botafogo-RJ,4,3,Bahia,3,0,7,3,7,3,10
218,4832,Palmeiras,1,1,Flamengo,4,0,2,4,5,1,6
219,4833,Coritiba,5,0,Sao Paulo,1,0,5,1,6,0,6
220,4834,Corinthians,0,0,Chapecoense,3,0,0,3,3,0,3
221,4835,Goias,0,0,Atletico-MG,1,0,0,1,1,0,1
222,4836,Gremio,2,0,Santos,0,0,2,0,2,0,2
223,4837,Athletico-PR,1,0,Internacional,1,0,1,1,2,0,2
224,4838,Criciuma,4,0,Botafogo-RJ,4,0,4,4,8,0,8
225,4839,Cruzeiro,0,0,Atletico-MG,3,0,0,3,3,0,3
226,4840,Flamengo,1,0,Fluminense,5,0,1,5,6,0,6
227,4841,Sport,2,0,Coritiba,2,0,2,2,4,0,4
228,4842,Corinthians,4,1,Sao Paulo,4,1,5,5,8,2,10
229,4843,Vitoria,3,0,Bahia,4,0,3,4,7,0,7
230,4844,Santos,1,0,Figueirense,2,0,1,2,3,0,3
231,4845,Goias,4,0,Palmeiras,1,1,4,2,5,1,6
232,4846,Gremio,2,0,Chapecoense,4,0,2,4,6,0,6
233,4847,Internacional,2,0,Criciuma,3,0,2,3,5,0,5
234,4848,Coritiba,4,0,Cruzeiro,2,0,4,2,6,0,6
235,4849,Bahia,2,0,Sport,3,0,2,3,5,0,5
236,4850,Chapecoense,1,0,Athletico-PR,2,0,1,2,3,0,3
237,4851,Sao Paulo,1,1,Flamengo,3,0,2,3,4,1,5
238,4852,Figueirense,2,0,Corinthians,1,0,2,1,3,0,3
239,4854,Palmeiras,2,0,Vitoria,4,0,2,4,6,0,6
240,4855,Botafogo-RJ,1,0,Goias,2,0,1,2,3,0,3
241,4856,Atletico-MG,3,0,Santos,3,0,3,3,6,0,6
242,4857,Chapecoense,1,1,Criciuma,3,1,2,4,4,2,6
243,4858,Sport,2,0,Cruzeiro,1,0,2,1,3,0,3
244,4859,Sao Paulo,4,0,Fluminense,1,0,4,1,5,0,5
245,4860,Bahia,1,0,Flamengo,0,0,1,0,1,0,1
246,4861,Athletico-PR,3,0,Corinthians,2,0,3,2,5,0,5
247,4862,Botafogo-RJ,3,0,Gremio,4,0,3,4,7,0,7
248,4863,Atletico-MG,2,0,Vitoria,2,0,2,2,4,0,4
249,4864,Figueirense,2,0,Palmeiras,3,1,2,4,5,1,6
250,4865,Internacional,1,0,Coritiba,1,0,1,1,2,0,2
251,4866,Santos,1,0,Goias,2,0,1,2,3,0,3
252,4867,Palmeiras,0,0,Chapecoense,4,0,0,4,4,0,4
253,4868,Flamengo,3,0,Santos,2,0,3,2,5,0,5
254,4869,Fluminense,3,0,Bahia,1,0,3,1,4,0,4
255,4870,Coritiba,2,0,Athletico-PR,2,0,2,2,4,0,4
256,4871,Vitoria,2,0,Botafogo-RJ,3,0,2,3,5,0,5
257,4872,Gremio,5,0,Sao Paulo,3,0,5,3,8,0,8
258,4873,Corinthians,0,0,Sport,1,0,0,1,1,0,1
259,4874,Cruzeiro,2,0,Internacional,4,0,2,4,6,0,6
260,4875,Criciuma,2,0,Atletico-MG,2,0,2,2,4,0,4
261,4876,Goias,0,0,Figueirense,1,0,0,1,1,0,1
262,4877,Botafogo-RJ,3,0,Palmeiras,3,0,3,3,6,0,6
263,4878,Coritiba,1,0,Criciuma,1,0,1,1,2,0,2
264,4879,Sao Paulo,3,0,Athletico-PR,2,0,3,2,5,0,5
265,4880,Vitoria,1,0,Goias,1,0,1,1,2,0,2
266,4881,Cruzeiro,1,0,Corinthians,2,0,1,2,3,0,3
267,4882,Gremio,3,0,Sport,1,0,3,1,4,0,4
268,4883,Figueirense,5,0,Flamengo,2,0,5,2,7,0,7
269,4884,Santos,1,0,Bahia,1,0,1,1,2,0,2
270,4885,Fluminense,1,0,Atletico-MG,2,0,1,2,3,0,3
271,4886,Chapecoense,0,0,Internacional,1,1,0,2,1,1,2
272,4887,Goias,3,0,Gremio,2,0,3,2,5,0,5
273,4888,Sao Paulo,5,0,Bahia,2,0,5,2,7,0,7
274,4889,Fluminense,5,0,Criciuma,5,1,5,6,10,1,11
275,4890,Atletico-MG,0,0,Chapecoense,1,0,0,1,1,0,1
276,4891,Athletico-PR,1,0,Flamengo,1,0,1,1,2,0,2
277,4892,Figueirense,4,0,Coritiba,3,0,4,3,7,0,7
278,4893,Internacional,5,0,Corinthians,5,0,5,5,10,0,10
279,4894,Palmeiras,3,0,Santos,6,0,3,6,9,0,9
280,4895,Vitoria,3,0,Cruzeiro,2,0,3,2,5,0,5
281,4896,Botafogo-RJ,0,0,Sport,1,0,0,1,1,0,1
282,4897,Bahia,2,1,Atletico-MG,3,1,3,4,5,2,7
283,4898,Corinthians,1,0,Vitoria,1,0,1,1,2,0,2
284,4899,Flamengo,2,0,Internacional,1,0,2,1,3,0,3
285,4900,Criciuma,4,0,Athletico-PR,3,0,4,3,7,0,7
286,4901,Cruzeiro,1,0,Palmeiras,4,0,1,4,5,0,5
287,4902,Gremio,3,0,Figueirense,3,1,3,4,6,1,7
288,4903,Coritiba,3,0,Botafogo-RJ,3,1,3,4,6,1,7
289,4904,Chapecoense,2,0,Sao Paulo,3,1,2,4,5,1,6
290,4905,Santos,2,0,Fluminense,1,0,2,1,3,0,3
291,4906,Sport,1,0,Goias,4,0,1,4,5,0,5
292,4907,Figueirense,1,0,Cruzeiro,1,0,1,1,2,0,2
293,4908,Palmeiras,5,0,Corinthians,3,0,5,3,8,0,8
294,4909,Fluminense,1,0,Athletico-PR,1,0,1,1,2,0,2
295,4910,Vitoria,0,0,Criciuma,4,0,0,4,4,0,4
296,4911,Atletico-MG,1,1,Sport,4,0,2,4,5,1,6
297,4912,Chapecoense,1,0,Santos,4,0,1,4,5,0,5
298,4913,Coritiba,2,0,Gremio,5,0,2,5,7,0,7
299,4914,Internacional,2,0,Bahia,4,0,2,4,6,0,6
300,4915,Botafogo-RJ,2,0,Flamengo,1,0,2,1,3,0,3
301,4916,Sao Paulo,1,0,Goias,2,0,1,2,3,0,3
302,4917,Goias,0,0,Fluminense,3,0,0,3,3,0,3
303,4918,Gremio,0,0,Vitoria,1,0,0,1,1,0,1
304,4920,Santos,2,0,Internacional,5,0,2,5,7,0,7
305,4921,Sport,3,0,Figueirense,2,0,3,2,5,0,5
306,4922,Cruzeiro,2,0,Botafogo-RJ,3,0,2,3,5,0,5
307,4923,Criciuma,2,0,Sao Paulo,2,0,2,2,4,0,4
308,4924,Athletico-PR,2,0,Atletico-MG,1,0,2,1,3,0,3
309,4925,Flamengo,2,0,Chapecoense,1,0,2,1,3,0,3
310,4926,Bahia,4,0,Palmeiras,3,0,4,3,7,0,7
311,4927,Coritiba,2,0,Fluminense,5,0,2,5,7,0,7
312,4928,Palmeiras,0,0,Atletico-MG,1,0,0,1,1,0,1
313,4929,Botafogo-RJ,0,1,Athletico-PR,0,0,1,0,0,1,1
314,4930,Vitoria,2,0,Sao Paulo,1,0,2,1,3,0,3
315,4931,Gremio,2,0,Internacional,3,0,2,3,5,0,5
316,4932,Figueirense,4,0,Chapecoense,0,0,4,0,4,0,4
317,4933,Sport,3,0,Flamengo,3,0,3,3,6,0,6
318,4934,Corinthians,2,0,Santos,2,0,2,2,4,0,4
319,4935,Cruzeiro,5,0,Criciuma,4,0,5,4,9,0,9
320,4936,Goias,2,0,Bahia,2,0,2,2,4,0,4
321,4937,Sao Paulo,4,0,Internacional,3,1,4,4,7,1,8
322,4938,Botafogo-RJ,0,0,Figueirense,4,0,0,4,4,0,4
323,4939,Athletico-PR,2,0,Santos,1,0,2,1,3,0,3
324,4940,Goias,2,0,Corinthians,0,0,2,0,2,0,2
325,4941,Vitoria,3,0,Coritiba,2,0,3,2,5,0,5
326,4942,Criciuma,4,0,Bahia,1,0,4,1,5,0,5
327,4943,Atletico-MG,2,0,Flamengo,0,0,2,0,2,0,2
328,4944,Palmeiras,2,0,Sport,1,0,2,1,3,0,3
329,4945,Fluminense,4,0,Chapecoense,1,0,4,1,5,0,5
330,4946,Gremio,4,0,Cruzeiro,3,0,4,3,7,0,7
331,4947,Criciuma,4,0,Gremio,2,0,4,2,6,0,6
332,4948,Fluminense,4,0,Botafogo-RJ,3,0,4,3,7,0,7
333,4949,Bahia,2,0,Corinthians,2,0,2,2,4,0,4
334,4950,Athletico-PR,2,0,Sport,1,0,2,1,3,0,3
335,4951,Flamengo,1,0,Coritiba,3,0,1,3,4,0,4
336,4952,Santos,2,0,Cruzeiro,1,0,2,1,3,0,3
337,4953,Internacional,2,0,Goias,3,0,2,3,5,0,5
338,4954,Chapecoense,0,0,Vitoria,3,0,0,3,3,0,3
339,4955,Sao Paulo,3,0,Palmeiras,3,0,3,3,6,0,6
340,4956,Atletico-MG,0,0,Figueirense,3,0,0,3,3,0,3
341,4957,Internacional,4,0,Atletico-MG,0,0,4,0,4,0,4
342,4958,Bahia,2,1,Athletico-PR,0,0,3,0,2,1,3
343,4959,Santos,3,0,Sao Paulo,1,0,3,1,4,0,4
344,4960,Flamengo,1,0,Criciuma,4,0,1,4,5,0,5
345,4961,Sport,4,0,Fluminense,1,0,4,1,5,0,5
346,4962,Cruzeiro,1,0,Goias,2,0,1,2,3,0,3
347,4963,Figueirense,2,0,Vitoria,3,0,2,3,5,0,5
348,4964,Corinthians,1,0,Gremio,2,0,1,2,3,0,3
349,4965,Chapecoense,3,0,Botafogo-RJ,2,0,3,2,5,0,5
350,4966,Coritiba,3,0,Palmeiras,4,0,3,4,7,0,7
351,4967,Criciuma,4,0,Sport,0,0,4,0,4,0,4
352,4968,Internacional,2,1,Palmeiras,1,2,3,3,3,3,6
353,4969,Flamengo,3,0,Vitoria,4,1,3,5,7,1,8
354,4970,Sao Paulo,2,0,Figueirense,4,1,2,5,6,1,7
355,4971,Santos,1,0,Botafogo-RJ,1,0,1,1,2,0,2
356,4972,Fluminense,2,1,Corinthians,4,0,3,4,6,1,7
357,4973,Chapecoense,2,0,Cruzeiro,0,0,2,0,2,0,2
358,4974,Atletico-MG,3,0,Coritiba,4,0,3,4,7,0,7
359,4975,Athletico-PR,3,0,Goias,5,2,3,7,8,2,10
360,4976,Bahia,2,0,Gremio,2,1,2,3,4,1,5
361,4977,Corinthians,2,0,Criciuma,2,0,2,2,4,0,4
362,4978,Figueirense,2,3,Internacional,3,2,5,5,5,5,10
363,4979,Coritiba,3,0,Bahia,1,0,3,1,4,0,4
364,4980,Vitoria,0,0,Santos,3,0,0,3,3,0,3
365,4981,Sport,0,0,Sao Paulo,1,0,0,1,1,0,1
366,4982,Botafogo-RJ,3,0,Atletico-MG,3,0,3,3,6,0,6
367,4983,Palmeiras,1,0,Athletico-PR,1,0,1,1,2,0,2
368,4984,Gremio,3,0,Flamengo,0,1,3,1,3,1,4
369,4985,Cruzeiro,1,0,Fluminense,4,0,1,4,5,0,5
370,4986,Goias,2,0,Chapecoense,1,0,2,1,3,0,3
371,4987,Chapecoense,2,0,Coritiba,2,0,2,2,4,0,4
372,4988,Palmeiras,2,0,Atletico-MG,4,0,2,4,6,0,6
373,4989,Fluminense,2,0,Joinville,1,1,2,2,3,1,4
374,4990,Gremio,3,0,Ponte Preta,5,1,3,6,8,1,9
375,4991,Athletico-PR,1,0,Internacional,2,0,1,2,3,0,3
376,4992,Sao Paulo,2,0,Flamengo,1,0,2,1,3,0,3
377,4993,Cruzeiro,3,0,Corinthians,1,0,3,1,4,0,4
378,4994,Sport,1,0,Figueirense,3,1,1,4,4,1,5
379,4995,Avai,2,0,Santos,2,1,2,3,4,1,5
380,4996,Vasco,3,0,Goias,5,0,3,5,8,0,8
381,4997,Goias,2,0,Athletico-PR,1,1,2,2,3,1,4
382,4998,Coritiba,2,0,Gremio,3,0,2,3,5,0,5
383,4999,Corinthians,2,0,Chapecoense,4,0,2,4,6,0,6
384,5000,Figueirense,2,0,Vasco,6,0,2,6,8,0,8
385,5001,Atletico-MG,2,0,Fluminense,1,0,2,1,3,0,3
386,5002,Flamengo,2,0,Sport,3,0,2,3,5,0,5
387,5003,Santos,1,0,Cruzeiro,4,0,1,4,5,0,5
388,5004,Joinville,3,0,Palmeiras,1,0,3,1,4,0,4
389,5005,Ponte Preta,1,0,Sao Paulo,3,0,1,3,4,0,4
390,5006,Internacional,3,0,Avai,7,0,3,7,10,0,10
391,5007,Sao Paulo,2,0,Joinville,0,0,2,0,2,0,2
392,5008,Vasco,6,0,Internacional,3,1,6,4,9,1,10
393,5009,Gremio,6,0,Figueirense,5,0,6,5,11,0,11
394,5010,Palmeiras,6,1,Goias,5,1,7,6,11,2,13
395,5011,Chapecoense,5,0,Santos,6,0,5,6,11,0,11
396,5012,Athletico-PR,4,1,Atletico-MG,0,0,5,0,4,1,5
397,5013,Fluminense,2,0,Corinthians,2,0,2,2,4,0,4
398,5014,Avai,5,0,Flamengo,6,0,5,6,11,0,11
399,5015,Cruzeiro,2,0,Ponte Preta,2,0,2,2,4,0,4
400,5016,Sport,1,0,Coritiba,4,0,1,4,5,0,5
401,5017,Ponte Preta,4,0,Chapecoense,2,1,4,3,6,1,7
402,5018,Coritiba,4,0,Avai,4,0,4,4,8,0,8
403,5019,Joinville,0,0,Athletico-PR,4,0,0,4,4,0,4
404,5020,Santos,1,0,Sport,2,0,1,2,3,0,3
405,5021,Goias,1,0,Gremio,1,0,1,1,2,0,2
406,5022,Atletico-MG,0,0,Vasco,3,0,0,3,3,0,3
407,5023,Corinthians,5,0,Palmeiras,5,0,5,5,10,0,10
408,5024,Internacional,3,0,Sao Paulo,1,1,3,2,4,1,5
409,5025,Flamengo,6,1,Fluminense,3,1,7,4,9,2,11
410,5026,Figueirense,3,0,Cruzeiro,6,1,3,7,9,1,10
411,5027,Athletico-PR,1,0,Figueirense,4,0,1,4,5,0,5
412,5028,Vasco,2,2,Ponte Preta,3,0,4,3,5,2,7
413,5029,Chapecoense,3,0,Joinville,5,0,3,5,8,0,8
414,5030,Sao Paulo,5,0,Santos,3,1,5,4,8,1,9
415,5031,Cruzeiro,2,0,Flamengo,3,0,2,3,5,0,5
416,5032,Avai,3,0,Atletico-MG,3,0,3,3,6,0,6
417,5033,Gremio,2,0,Corinthians,3,0,2,3,5,0,5
418,5034,Fluminense,1,0,Coritiba,4,0,1,4,5,0,5
419,5035,Sport,2,0,Goias,4,0,2,4,6,0,6
420,5036,Palmeiras,1,0,Internacional,4,0,1,4,5,0,5
421,5038,Flamengo,1,0,Chapecoense,0,1,1,1,1,1,2
422,5039,Santos,2,0,Ponte Preta,2,0,2,2,4,0,4
423,5040,Athletico-PR,4,0,Vasco,3,0,4,3,7,0,7
424,5041,Joinville,1,0,Corinthians,1,0,1,1,2,0,2
425,5042,Sao Paulo,3,0,Gremio,2,0,3,2,5,0,5
426,5043,Internacional,4,1,Coritiba,5,0,5,5,9,1,10
427,5044,Figueirense,3,0,Palmeiras,3,0,3,3,6,0,6
428,5045,Goias,2,0,Avai,4,0,2,4,6,0,6
429,5046,Fluminense,3,0,Sport,2,0,3,2,5,0,5
430,5047,Atletico-MG,1,0,Santos,4,0,1,4,5,0,5
431,5048,Coritiba,2,0,Flamengo,4,1,2,5,6,1,7
432,5049,Chapecoense,2,0,Sao Paulo,4,0,2,4,6,0,6
433,5050,Corinthians,0,0,Internacional,2,0,0,2,2,0,2
434,5051,Sport,0,0,Joinville,4,0,0,4,4,0,4
435,5052,Vasco,2,0,Cruzeiro,4,0,2,4,6,0,6
436,5053,Ponte Preta,3,0,Goias,3,0,3,3,6,0,6
437,5054,Avai,4,0,Figueirense,3,0,4,3,7,0,7
438,5055,Palmeiras,0,0,Fluminense,7,2,0,9,7,2,9
439,5056,Gremio,1,0,Athletico-PR,4,0,1,4,5,0,5
440,5057,Figueirense,4,0,Internacional,2,0,4,2,6,0,6
441,5058,Sport,2,0,Vasco,3,0,2,3,5,0,5
442,5059,Flamengo,0,0,Atletico-MG,1,1,0,2,1,1,2
443,5060,Santos,5,1,Corinthians,4,1,6,5,9,2,11
444,5061,Gremio,4,0,Palmeiras,3,0,4,3,7,0,7
445,5062,Cruzeiro,4,0,Chapecoense,3,0,4,3,7,0,7
446,5063,Joinville,4,1,Goias,5,1,5,6,9,2,11
447,5064,Athletico-PR,2,0,Coritiba,5,2,2,7,7,2,9
448,5065,Sao Paulo,1,0,Avai,5,0,1,5,6,0,6
449,5066,Fluminense,2,0,Ponte Preta,3,0,2,3,5,0,5
450,5067,Avai,3,0,Gremio,3,0,3,3,6,0,6
451,5068,Chapecoense,1,0,Sport,6,0,1,6,7,0,7
452,5069,Corinthians,0,0,Figueirense,2,0,0,2,2,0,2
453,5070,Atletico-MG,2,0,Joinville,1,0,2,1,3,0,3
454,5071,Palmeiras,1,0,Sao Paulo,3,0,1,3,4,0,4
455,5072,Goias,2,0,Fluminense,2,1,2,3,4,1,5
456,5073,Ponte Preta,1,0,Athletico-PR,2,0,1,2,3,0,3
457,5074,Coritiba,5,0,Cruzeiro,5,0,5,5,10,0,10
458,5075,Vasco,4,0,Flamengo,0,0,4,0,4,0,4
459,5076,Internacional,3,0,Santos,3,1,3,4,6,1,7
460,5077,Sport,2,0,Internacional,2,1,2,3,4,1,5
461,5078,Vasco,3,1,Avai,2,1,4,3,5,2,7
462,5079,Palmeiras,0,0,Chapecoense,3,0,0,3,3,0,3
463,5080,Atletico-MG,3,0,Coritiba,5,0,3,5,8,0,8
464,5081,Joinville,3,0,Flamengo,2,0,3,2,5,0,5
465,5082,Gremio,5,0,Cruzeiro,6,0,5,6,11,0,11
466,5083,Athletico-PR,2,0,Sao Paulo,0,0,2,0,2,0,2
467,5084,Corinthians,1,0,Ponte Preta,2,0,1,2,3,0,3
468,5085,Figueirense,2,1,Goias,2,0,3,2,4,1,5
469,5086,Fluminense,2,0,Santos,3,0,2,3,5,0,5
470,5087,Coritiba,1,0,Joinville,2,0,1,2,3,0,3
471,5088,Chapecoense,1,0,Vasco,2,2,1,4,3,2,5
472,5089,Cruzeiro,0,0,Athletico-PR,2,1,0,3,2,1,3
473,5090,Avai,6,1,Sport,2,0,7,2,8,1,9
474,5091,Goias,2,0,Corinthians,2,0,2,2,4,0,4
475,5092,Sao Paulo,1,0,Fluminense,2,0,1,2,3,0,3
476,5093,Santos,4,1,Gremio,1,0,5,1,5,1,6
477,5094,Ponte Preta,3,0,Palmeiras,3,0,3,3,6,0,6
478,5095,Flamengo,3,0,Figueirense,2,0,3,2,5,0,5
479,5096,Internacional,1,1,Atletico-MG,3,0,2,3,4,1,5
480,5097,Chapecoense,1,0,Gremio,2,0,1,2,3,0,3
481,5098,Goias,0,0,Santos,3,0,0,3,3,0,3
482,5099,Coritiba,4,0,Ponte Preta,6,0,4,6,10,0,10
483,5100,Figueirense,1,0,Joinville,2,0,1,2,3,0,3
484,5101,Palmeiras,2,0,Avai,6,0,2,6,8,0,8
485,5102,Atletico-MG,2,0,Sport,2,0,2,2,4,0,4
486,5103,Internacional,3,0,Flamengo,2,0,3,2,5,0,5
487,5104,Vasco,3,0,Sao Paulo,0,0,3,0,3,0,3
488,5105,Corinthians,1,0,Athletico-PR,2,0,1,2,3,0,3
489,5106,Fluminense,2,0,Cruzeiro,2,0,2,2,4,0,4
490,5107,Santos,1,0,Figueirense,5,0,1,5,6,0,6
491,5108,Gremio,1,0,Vasco,3,0,1,3,4,0,4
492,5109,Ponte Preta,1,0,Atletico-MG,3,0,1,3,4,0,4
493,5110,Sao Paulo,1,0,Coritiba,3,0,1,3,4,0,4
494,5111,Joinville,4,0,Internacional,3,0,4,3,7,0,7
495,5112,Flamengo,0,0,Corinthians,2,0,0,2,2,0,2
496,5113,Athletico-PR,1,0,Fluminense,2,0,1,2,3,0,3
497,5114,Cruzeiro,2,0,Goias,1,0,2,1,3,0,3
498,5115,Sport,2,0,Palmeiras,1,0,2,1,3,0,3
499,5116,Avai,4,0,Chapecoense,2,0,4,2,6,0,6
500,5117,Internacional,1,0,Goias,1,0,1,1,2,0,2
501,5118,Flamengo,1,0,Gremio,5,0,1,5,6,0,6
502,5119,Corinthians,1,0,Atletico-MG,1,0,1,1,2,0,2
503,5120,Athletico-PR,2,0,Chapecoense,3,0,2,3,5,0,5
504,5121,Figueirense,1,0,Coritiba,2,0,1,2,3,0,3
505,5122,Sport,1,0,Sao Paulo,2,2,1,4,3,2,5
506,5123,Fluminense,2,0,Vasco,6,0,2,6,8,0,8
507,5124,Palmeiras,3,0,Santos,3,0,3,3,6,0,6
508,5125,Cruzeiro,1,0,Avai,3,0,1,3,4,0,4
509,5126,Joinville,2,0,Ponte Preta,5,0,2,5,7,0,7
510,5127,Avai,3,0,Athletico-PR,3,0,3,3,6,0,6
511,5129,Atletico-MG,2,0,Figueirense,4,0,2,4,6,0,6
512,5130,Chapecoense,2,0,Fluminense,3,1,2,4,5,1,6
513,5131,Santos,2,0,Joinville,2,0,2,2,4,0,4
514,5132,Ponte Preta,2,0,Internacional,2,0,2,2,4,0,4
515,5133,Coritiba,3,0,Corinthians,3,0,3,3,6,0,6
516,5134,Sao Paulo,0,0,Cruzeiro,1,0,0,1,1,0,1
517,5135,Goias,2,0,Flamengo,1,0,2,1,3,0,3
518,5136,Vasco,3,0,Palmeiras,1,0,3,1,4,0,4
519,5137,Corinthians,0,0,Vasco,3,0,0,3,3,0,3
520,5138,Atletico-MG,0,0,Sao Paulo,1,0,0,1,1,0,1
521,5139,Fluminense,3,0,Gremio,2,1,3,3,5,1,6
522,5140,Coritiba,4,0,Goias,4,0,4,4,8,0,8
523,5141,Palmeiras,1,0,Athletico-PR,2,0,1,2,3,0,3
524,5142,Joinville,2,0,Avai,1,0,2,1,3,0,3
525,5143,Internacional,3,0,Chapecoense,2,0,3,2,5,0,5
526,5144,Figueirense,2,0,Ponte Preta,3,0,2,3,5,0,5
527,5145,Flamengo,4,0,Santos,2,0,4,2,6,0,6
528,5146,Sport,1,0,Cruzeiro,2,0,1,2,3,0,3
529,5147,Avai,2,0,Fluminense,2,0,2,2,4,0,4
530,5148,Santos,1,0,Coritiba,4,0,1,4,5,0,5
531,5150,Vasco,2,0,Joinville,4,0,2,4,6,0,6
532,5151,Sao Paulo,4,0,Corinthians,2,1,4,3,6,1,7
533,5152,Cruzeiro,4,0,Palmeiras,3,0,4,3,7,0,7
534,5153,Ponte Preta,2,0,Flamengo,4,0,2,4,6,0,6
535,5154,Goias,2,0,Atletico-MG,2,0,2,2,4,0,4
536,5155,Gremio,2,0,Internacional,4,0,2,4,6,0,6
537,5156,Chapecoense,1,0,Figueirense,1,0,1,1,2,0,2
538,5157,Coritiba,3,0,Palmeiras,1,0,3,1,4,0,4
539,5158,Flamengo,2,0,Athletico-PR,4,1,2,5,6,1,7
540,5159,Santos,3,0,Vasco,5,1,3,6,8,1,9
541,5160,Goias,1,0,Chapecoense,3,0,1,3,4,0,4
542,5161,Figueirense,3,0,Sao Paulo,4,1,3,5,7,1,8
543,5162,Internacional,6,0,Fluminense,4,2,6,6,10,2,12
544,5163,Corinthians,2,0,Sport,1,0,2,1,3,0,3
545,5164,Ponte Preta,1,0,Avai,1,0,1,1,2,0,2
546,5165,Joinville,1,0,Cruzeiro,2,0,1,2,3,0,3
547,5166,Atletico-MG,2,0,Gremio,3,0,2,3,5,0,5
548,5167,Vasco,3,0,Coritiba,1,0,3,1,4,0,4
549,5168,Athletico-PR,2,1,Santos,1,0,3,1,3,1,4
550,5169,Sao Paulo,1,0,Goias,0,0,1,0,1,0,1
551,5170,Palmeiras,2,0,Flamengo,2,0,2,2,4,0,4
552,5171,Avai,0,0,Corinthians,1,0,0,1,1,0,1
553,5172,Fluminense,1,0,Figueirense,2,1,1,3,3,1,4
554,5173,Cruzeiro,2,0,Internacional,2,0,2,2,4,0,4
555,5175,Gremio,1,0,Joinville,0,0,1,0,1,0,1
556,5176,Chapecoense,4,0,Atletico-MG,3,1,4,4,7,1,8
557,5177,Goias,3,0,Vasco,3,2,3,5,6,2,8
558,5178,Santos,1,0,Avai,3,0,1,3,4,0,4
559,5179,Figueirense,1,0,Sport,3,0,1,3,4,0,4
560,5180,Coritiba,3,0,Chapecoense,3,0,3,3,6,0,6
561,5181,Ponte Preta,1,0,Gremio,1,0,1,1,2,0,2
562,5182,Joinville,3,0,Fluminense,2,0,3,2,5,0,5
563,5183,Internacional,1,0,Athletico-PR,3,0,1,3,4,0,4
564,5184,Corinthians,2,0,Cruzeiro,1,0,2,1,3,0,3
565,5185,Flamengo,4,0,Sao Paulo,2,0,4,2,6,0,6
566,5186,Atletico-MG,1,0,Palmeiras,3,0,1,3,4,0,4
567,5187,Vasco,2,0,Figueirense,4,0,2,4,6,0,6
568,5188,Sao Paulo,4,0,Ponte Preta,0,0,4,0,4,0,4
569,5189,Gremio,5,0,Coritiba,5,0,5,5,10,0,10
570,5190,Avai,2,0,Internacional,2,0,2,2,4,0,4
571,5191,Palmeiras,0,0,Joinville,3,0,0,3,3,0,3
572,5192,Fluminense,3,0,Atletico-MG,4,0,3,4,7,0,7
573,5193,Sport,1,1,Flamengo,5,0,2,5,6,1,7
574,5194,Chapecoense,2,0,Corinthians,3,0,2,3,5,0,5
575,5195,Cruzeiro,3,1,Santos,2,0,4,2,5,1,6
576,5196,Athletico-PR,1,0,Goias,3,0,1,3,4,0,4
577,5197,Joinville,4,0,Sao Paulo,5,0,4,5,9,0,9
578,5198,Ponte Preta,2,1,Cruzeiro,5,0,3,5,7,1,8
579,5199,Internacional,3,0,Vasco,1,0,3,1,4,0,4
580,5200,Flamengo,1,0,Avai,4,0,1,4,5,0,5
581,5201,Atletico-MG,5,1,Athletico-PR,4,0,6,4,9,1,10
582,5202,Coritiba,2,0,Sport,2,0,2,2,4,0,4
583,5203,Corinthians,0,0,Fluminense,3,0,0,3,3,0,3
584,5204,Goias,3,0,Palmeiras,3,0,3,3,6,0,6
585,5205,Santos,0,0,Chapecoense,1,0,0,1,1,0,1
586,5206,Figueirense,4,0,Gremio,4,0,4,4,8,0,8
587,5208,Vasco,3,1,Atletico-MG,2,0,4,2,5,1,6
588,5209,Athletico-PR,4,1,Joinville,3,3,5,6,7,4,11
589,5210,Cruzeiro,0,0,Figueirense,4,0,0,4,4,0,4
590,5211,Chapecoense,1,0,Ponte Preta,2,0,1,2,3,0,3
591,5212,Gremio,3,0,Goias,4,1,3,5,7,1,8
592,5213,Palmeiras,6,0,Corinthians,3,0,6,3,9,0,9
593,5214,Avai,2,0,Coritiba,4,0,2,4,6,0,6
594,5215,Fluminense,6,0,Flamengo,6,1,6,7,12,1,13
595,5216,Sport,1,0,Santos,0,0,1,0,1,0,1
596,5217,Ponte Preta,3,1,Vasco,1,0,4,1,4,1,5
597,5218,Atletico-MG,3,0,Avai,3,0,3,3,6,0,6
598,5219,Internacional,5,1,Palmeiras,3,1,6,4,8,2,10
599,5220,Figueirense,2,0,Athletico-PR,2,0,2,2,4,0,4
600,5221,Coritiba,1,0,Fluminense,4,0,1,4,5,0,5
601,5222,Santos,1,0,Sao Paulo,1,0,1,1,2,0,2
602,5223,Corinthians,0,0,Gremio,3,0,0,3,3,0,3
603,5224,Goias,3,0,Sport,1,0,3,1,4,0,4
604,5225,Joinville,4,0,Chapecoense,2,0,4,2,6,0,6
605,5226,Flamengo,3,0,Cruzeiro,3,0,3,3,6,0,6
606,5227,Coritiba,4,0,Internacional,7,0,4,7,11,0,11
607,5228,Palmeiras,4,0,Figueirense,4,1,4,5,8,1,9
608,5229,Ponte Preta,5,0,Santos,2,0,5,2,7,0,7
609,5230,Corinthians,0,0,Joinville,1,0,0,1,1,0,1
610,5231,Cruzeiro,3,1,Atletico-MG,5,0,4,5,8,1,9
611,5232,Gremio,3,0,Sao Paulo,3,0,3,3,6,0,6
612,5233,Chapecoense,2,0,Flamengo,1,0,2,1,3,0,3
613,5234,Vasco,2,0,Athletico-PR,2,0,2,2,4,0,4
614,5235,Avai,2,0,Goias,2,0,2,2,4,0,4
615,5236,Sport,2,0,Fluminense,3,0,2,3,5,0,5
616,5237,Joinville,4,0,Sport,3,0,4,3,7,0,7
617,5238,Fluminense,1,0,Palmeiras,3,0,1,3,4,0,4
618,5239,Goias,2,0,Ponte Preta,5,0,2,5,7,0,7
619,5240,Figueirense,2,0,Avai,4,0,2,4,6,0,6
620,5241,Athletico-PR,1,0,Gremio,2,0,1,2,3,0,3
621,5242,Santos,1,0,Atletico-MG,1,0,1,1,2,0,2
622,5243,Internacional,2,0,Corinthians,1,0,2,1,3,0,3
623,5244,Cruzeiro,4,0,Vasco,3,1,4,4,7,1,8
624,5245,Sao Paulo,2,0,Chapecoense,2,0,2,2,4,0,4
625,5246,Flamengo,2,0,Coritiba,3,0,2,3,5,0,5
626,5247,Palmeiras,2,0,Gremio,4,0,2,4,6,0,6
627,5248,Internacional,1,0,Figueirense,5,0,1,5,6,0,6
628,5249,Ponte Preta,3,0,Fluminense,4,0,3,4,7,0,7
629,5250,Goias,0,0,Joinville,1,0,0,1,1,0,1
630,5251,Corinthians,2,0,Santos,5,2,2,7,7,2,9
631,5252,Vasco,2,0,Sport,2,0,2,2,4,0,4
632,5253,Atletico-MG,2,0,Flamengo,2,0,2,2,4,0,4
633,5254,Avai,3,0,Sao Paulo,4,0,3,4,7,0,7
634,5255,Chapecoense,2,0,Cruzeiro,1,1,2,2,3,1,4
635,5256,Coritiba,7,1,Athletico-PR,3,0,8,3,10,1,11
636,5257,Fluminense,4,0,Goias,3,0,4,3,7,0,7
637,5258,Gremio,1,0,Avai,3,0,1,3,4,0,4
638,5259,Athletico-PR,2,0,Ponte Preta,4,0,2,4,6,0,6
639,5260,Santos,1,0,Internacional,4,0,1,4,5,0,5
640,5261,Flamengo,5,0,Vasco,6,0,5,6,11,0,11
641,5262,Joinville,2,0,Atletico-MG,2,0,2,2,4,0,4
642,5263,Figueirense,3,0,Corinthians,3,0,3,3,6,0,6
643,5264,Sao Paulo,1,0,Palmeiras,2,0,1,2,3,0,3
644,5265,Sport,3,0,Chapecoense,0,0,3,0,3,0,3
645,5266,Cruzeiro,0,1,Coritiba,1,1,1,2,1,2,3
646,5267,Internacional,2,0,Sport,2,1,2,3,4,1,5
647,5268,Coritiba,1,0,Atletico-MG,2,0,1,2,3,0,3
648,5269,Sao Paulo,1,0,Athletico-PR,3,0,1,3,4,0,4
649,5270,Avai,4,1,Vasco,6,2,5,8,10,3,13
650,5271,Flamengo,2,0,Joinville,3,0,2,3,5,0,5
651,5272,Santos,3,0,Fluminense,2,0,3,2,5,0,5
652,5273,Cruzeiro,3,0,Gremio,3,0,3,3,6,0,6
653,5274,Goias,1,0,Figueirense,5,1,1,6,6,1,7
654,5275,Ponte Preta,2,1,Corinthians,4,0,3,4,6,1,7
655,5276,Chapecoense,0,0,Palmeiras,5,0,0,5,5,0,5
656,5277,Atletico-MG,2,0,Internacional,3,0,2,3,5,0,5
657,5278,Sport,2,0,Avai,5,0,2,5,7,0,7
658,5279,Joinville,6,0,Coritiba,1,0,6,1,7,0,7
659,5280,Figueirense,1,0,Flamengo,1,0,1,1,2,0,2
660,5281,Palmeiras,2,0,Ponte Preta,3,0,2,3,5,0,5
661,5282,Fluminense,0,0,Sao Paulo,4,0,0,4,4,0,4
662,5283,Athletico-PR,5,0,Cruzeiro,2,0,5,2,7,0,7
663,5284,Vasco,4,0,Chapecoense,5,0,4,5,9,0,9
664,5285,Corinthians,1,0,Goias,5,0,1,5,6,0,6
665,5286,Gremio,3,0,Santos,3,1,3,4,6,1,7
666,5287,Avai,3,0,Palmeiras,4,0,3,4,7,0,7
667,5288,Joinville,2,1,Figueirense,3,0,3,3,5,1,6
668,5289,Ponte Preta,3,0,Coritiba,3,0,3,3,6,0,6
669,5290,Cruzeiro,2,0,Fluminense,1,0,2,1,3,0,3
670,5291,Athletico-PR,2,0,Corinthians,1,0,2,1,3,0,3
671,5292,Flamengo,0,0,Internacional,2,0,0,2,2,0,2
672,5293,Sao Paulo,2,1,Vasco,1,0,3,1,3,1,4
673,5294,Gremio,3,0,Chapecoense,2,1,3,3,5,1,6
674,5295,Santos,0,0,Goias,1,0,0,1,1,0,1
675,5296,Sport,0,0,Atletico-MG,1,1,0,2,1,1,2
676,5297,Fluminense,1,0,Athletico-PR,3,0,1,3,4,0,4
677,5298,Internacional,1,0,Joinville,2,0,1,2,3,0,3
678,5299,Figueirense,5,0,Santos,2,0,5,2,7,0,7
679,5300,Palmeiras,2,0,Sport,1,0,2,1,3,0,3
680,5301,Corinthians,3,0,Flamengo,2,1,3,3,5,1,6
681,5302,Coritiba,4,1,Sao Paulo,3,0,5,3,7,1,8
682,5303,Chapecoense,1,0,Avai,2,0,1,2,3,0,3
683,5304,Vasco,1,0,Gremio,2,0,1,2,3,0,3
684,5305,Goias,4,0,Cruzeiro,4,0,4,4,8,0,8
685,5306,Atletico-MG,2,0,Ponte Preta,1,0,2,1,3,0,3
686,5307,Sao Paulo,1,0,Sport,2,0,1,2,3,0,3
687,5308,Avai,3,0,Cruzeiro,3,0,3,3,6,0,6
688,5309,Ponte Preta,3,0,Joinville,5,0,3,5,8,0,8
689,5310,Coritiba,2,0,Figueirense,5,0,2,5,7,0,7
690,5311,Chapecoense,3,0,Athletico-PR,4,1,3,5,7,1,8
691,5312,Santos,3,0,Palmeiras,3,1,3,4,6,1,7
692,5313,Gremio,0,0,Flamengo,1,1,0,2,1,1,2
693,5314,Atletico-MG,1,0,Corinthians,0,0,1,0,1,0,1
694,5315,Vasco,2,0,Fluminense,5,1,2,6,7,1,8
695,5316,Goias,3,0,Internacional,3,0,3,3,6,0,6
696,5317,Internacional,2,0,Ponte Preta,4,0,2,4,6,0,6
697,5318,Corinthians,0,0,Coritiba,3,0,0,3,3,0,3
698,5319,Athletico-PR,1,0,Avai,2,0,1,2,3,0,3
699,5320,Fluminense,3,0,Chapecoense,3,0,3,3,6,0,6
700,5321,Palmeiras,1,0,Vasco,4,0,1,4,5,0,5
701,5322,Flamengo,1,0,Goias,0,0,1,0,1,0,1
702,5323,Cruzeiro,1,0,Sao Paulo,2,0,1,2,3,0,3
703,5324,Figueirense,2,0,Atletico-MG,4,0,2,4,6,0,6
704,5325,Joinville,3,1,Santos,2,0,4,2,5,1,6
705,5326,Sport,2,0,Gremio,3,1,2,4,5,1,6
706,5327,Cruzeiro,2,0,Sport,4,0,2,4,6,0,6
707,5328,Goias,1,0,Coritiba,1,0,1,1,2,0,2
708,5329,Ponte Preta,4,0,Figueirense,4,0,4,4,8,0,8
709,5330,Avai,4,0,Joinville,1,0,4,1,5,0,5
710,5331,Athletico-PR,2,0,Palmeiras,4,2,2,6,6,2,8
711,5332,Gremio,3,0,Fluminense,4,1,3,5,7,1,8
712,5333,Chapecoense,4,0,Internacional,3,1,4,4,7,1,8
713,5335,Santos,2,0,Flamengo,2,1,2,3,4,1,5
714,5336,Vasco,2,1,Corinthians,3,0,3,3,5,1,6
715,5337,Palmeiras,2,0,Cruzeiro,1,0,2,1,3,0,3
716,5338,Joinville,5,1,Vasco,4,0,6,4,9,1,10
717,5339,Atletico-MG,3,0,Goias,3,0,3,3,6,0,6
718,5340,Internacional,4,0,Gremio,2,0,4,2,6,0,6
719,5341,Figueirense,1,0,Chapecoense,3,0,1,3,4,0,4
720,5342,Corinthians,2,0,Sao Paulo,2,0,2,2,4,0,4
721,5343,Flamengo,3,0,Ponte Preta,3,0,3,3,6,0,6
722,5344,Fluminense,2,0,Avai,3,0,2,3,5,0,5
723,5345,Coritiba,3,0,Santos,3,1,3,4,6,1,7
724,5346,Sport,3,0,Athletico-PR,2,0,3,2,5,0,5
725,5347,Sao Paulo,1,0,Figueirense,4,0,1,4,5,0,5
726,5348,Fluminense,3,1,Internacional,4,0,4,4,7,1,8
727,5349,Avai,1,0,Ponte Preta,2,1,1,3,3,1,4
728,5350,Sport,6,0,Corinthians,3,0,6,3,9,0,9
729,5351,Cruzeiro,2,0,Joinville,3,0,2,3,5,0,5
730,5352,Gremio,3,0,Atletico-MG,5,0,3,5,8,0,8
731,5353,Chapecoense,5,0,Goias,3,0,5,3,8,0,8
732,5354,Vasco,3,0,Santos,2,0,3,2,5,0,5
733,5355,Palmeiras,3,0,Coritiba,3,0,3,3,6,0,6
734,5356,Athletico-PR,1,0,Flamengo,3,0,1,3,4,0,4
735,5357,Internacional,2,0,Cruzeiro,1,0,2,1,3,0,3
736,5358,Flamengo,0,0,Palmeiras,1,0,0,1,1,0,1
737,5359,Figueirense,4,0,Fluminense,4,0,4,4,8,0,8
738,5360,Santos,0,0,Athletico-PR,1,0,0,1,1,0,1
739,5361,Ponte Preta,4,0,Sport,2,0,4,2,6,0,6
740,5362,Goias,4,0,Sao Paulo,1,0,4,1,5,0,5
741,5363,Corinthians,2,0,Avai,2,0,2,2,4,0,4
742,5365,Joinville,3,0,Gremio,1,0,3,1,4,0,4
743,5366,Coritiba,1,0,Vasco,0,1,1,1,1,1,2
744,5367,Palmeiras,1,0,Athletico-PR,4,1,1,5,5,1,6
745,5368,Flamengo,2,0,Sport,1,1,2,2,3,1,4
746,5369,Atletico-MG,2,0,Santos,2,0,2,2,4,0,4
747,5370,Coritiba,1,0,Cruzeiro,3,2,1,5,4,2,6
748,5371,Santa Cruz,3,0,Vitoria,0,0,3,0,3,0,3
749,5372,Botafogo-RJ,1,0,Sao Paulo,5,0,1,5,6,0,6
750,5373,Figueirense,2,0,Ponte Preta,5,0,2,5,7,0,7
751,5374,Corinthians,1,0,Gremio,4,0,1,4,5,0,5
752,5376,Internacional,3,0,Chapecoense,4,1,3,5,7,1,8
753,5377,Ponte Preta,3,0,Palmeiras,4,0,3,4,7,0,7
754,5378,Fluminense,3,0,Santa Cruz,5,0,3,5,8,0,8
755,5379,Cruzeiro,3,0,Figueirense,1,0,3,1,4,0,4
756,5380,Santos,5,0,Coritiba,2,0,5,2,7,0,7
757,5381,Athletico-PR,3,0,Atletico-MG,1,0,3,1,4,0,4
758,5382,Vitoria,5,1,Corinthians,4,0,6,4,9,1,10
759,5383,Chapecoense,0,0,America-MG,4,0,0,4,4,0,4
760,5384,Sao Paulo,4,0,Internacional,6,1,4,7,10,1,11
761,5385,Gremio,3,0,Flamengo,2,0,3,2,5,0,5
762,5386,Sport,3,0,Botafogo-RJ,2,0,3,2,5,0,5
763,5387,Figueirense,2,0,Santos,3,1,2,4,5,1,6
764,5388,Botafogo-RJ,2,0,Athletico-PR,2,0,2,2,4,0,4
765,5389,Flamengo,4,1,Chapecoense,1,0,5,1,5,1,6
766,5390,America-MG,4,0,Vitoria,2,1,4,3,6,1,7
767,5391,Santa Cruz,2,0,Cruzeiro,3,0,2,3,5,0,5
768,5392,Palmeiras,1,0,Fluminense,0,0,1,0,1,0,1
769,5393,Coritiba,2,0,Sao Paulo,2,0,2,2,4,0,4
770,5394,Corinthians,3,0,Ponte Preta,3,0,3,3,6,0,6
771,5395,Internacional,3,0,Sport,1,0,3,1,4,0,4
772,5396,Atletico-MG,1,0,Gremio,5,0,1,5,6,0,6
773,5397,Cruzeiro,1,0,America-MG,1,0,1,1,2,0,2
774,5398,Athletico-PR,2,0,Figueirense,1,0,2,1,3,0,3
775,5399,Chapecoense,1,0,Santa Cruz,4,0,1,4,5,0,5
776,5400,Ponte Preta,2,0,Flamengo,2,1,2,3,4,1,5
777,5401,Sport,2,0,Corinthians,1,0,2,1,3,0,3
778,5402,Fluminense,1,0,Botafogo-RJ,1,0,1,1,2,0,2
779,5403,Vitoria,4,0,Atletico-MG,6,0,4,6,10,0,10
780,5404,Sao Paulo,2,0,Palmeiras,5,0,2,5,7,0,7
781,5405,Gremio,0,0,Coritiba,3,0,0,3,3,0,3
782,5406,Santos,1,0,Internacional,1,0,1,1,2,0,2
783,5407,Internacional,5,0,Athletico-PR,2,0,5,2,7,0,7
784,5408,Corinthians,0,0,Santos,2,0,0,2,2,0,2
785,5409,Santa Cruz,6,1,Sport,2,0,7,2,8,1,9
786,5410,Coritiba,4,0,Chapecoense,5,0,4,5,9,0,9
787,5411,Atletico-MG,2,0,Fluminense,5,0,2,5,7,0,7
788,5412,Figueirense,2,0,Sao Paulo,1,0,2,1,3,0,3
789,5413,Botafogo-RJ,1,0,Cruzeiro,3,0,1,3,4,0,4
790,5414,America-MG,1,0,Ponte Preta,3,0,1,3,4,0,4
791,5415,Palmeiras,5,0,Gremio,4,0,5,4,9,0,9
792,5416,Flamengo,2,0,Vitoria,3,0,2,3,5,0,5
793,5417,Athletico-PR,0,0,Santa Cruz,2,0,0,2,2,0,2
794,5418,Chapecoense,3,0,Fluminense,0,0,3,0,3,0,3
795,5419,Corinthians,2,0,Coritiba,5,0,2,5,7,0,7
796,5420,America-MG,2,0,Figueirense,3,0,2,3,5,0,5
797,5421,Santos,1,0,Botafogo-RJ,1,0,1,1,2,0,2
798,5422,Vitoria,1,0,Internacional,6,0,1,6,7,0,7
799,5423,Sport,1,0,Atletico-MG,3,0,1,3,4,0,4
800,5424,Flamengo,1,1,Palmeiras,2,0,2,2,3,1,4
801,5425,Gremio,2,1,Ponte Preta,4,1,3,5,6,2,8
802,5426,Cruzeiro,2,0,Sao Paulo,0,0,2,0,2,0,2
803,5427,Internacional,2,0,America-MG,3,0,2,3,5,0,5
804,5428,Ponte Preta,3,0,Chapecoense,4,0,3,4,7,0,7
805,5429,Fluminense,4,0,Gremio,2,1,4,3,6,1,7
806,5430,Sao Paulo,1,0,Athletico-PR,2,0,1,2,3,0,3
807,5431,Coritiba,5,1,Sport,4,1,6,5,9,2,11
808,5432,Botafogo-RJ,3,0,Vitoria,1,0,3,1,4,0,4
809,5433,Atletico-MG,4,1,Cruzeiro,6,3,5,9,10,4,14
810,5434,Palmeiras,4,0,Corinthians,4,0,4,4,8,0,8
811,5435,Figueirense,2,0,Flamengo,2,0,2,2,4,0,4
812,5436,Santa Cruz,1,0,Santos,2,0,1,2,3,0,3
813,5437,Sao Paulo,5,0,Vitoria,2,0,5,2,7,0,7
814,5438,Chapecoense,2,0,Gremio,2,0,2,2,4,0,4
815,5439,Ponte Preta,0,0,Athletico-PR,2,0,0,2,2,0,2
816,5440,Santos,1,0,Sport,3,0,1,3,4,0,4
817,5441,Santa Cruz,3,0,Figueirense,3,1,3,4,6,1,7
818,5442,Botafogo-RJ,2,0,America-MG,2,0,2,2,4,0,4
819,5443,Coritiba,4,0,Palmeiras,3,0,4,3,7,0,7
820,5445,Internacional,2,0,Atletico-MG,1,0,2,1,3,0,3
821,5446,Fluminense,2,0,Corinthians,1,1,2,2,3,1,4
822,5447,Palmeiras,1,0,Santa Cruz,4,1,1,5,5,1,6
823,5448,Athletico-PR,2,0,Santos,1,0,2,1,3,0,3
824,5449,America-MG,0,0,Coritiba,3,0,0,3,3,0,3
825,5450,Vitoria,1,0,Chapecoense,4,0,1,4,5,0,5
826,5451,Atletico-MG,0,0,Ponte Preta,1,0,0,1,1,0,1
827,5452,Corinthians,2,0,Botafogo-RJ,2,0,2,2,4,0,4
828,5453,Flamengo,1,0,Sao Paulo,3,1,1,4,4,1,5
829,5454,Figueirense,3,0,Internacional,0,0,3,0,3,0,3
830,5455,Sport,2,0,Fluminense,0,0,2,0,2,0,2
831,5456,Gremio,0,0,Cruzeiro,2,0,0,2,2,0,2
832,5457,Palmeiras,0,0,America-MG,1,0,0,1,1,0,1
833,5458,Ponte Preta,4,0,Cruzeiro,4,0,4,4,8,0,8
834,5459,Botafogo-RJ,0,0,Figueirense,1,0,0,1,1,0,1
835,5460,Santa Cruz,1,0,Flamengo,0,0,1,0,1,0,1
836,5461,Fluminense,1,0,Santos,1,0,1,1,2,0,2
837,5462,Atletico-MG,3,0,Corinthians,1,0,3,1,4,0,4
838,5463,Chapecoense,2,0,Athletico-PR,2,0,2,2,4,0,4
839,5464,Gremio,4,1,Vitoria,4,0,5,4,8,1,9
840,5465,Sao Paulo,0,0,Sport,2,0,0,2,2,0,2
841,5466,Coritiba,2,1,Internacional,5,0,3,5,7,1,8
842,5467,Cruzeiro,4,0,Palmeiras,2,0,4,2,6,0,6
843,5468,Corinthians,3,0,Santa Cruz,1,0,3,1,4,0,4
844,5469,America-MG,3,0,Atletico-MG,3,0,3,3,6,0,6
845,5470,Flamengo,0,0,Fluminense,1,0,0,1,1,0,1
846,5471,Vitoria,3,0,Ponte Preta,2,0,3,2,5,0,5
847,5472,Athletico-PR,1,0,Gremio,0,1,1,1,1,1,2
848,5473,Internacional,4,1,Botafogo-RJ,3,0,5,3,7,1,8
849,5474,Santos,2,0,Sao Paulo,3,1,2,4,5,1,6
850,5475,Sport,3,0,Chapecoense,2,0,3,2,5,0,5
851,5476,Figueirense,3,0,Coritiba,4,0,3,4,7,0,7
852,5477,Flamengo,1,0,Internacional,1,0,1,1,2,0,2
853,5478,Vitoria,4,0,Sport,4,2,4,6,8,2,10
854,5479,Gremio,3,0,Santos,3,0,3,3,6,0,6
855,5480,Coritiba,3,0,Athletico-PR,2,0,3,2,5,0,5
856,5481,Chapecoense,4,0,Cruzeiro,6,0,4,6,10,0,10
857,5482,Sao Paulo,4,0,Fluminense,3,0,4,3,7,0,7
858,5483,America-MG,2,0,Corinthians,1,0,2,1,3,0,3
859,5484,Santa Cruz,2,0,Ponte Preta,1,0,2,1,3,0,3
860,5485,Palmeiras,1,0,Figueirense,1,0,1,1,2,0,2
861,5487,Fluminense,1,0,Coritiba,2,0,1,2,3,0,3
862,5488,Athletico-PR,2,0,America-MG,2,0,2,2,4,0,4
863,5489,Cruzeiro,3,0,Vitoria,3,1,3,4,6,1,7
864,5490,Internacional,4,0,Gremio,5,0,4,5,9,0,9
865,5491,Santos,1,0,Chapecoense,1,0,1,1,2,0,2
866,5492,Ponte Preta,3,0,Sao Paulo,2,1,3,3,5,1,6
867,5493,Corinthians,2,0,Flamengo,3,0,2,3,5,0,5
868,5494,Botafogo-RJ,1,0,Santa Cruz,3,0,1,3,4,0,4
869,5495,Figueirense,2,1,Atletico-MG,4,1,3,5,6,2,8
870,5496,Sport,4,0,Palmeiras,5,0,4,5,9,0,9
871,5497,Chapecoense,1,1,Corinthians,1,0,2,1,2,1,3
872,5498,Coritiba,1,0,Botafogo-RJ,3,0,1,3,4,0,4
873,5499,Ponte Preta,2,0,Sport,2,0,2,2,4,0,4
874,5500,Gremio,1,0,Figueirense,1,0,1,1,2,0,2
875,5501,Flamengo,1,0,Atletico-MG,4,0,1,4,5,0,5
876,5502,Santa Cruz,0,0,Internacional,2,0,0,2,2,0,2
877,5503,Sao Paulo,1,0,America-MG,4,0,1,4,5,0,5
878,5504,Vitoria,3,0,Fluminense,4,0,3,4,7,0,7
879,5505,Cruzeiro,1,0,Athletico-PR,4,0,1,4,5,0,5
880,5506,Palmeiras,3,0,Santos,2,0,3,2,5,0,5
881,5507,Botafogo-RJ,2,0,Flamengo,4,0,2,4,6,0,6
882,5508,Santos,3,0,Ponte Preta,2,0,3,2,5,0,5
883,5509,America-MG,2,0,Santa Cruz,2,0,2,2,4,0,4
884,5510,Internacional,4,0,Palmeiras,2,0,4,2,6,0,6
885,5511,Figueirense,1,0,Chapecoense,4,0,1,4,5,0,5
886,5512,Fluminense,0,0,Cruzeiro,6,0,0,6,6,0,6
887,5513,Athletico-PR,3,0,Vitoria,3,0,3,3,6,0,6
888,5514,Corinthians,3,0,Sao Paulo,3,0,3,3,6,0,6
889,5515,Sport,0,0,Gremio,3,0,0,3,3,0,3
890,5516,Atletico-MG,2,0,Coritiba,2,0,2,2,4,0,4
891,5517,Corinthians,2,0,Figueirense,6,0,2,6,8,0,8
892,5518,Santa Cruz,2,0,Coritiba,1,0,2,1,3,0,3
893,5519,Palmeiras,1,0,Atletico-MG,2,0,1,2,3,0,3
894,5520,Ponte Preta,3,0,Internacional,3,1,3,4,6,1,7
895,5521,Gremio,0,0,Sao Paulo,3,1,0,4,3,1,4
896,5522,Athletico-PR,3,0,Fluminense,5,0,3,5,8,0,8
897,5523,Cruzeiro,1,0,Sport,4,0,1,4,5,0,5
898,5524,Chapecoense,1,0,Botafogo-RJ,2,0,1,2,3,0,3
899,5525,Vitoria,3,0,Santos,2,0,3,2,5,0,5
900,5526,Flamengo,1,0,America-MG,0,0,1,0,1,0,1
901,5527,Figueirense,3,1,Vitoria,4,1,4,5,7,2,9
902,5528,Sport,2,0,Athletico-PR,1,0,2,1,3,0,3
903,5529,Atletico-MG,1,0,Santa Cruz,3,0,1,3,4,0,4
904,5530,Sao Paulo,4,0,Chapecoense,1,0,4,1,5,0,5
905,5531,Fluminense,4,0,Ponte Preta,6,0,4,6,10,0,10
906,5532,Coritiba,1,0,Flamengo,2,0,1,2,3,0,3
907,5533,Internacional,2,0,Corinthians,2,0,2,2,4,0,4
908,5534,Santos,1,0,Cruzeiro,1,0,1,1,2,0,2
909,5535,Botafogo-RJ,4,0,Palmeiras,3,0,4,3,7,0,7
910,5536,America-MG,2,0,Gremio,2,1,2,3,4,1,5
911,5537,Vitoria,2,0,Coritiba,1,0,2,1,3,0,3
912,5538,Sport,1,0,America-MG,3,0,1,3,4,0,4
913,5539,Santos,2,0,Flamengo,2,0,2,2,4,0,4
914,5540,Athletico-PR,3,0,Corinthians,0,0,3,0,3,0,3
915,5541,Ponte Preta,2,0,Botafogo-RJ,2,0,2,2,4,0,4
916,5542,Gremio,1,0,Santa Cruz,3,0,1,3,4,0,4
917,5543,Sao Paulo,2,0,Atletico-MG,2,0,2,2,4,0,4
918,5544,Cruzeiro,1,0,Internacional,1,0,1,1,2,0,2
919,5545,Chapecoense,1,0,Palmeiras,0,0,1,0,1,0,1
920,5546,Fluminense,3,0,Figueirense,3,0,3,3,6,0,6
921,5547,Flamengo,2,0,Athletico-PR,4,0,2,4,6,0,6
922,5548,America-MG,2,0,Santos,1,1,2,2,3,1,4
923,5549,Coritiba,4,0,Ponte Preta,3,0,4,3,7,0,7
924,5550,Palmeiras,2,0,Vitoria,4,0,2,4,6,0,6
925,5551,Santa Cruz,1,0,Sao Paulo,3,0,1,3,4,0,4
926,5552,Internacional,4,0,Fluminense,4,0,4,4,8,0,8
927,5553,Figueirense,5,0,Sport,3,0,5,3,8,0,8
928,5554,Atletico-MG,0,0,Chapecoense,1,0,0,1,1,0,1
929,5555,Corinthians,4,0,Cruzeiro,3,0,4,3,7,0,7
930,5556,Botafogo-RJ,3,0,Gremio,4,0,3,4,7,0,7
931,5557,Sport,2,0,Flamengo,3,0,2,3,5,0,5
932,5558,Ponte Preta,2,0,Figueirense,2,0,2,2,4,0,4
933,5559,Fluminense,2,0,America-MG,5,0,2,5,7,0,7
934,5560,Gremio,4,0,Corinthians,1,0,4,1,5,0,5
935,5561,Cruzeiro,2,0,Coritiba,4,0,2,4,6,0,6
936,5562,Santos,4,0,Atletico-MG,4,0,4,4,8,0,8
937,5563,Vitoria,1,0,Santa Cruz,2,0,1,2,3,0,3
938,5564,Sao Paulo,2,0,Botafogo-RJ,2,0,2,2,4,0,4
939,5565,Athletico-PR,3,0,Palmeiras,3,0,3,3,6,0,6
940,5566,Chapecoense,1,0,Internacional,2,0,1,2,3,0,3
941,5567,America-MG,1,0,Chapecoense,1,0,1,1,2,0,2
942,5568,Botafogo-RJ,1,0,Sport,2,0,1,2,3,0,3
943,5569,Flamengo,2,0,Gremio,1,0,2,1,3,0,3
944,5570,Atletico-MG,0,0,Athletico-PR,2,0,0,2,2,0,2
945,5571,Internacional,1,0,Sao Paulo,2,0,1,2,3,0,3
946,5572,Santa Cruz,0,0,Fluminense,2,0,0,2,2,0,2
947,5573,Palmeiras,3,0,Ponte Preta,6,0,3,6,9,0,9
948,5574,Coritiba,1,0,Santos,3,0,1,3,4,0,4
949,5575,Figueirense,4,1,Cruzeiro,5,0,5,5,9,1,10
950,5576,Corinthians,2,0,Vitoria,4,0,2,4,6,0,6
951,5577,Ponte Preta,2,0,Corinthians,1,1,2,2,3,1,4
952,5578,Cruzeiro,3,0,Santa Cruz,3,0,3,3,6,0,6
953,5579,Santos,3,0,Figueirense,2,0,3,2,5,0,5
954,5580,Gremio,4,0,Atletico-MG,4,0,4,4,8,0,8
955,5581,Fluminense,7,0,Palmeiras,5,0,7,5,12,0,12
956,5582,Chapecoense,4,0,Flamengo,0,0,4,0,4,0,4
957,5583,Sao Paulo,2,0,Coritiba,1,0,2,1,3,0,3
958,5584,Sport,4,0,Internacional,5,0,4,5,9,0,9
959,5585,Vitoria,3,0,America-MG,5,0,3,5,8,0,8
960,5586,Athletico-PR,3,0,Botafogo-RJ,2,0,3,2,5,0,5
961,5587,Santa Cruz,3,1,Chapecoense,3,0,4,3,6,1,7
962,5588,Figueirense,1,0,Athletico-PR,2,0,1,2,3,0,3
963,5589,Botafogo-RJ,5,0,Fluminense,2,0,5,2,7,0,7
964,5590,Atletico-MG,2,0,Vitoria,5,0,2,5,7,0,7
965,5591,Palmeiras,3,0,Sao Paulo,3,0,3,3,6,0,6
966,5592,Flamengo,1,0,Ponte Preta,3,0,1,3,4,0,4
967,5593,Coritiba,3,0,Gremio,0,0,3,0,3,0,3
968,5594,Corinthians,2,0,Sport,2,0,2,2,4,0,4
969,5595,America-MG,1,0,Cruzeiro,2,0,1,2,3,0,3
970,5596,Internacional,4,0,Santos,4,1,4,5,8,1,9
971,5597,Vitoria,2,1,Flamengo,1,0,3,1,3,1,4
972,5598,Chapecoense,2,0,Coritiba,3,0,2,3,5,0,5
973,5599,Sao Paulo,2,0,Figueirense,2,0,2,2,4,0,4
974,5600,Cruzeiro,4,0,Botafogo-RJ,2,0,4,2,6,0,6
975,5601,Sport,2,1,Santa Cruz,1,1,3,2,3,2,5
976,5602,Athletico-PR,0,0,Internacional,2,0,0,2,2,0,2
977,5603,Santos,2,0,Corinthians,1,0,2,1,3,0,3
978,5604,Ponte Preta,2,0,America-MG,1,0,2,1,3,0,3
979,5605,Gremio,4,0,Palmeiras,3,0,4,3,7,0,7
980,5606,Fluminense,1,0,Atletico-MG,4,0,1,4,5,0,5
981,5607,Botafogo-RJ,2,0,Santos,1,0,2,1,3,0,3
982,5608,Figueirense,0,0,America-MG,2,1,0,3,2,1,3
983,5609,Ponte Preta,2,0,Gremio,1,0,2,1,3,0,3
984,5610,Santa Cruz,3,0,Athletico-PR,4,0,3,4,7,0,7
985,5611,Coritiba,3,1,Corinthians,1,0,4,1,4,1,5
986,5612,Palmeiras,2,0,Flamengo,1,1,2,2,3,1,4
987,5613,Atletico-MG,0,0,Sport,1,1,0,2,1,1,2
988,5614,Fluminense,3,0,Chapecoense,4,0,3,4,7,0,7
989,5615,Sao Paulo,0,0,Cruzeiro,0,1,0,1,0,1,1
990,5616,Internacional,3,0,Vitoria,5,0,3,5,8,0,8
991,5617,Corinthians,2,1,Palmeiras,4,0,3,4,6,1,7
992,5618,Flamengo,2,0,Figueirense,3,1,2,4,5,1,6
993,5619,Cruzeiro,1,1,Atletico-MG,2,0,2,2,3,1,4
994,5620,Sport,0,0,Coritiba,1,0,0,1,1,0,1
995,5621,Gremio,4,0,Fluminense,3,0,4,3,7,0,7
996,5622,Chapecoense,2,0,Ponte Preta,0,0,2,0,2,0,2
997,5623,Athletico-PR,1,0,Sao Paulo,1,0,1,1,2,0,2
998,5624,Santos,1,0,Santa Cruz,1,0,1,1,2,0,2
999,5625,Vitoria,2,0,Botafogo-RJ,5,0,2,5,7,0,7
1000,5626,America-MG,1,0,Internacional,2,0,1,2,3,0,3
1001,5627,Palmeiras,2,0,Coritiba,3,0,2,3,5,0,5
1002,5628,Sport,3,0,Santos,2,1,3,3,5,1,6
1003,5629,America-MG,2,0,Botafogo-RJ,3,0,2,3,5,0,5
1004,5630,Athletico-PR,2,0,Ponte Preta,5,1,2,6,7,1,8
1005,5631,Figueirense,1,0,Santa Cruz,5,0,1,5,6,0,6
1006,5632,Vitoria,4,0,Sao Paulo,3,0,4,3,7,0,7
1007,5633,Corinthians,4,0,Fluminense,3,0,4,3,7,0,7
1008,5634,Flamengo,1,0,Cruzeiro,2,0,1,2,3,0,3
1009,5635,Gremio,2,0,Chapecoense,2,0,2,2,4,0,4
1010,5636,Atletico-MG,2,0,Internacional,2,0,2,2,4,0,4
1011,5637,Fluminense,1,0,Sport,3,0,1,3,4,0,4
1012,5638,Sao Paulo,4,0,Flamengo,3,0,4,3,7,0,7
1013,5639,Chapecoense,1,0,Vitoria,2,0,1,2,3,0,3
1014,5640,Santos,2,0,Athletico-PR,1,0,2,1,3,0,3
1015,5641,Botafogo-RJ,4,0,Corinthians,4,0,4,4,8,0,8
1016,5642,Ponte Preta,2,0,Atletico-MG,2,0,2,2,4,0,4
1017,5643,Cruzeiro,3,0,Gremio,3,0,3,3,6,0,6
1018,5644,Internacional,2,0,Figueirense,2,0,2,2,4,0,4
1019,5645,Santa Cruz,6,0,Palmeiras,3,0,6,3,9,0,9
1020,5646,Coritiba,2,0,America-MG,2,0,2,2,4,0,4
1021,5647,Athletico-PR,2,0,Chapecoense,3,0,2,3,5,0,5
1022,5648,Vitoria,3,0,Gremio,3,0,3,3,6,0,6
1023,5649,Corinthians,0,0,Atletico-MG,2,1,0,3,2,1,3
1024,5651,Sport,0,0,Sao Paulo,2,0,0,2,2,0,2
1025,5652,Internacional,2,0,Coritiba,4,0,2,4,6,0,6
1026,5653,Cruzeiro,2,0,Ponte Preta,2,0,2,2,4,0,4
1027,5654,Flamengo,1,0,Santa Cruz,1,1,1,2,2,1,3
1028,5655,America-MG,2,1,Palmeiras,1,0,3,1,3,1,4
1029,5656,Figueirense,2,0,Botafogo-RJ,2,0,2,2,4,0,4
1030,5657,Chapecoense,1,0,Sport,2,1,1,3,3,1,4
1031,5658,Coritiba,4,0,Figueirense,3,0,4,3,7,0,7
1032,5659,Santa Cruz,2,0,Corinthians,2,0,2,2,4,0,4
1033,5660,Botafogo-RJ,3,0,Internacional,2,0,3,2,5,0,5
1034,5661,Palmeiras,1,0,Cruzeiro,4,0,1,4,5,0,5
1035,5662,Ponte Preta,4,0,Vitoria,2,0,4,2,6,0,6
1036,5664,Fluminense,3,0,Flamengo,3,0,3,3,6,0,6
1037,5665,Sao Paulo,2,0,Santos,3,0,2,3,5,0,5
1038,5666,Gremio,2,0,Athletico-PR,3,0,2,3,5,0,5
1039,5667,Botafogo-RJ,2,0,Atletico-MG,4,0,2,4,6,0,6
1040,5668,Cruzeiro,1,0,Chapecoense,2,0,1,2,3,0,3
1041,5669,Athletico-PR,0,0,Coritiba,3,0,0,3,3,0,3
1042,5670,Internacional,3,0,Flamengo,1,0,3,1,4,0,4
1043,5671,Figueirense,4,0,Palmeiras,3,0,4,3,7,0,7
1044,5672,Corinthians,2,0,America-MG,1,0,2,1,3,0,3
1045,5673,Ponte Preta,0,0,Santa Cruz,2,0,0,2,2,0,2
1046,5674,Santos,1,0,Gremio,7,0,1,7,8,0,8
1047,5675,Sport,1,0,Vitoria,4,1,1,5,5,1,6
1048,5676,Fluminense,1,0,Sao Paulo,4,0,1,4,5,0,5
1049,5677,Santa Cruz,0,0,Botafogo-RJ,2,0,0,2,2,0,2
1050,5678,Sao Paulo,0,0,Ponte Preta,1,0,0,1,1,0,1
1051,5679,Flamengo,2,0,Corinthians,4,1,2,5,6,1,7
1052,5680,Vitoria,2,0,Cruzeiro,3,1,2,4,5,1,6
1053,5681,Palmeiras,3,0,Sport,2,0,3,2,5,0,5
1054,5682,Gremio,0,1,Internacional,2,1,1,3,2,2,4
1055,5683,Coritiba,0,1,Fluminense,4,0,1,4,4,1,5
1056,5684,Atletico-MG,2,0,Figueirense,4,2,2,6,6,2,8
1057,5685,Chapecoense,2,0,Santos,3,0,2,3,5,0,5
1058,5687,Sport,2,0,Ponte Preta,3,0,2,3,5,0,5
1059,5688,Fluminense,3,0,Vitoria,2,0,3,2,5,0,5
1060,5689,Atletico-MG,0,0,Flamengo,1,0,0,1,1,0,1
1061,5690,Athletico-PR,1,0,Cruzeiro,1,0,1,1,2,0,2
1062,5691,Corinthians,1,0,Chapecoense,2,0,1,2,3,0,3
1063,5692,Botafogo-RJ,5,0,Coritiba,3,0,5,3,8,0,8
1064,5693,Internacional,3,1,Santa Cruz,2,0,4,2,5,1,6
1065,5694,Figueirense,2,0,Gremio,2,0,2,2,4,0,4
1066,5695,Santos,4,0,Palmeiras,3,0,4,3,7,0,7
1067,5696,America-MG,0,0,Sao Paulo,1,0,0,1,1,0,1
1068,5697,Flamengo,3,0,Botafogo-RJ,3,0,3,3,6,0,6
1069,5698,Sao Paulo,3,0,Corinthians,4,0,3,4,7,0,7
1070,5699,Ponte Preta,1,0,Santos,1,0,1,1,2,0,2
1071,5700,Santa Cruz,1,0,America-MG,1,0,1,1,2,0,2
1072,5701,Cruzeiro,2,0,Fluminense,1,0,2,1,3,0,3
1073,5703,Vitoria,2,0,Athletico-PR,2,0,2,2,4,0,4
1074,5704,Coritiba,1,0,Atletico-MG,3,0,1,3,4,0,4
1075,5705,Chapecoense,1,0,Figueirense,3,1,1,4,4,1,5
1076,5706,Gremio,4,0,Sport,3,0,4,3,7,0,7
1077,5707,Fluminense,3,0,Athletico-PR,3,0,3,3,6,0,6
1078,5708,Botafogo-RJ,3,0,Chapecoense,1,0,3,1,4,0,4
1079,5709,Coritiba,3,0,Santa Cruz,2,0,3,2,5,0,5
1080,5710,Sport,2,0,Cruzeiro,2,0,2,2,4,0,4
1081,5711,America-MG,1,0,Flamengo,0,0,1,0,1,0,1
1082,5712,Figueirense,3,0,Corinthians,2,1,3,3,5,1,6
1083,5713,Santos,3,0,Vitoria,1,0,3,1,4,0,4
1084,5714,Sao Paulo,3,0,Gremio,2,0,3,2,5,0,5
1085,5715,Internacional,1,0,Ponte Preta,3,0,1,3,4,0,4
1086,5716,Atletico-MG,2,0,Palmeiras,4,0,2,4,6,0,6
1087,5717,Vitoria,4,0,Figueirense,2,0,4,2,6,0,6
1088,5718,Cruzeiro,3,1,Santos,3,0,4,3,6,1,7
1089,5719,Palmeiras,0,0,Botafogo-RJ,4,1,0,5,4,1,5
1090,5720,Athletico-PR,0,0,Sport,2,0,0,2,2,0,2
1091,5721,Gremio,0,0,America-MG,2,0,0,2,2,0,2
1092,5722,Ponte Preta,3,0,Fluminense,3,1,3,4,6,1,7
1093,5723,Flamengo,1,0,Coritiba,2,0,1,2,3,0,3
1094,5724,Chapecoense,1,0,Sao Paulo,1,0,1,1,2,0,2
1095,5725,Santa Cruz,3,1,Atletico-MG,0,1,4,1,3,2,5
1096,5726,Corinthians,2,0,Internacional,2,0,2,2,4,0,4
1097,5727,America-MG,1,1,Sport,3,0,2,3,4,1,5
1098,5728,Botafogo-RJ,5,0,Ponte Preta,4,1,5,5,9,1,10
1099,5729,Corinthians,3,0,Athletico-PR,2,0,3,2,5,0,5
1100,5730,Atletico-MG,1,0,Sao Paulo,6,0,1,6,7,0,7
1101,5731,Palmeiras,1,0,Chapecoense,2,0,1,2,3,0,3
1102,5732,Flamengo,1,0,Santos,0,0,1,0,1,0,1
1103,5733,Internacional,3,0,Cruzeiro,4,0,3,4,7,0,7
1104,5734,Figueirense,3,0,Fluminense,3,0,3,3,6,0,6
1105,5735,Santa Cruz,3,0,Gremio,4,0,3,4,7,0,7
1106,5736,Coritiba,5,0,Vitoria,6,0,5,6,11,0,11
1107,5737,Santos,0,0,America-MG,1,0,0,1,1,0,1
1108,5738,Fluminense,1,0,Internacional,1,0,1,1,2,0,2
1109,5739,Gremio,2,0,Botafogo-RJ,4,1,2,5,6,1,7
1110,5740,Sao Paulo,2,1,Santa Cruz,1,0,3,1,3,1,4
1111,5741,Cruzeiro,2,0,Corinthians,4,0,2,4,6,0,6
1112,5742,Sport,5,0,Figueirense,2,0,5,2,7,0,7
1113,5743,Athletico-PR,2,0,Flamengo,6,1,2,7,8,1,9
1114,5744,Vitoria,1,0,Palmeiras,6,0,1,6,7,0,7
1115,5745,Ponte Preta,0,0,Coritiba,1,0,0,1,1,0,1
1116,5746,Flamengo,2,0,Atletico-MG,3,0,2,3,5,0,5
1117,5747,Corinthians,2,0,Chapecoense,2,0,2,2,4,0,4
1118,5748,Fluminense,1,0,Santos,5,0,1,5,6,0,6
1119,5749,Cruzeiro,0,0,Sao Paulo,1,0,0,1,1,0,1
1120,5750,Bahia,0,0,Athletico-PR,1,1,0,2,1,1,2
1121,5751,Ponte Preta,0,0,Sport,2,0,0,2,2,0,2
1122,5752,Avai,0,0,Vitoria,2,0,0,2,2,0,2
1123,5753,Palmeiras,0,0,Vasco,2,0,0,2,2,0,2
1124,5754,Gremio,2,0,Botafogo-RJ,5,0,2,5,7,0,7
1125,5755,Coritiba,1,0,Atletico-GO,2,0,1,2,3,0,3
1126,5756,Santos,6,0,Coritiba,4,0,6,4,10,0,10
1127,5757,Atletico-GO,2,0,Flamengo,1,0,2,1,3,0,3
1128,5758,Chapecoense,1,0,Palmeiras,1,0,1,1,2,0,2
1129,5759,Vasco,4,0,Bahia,2,1,4,3,6,1,7
1130,5760,Athletico-PR,2,0,Gremio,4,1,2,5,6,1,7
1131,5761,Vitoria,0,0,Corinthians,1,0,0,1,1,0,1
1132,5762,Atletico-MG,0,0,Fluminense,6,0,0,6,6,0,6
1133,5763,Botafogo-RJ,1,0,Ponte Preta,0,0,1,0,1,0,1
1134,5764,Sport,3,0,Cruzeiro,3,0,3,3,6,0,6
1135,5765,Sao Paulo,1,0,Avai,2,0,1,2,3,0,3
1136,5766,Vasco,2,0,Fluminense,3,0,2,3,5,0,5
1137,5767,Sao Paulo,3,0,Palmeiras,1,0,3,1,4,0,4
1138,5768,Vitoria,3,0,Coritiba,3,0,3,3,6,0,6
1139,5769,Atletico-MG,2,0,Ponte Preta,2,0,2,2,4,0,4
1140,5770,Athletico-PR,1,0,Flamengo,0,0,1,0,1,0,1
1141,5771,Santos,2,0,Cruzeiro,3,0,2,3,5,0,5
1142,5772,Atletico-GO,2,0,Corinthians,0,0,2,0,2,0,2
1143,5773,Sport,4,1,Gremio,1,0,5,1,5,1,6
1144,5774,Botafogo-RJ,1,0,Bahia,1,0,1,1,2,0,2
1145,5775,Chapecoense,2,1,Avai,1,1,3,2,3,2,5
1146,5776,Coritiba,3,0,Athletico-PR,2,0,3,2,5,0,5
1147,5777,Fluminense,0,0,Vitoria,5,0,0,5,5,0,5
1148,5778,Corinthians,0,0,Santos,1,1,0,2,1,1,2
1149,5779,Flamengo,2,0,Botafogo-RJ,2,0,2,2,4,0,4
1150,5780,Avai,4,0,Sport,4,0,4,4,8,0,8
1151,5781,Palmeiras,2,0,Atletico-MG,4,0,2,4,6,0,6
1152,5782,Ponte Preta,2,0,Sao Paulo,5,0,2,5,7,0,7
1153,5783,Gremio,2,0,Vasco,3,0,2,3,5,0,5
1154,5784,Cruzeiro,1,0,Chapecoense,3,0,1,3,4,0,4
1155,5785,Bahia,0,0,Atletico-GO,2,0,0,2,2,0,2
1156,5786,Fluminense,3,0,Athletico-PR,3,0,3,3,6,0,6
1157,5787,Atletico-MG,3,0,Avai,1,0,3,1,4,0,4
1158,5788,Coritiba,4,0,Palmeiras,3,0,4,3,7,0,7
1159,5789,Santos,4,0,Botafogo-RJ,2,0,4,2,6,0,6
1160,5790,Vasco,0,0,Corinthians,3,0,0,3,3,0,3
1161,5791,Sport,2,0,Flamengo,2,0,2,2,4,0,4
1162,5792,Atletico-GO,1,0,Ponte Preta,2,1,1,3,3,1,4
1163,5793,Sao Paulo,1,0,Vitoria,1,0,1,1,2,0,2
1164,5794,Chapecoense,4,0,Gremio,3,0,4,3,7,0,7
1165,5795,Bahia,4,0,Cruzeiro,2,1,4,3,6,1,7
1166,5796,Palmeiras,4,0,Fluminense,2,0,4,2,6,0,6
1167,5797,Vasco,0,0,Sport,1,0,0,1,1,0,1
1168,5798,Botafogo-RJ,4,0,Coritiba,3,0,4,3,7,0,7
1169,5799,Ponte Preta,2,0,Chapecoense,4,0,2,4,6,0,6
1170,5800,Avai,2,1,Flamengo,1,0,3,1,3,1,4
1171,5801,Vitoria,3,0,Atletico-MG,2,0,3,2,5,0,5
1172,5802,Corinthians,1,0,Sao Paulo,1,0,1,1,2,0,2
1173,5803,Cruzeiro,3,0,Atletico-GO,4,0,3,4,7,0,7
1174,5804,Athletico-PR,1,0,Santos,1,1,1,2,2,1,3
1175,5805,Gremio,0,0,Bahia,1,0,0,1,1,0,1
1176,5806,Atletico-MG,2,0,Athletico-PR,5,1,2,6,7,1,8
1177,5807,Atletico-GO,3,0,Avai,6,0,3,6,9,0,9
1178,5808,Vitoria,1,1,Botafogo-RJ,1,0,2,1,2,1,3
1179,5809,Sport,1,0,Sao Paulo,1,0,1,1,2,0,2
1180,5810,Flamengo,2,0,Ponte Preta,2,0,2,2,4,0,4
1181,5811,Santos,1,0,Palmeiras,3,0,1,3,4,0,4
1182,5812,Chapecoense,3,0,Vasco,2,0,3,2,5,0,5
1183,5813,Corinthians,0,0,Cruzeiro,1,0,0,1,1,0,1
1184,5814,Coritiba,1,1,Bahia,4,1,2,5,5,2,7
1185,5815,Fluminense,4,0,Gremio,3,0,4,3,7,0,7
1186,5816,Atletico-GO,1,0,Athletico-PR,5,0,1,5,6,0,6
1187,5817,Vasco,4,0,Avai,1,0,4,1,5,0,5
1188,5818,Santos,3,0,Ponte Preta,4,0,3,4,7,0,7
1189,5819,Coritiba,2,0,Corinthians,3,0,2,3,5,0,5
1190,5820,Bahia,2,0,Palmeiras,5,0,2,5,7,0,7
1191,5821,Fluminense,1,0,Flamengo,6,0,1,6,7,0,7
1192,5822,Chapecoense,0,0,Botafogo-RJ,2,0,0,2,2,0,2
1193,5823,Sao Paulo,2,0,Atletico-MG,2,0,2,2,4,0,4
1194,5825,Cruzeiro,5,0,Gremio,2,0,5,2,7,0,7
1195,5826,Vitoria,2,0,Santos,1,0,2,1,3,0,3
1196,5827,Palmeiras,2,0,Atletico-GO,2,0,2,2,4,0,4
1197,5828,Botafogo-RJ,5,0,Vasco,1,0,5,1,6,0,6
1198,5829,Avai,1,0,Fluminense,1,0,1,1,2,0,2
1199,5830,Athletico-PR,3,0,Sao Paulo,3,0,3,3,6,0,6
1200,5831,Atletico-MG,2,0,Sport,1,0,2,1,3,0,3
1201,5832,Corinthians,3,1,Bahia,3,1,4,4,6,2,8
1202,5833,Ponte Preta,2,0,Cruzeiro,2,0,2,2,4,0,4
1203,5834,Gremio,2,0,Coritiba,0,0,2,0,2,0,2
1204,5835,Flamengo,3,0,Chapecoense,1,0,3,1,4,0,4
1205,5836,Santos,0,0,Sport,1,0,0,1,1,0,1
1206,5837,Vasco,2,0,Atletico-GO,0,0,2,0,2,0,2
1207,5838,Gremio,4,0,Corinthians,5,0,4,5,9,0,9
1208,5839,Sao Paulo,1,0,Fluminense,1,0,1,1,2,0,2
1209,5840,Athletico-PR,0,0,Vitoria,3,0,0,3,3,0,3
1210,5841,Cruzeiro,0,0,Coritiba,2,0,0,2,2,0,2
1211,5842,Ponte Preta,6,2,Palmeiras,3,1,8,4,9,3,12
1212,5843,Bahia,2,1,Flamengo,3,0,3,3,5,1,6
1213,5844,Chapecoense,5,0,Atletico-MG,5,0,5,5,10,0,10
1214,5845,Botafogo-RJ,1,0,Avai,2,0,1,2,3,0,3
1215,5846,Palmeiras,3,0,Gremio,1,0,3,1,4,0,4
1216,5847,Atletico-GO,3,1,Santos,1,0,4,1,4,1,5
1217,5848,Sport,1,0,Athletico-PR,3,0,1,3,4,0,4
1218,5849,Vitoria,5,0,Bahia,3,0,5,3,8,0,8
1219,5850,Atletico-MG,4,0,Cruzeiro,4,0,4,4,8,0,8
1220,5851,Flamengo,1,0,Sao Paulo,1,0,1,1,2,0,2
1221,5852,Corinthians,3,0,Botafogo-RJ,2,0,3,2,5,0,5
1222,5853,Avai,2,0,Ponte Preta,2,0,2,2,4,0,4
1223,5854,Coritiba,3,0,Vasco,5,0,3,5,8,0,8
1224,5855,Fluminense,3,0,Chapecoense,5,1,3,6,8,1,9
1225,5856,Atletico-GO,1,0,Vitoria,4,0,1,4,5,0,5
1226,5857,Vasco,4,0,Flamengo,1,0,4,1,5,0,5
1227,5858,Corinthians,2,0,Ponte Preta,2,0,2,2,4,0,4
1228,5859,Chapecoense,1,0,Athletico-PR,3,0,1,3,4,0,4
1229,5860,Bahia,4,0,Fluminense,2,0,4,2,6,0,6
1230,5861,Gremio,1,0,Avai,5,1,1,6,6,1,7
1231,5862,Cruzeiro,1,0,Palmeiras,4,0,1,4,5,0,5
1232,5863,Santos,4,0,Sao Paulo,3,0,4,3,7,0,7
1233,5864,Botafogo-RJ,1,0,Atletico-MG,3,0,1,3,4,0,4
1234,5865,Coritiba,2,1,Sport,2,0,3,2,4,1,5
1235,5866,Ponte Preta,1,0,Bahia,3,0,1,3,4,0,4
1236,5867,Atletico-MG,1,0,Santos,2,0,1,2,3,0,3
1237,5868,Fluminense,3,0,Botafogo-RJ,4,0,3,4,7,0,7
1238,5869,Palmeiras,3,0,Corinthians,4,0,3,4,7,0,7
1239,5870,Athletico-PR,3,0,Cruzeiro,1,0,3,1,4,0,4
1240,5871,Vitoria,4,0,Vasco,3,0,4,3,7,0,7
1241,5872,Sao Paulo,0,0,Atletico-GO,3,0,0,3,3,0,3
1242,5873,Sport,2,0,Chapecoense,8,0,2,8,10,0,10
1243,5874,Flamengo,2,0,Gremio,2,0,2,2,4,0,4
1244,5875,Avai,2,0,Coritiba,2,0,2,2,4,0,4
1245,5877,Palmeiras,2,0,Vitoria,3,0,2,3,5,0,5
1246,5878,Vasco,4,0,Santos,3,1,4,4,7,1,8
1247,5879,Atletico-GO,2,0,Atletico-MG,3,0,2,3,5,0,5
1248,5880,Chapecoense,4,0,Sao Paulo,2,0,4,2,6,0,6
1249,5881,Cruzeiro,3,0,Flamengo,1,0,3,1,4,0,4
1250,5882,Gremio,1,0,Ponte Preta,2,0,1,2,3,0,3
1251,5883,Bahia,2,0,Avai,0,0,2,0,2,0,2
1252,5884,Coritiba,4,0,Fluminense,4,0,4,4,8,0,8
1253,5885,Botafogo-RJ,4,0,Sport,3,0,4,3,7,0,7
1254,5886,Vitoria,3,0,Gremio,3,0,3,3,6,0,6
1255,5887,Santos,5,0,Chapecoense,2,0,5,2,7,0,7
1256,5888,Avai,2,0,Corinthians,3,0,2,3,5,0,5
1257,5889,Ponte Preta,1,0,Coritiba,0,0,1,0,1,0,1
1258,5890,Atletico-MG,4,0,Bahia,6,0,4,6,10,0,10
1259,5891,Sao Paulo,3,0,Vasco,3,0,3,3,6,0,6
1260,5892,Flamengo,2,0,Palmeiras,9,0,2,9,11,0,11
1261,5893,Fluminense,3,0,Cruzeiro,3,0,3,3,6,0,6
1262,5894,Sport,2,0,Atletico-GO,1,0,2,1,3,0,3
1263,5895,Athletico-PR,3,0,Botafogo-RJ,5,1,3,6,8,1,9
1264,5896,Vitoria,2,0,Chapecoense,5,0,2,5,7,0,7
1265,5897,Flamengo,1,0,Coritiba,6,0,1,6,7,0,7
1266,5898,Santos,1,0,Bahia,1,0,1,1,2,0,2
1267,5899,Avai,2,0,Cruzeiro,0,0,2,0,2,0,2
1268,5900,Sport,3,0,Palmeiras,4,0,3,4,7,0,7
1269,5901,Fluminense,2,0,Corinthians,2,0,2,2,4,0,4
1270,5902,Athletico-PR,2,0,Ponte Preta,2,0,2,2,4,0,4
1271,5903,Atletico-GO,1,0,Botafogo-RJ,4,0,1,4,5,0,5
1272,5904,Atletico-MG,5,0,Vasco,3,0,5,3,8,0,8
1273,5905,Sao Paulo,1,0,Gremio,3,0,1,3,4,0,4
1274,5906,Botafogo-RJ,0,0,Sao Paulo,1,0,0,1,1,0,1
1275,5907,Palmeiras,1,0,Avai,2,1,1,3,3,1,4
1276,5908,Chapecoense,1,0,Atletico-GO,1,0,1,1,2,0,2
1277,5909,Coritiba,4,0,Atletico-MG,4,0,4,4,8,0,8
1278,5910,Bahia,2,0,Sport,6,0,2,6,8,0,8
1279,5911,Corinthians,0,0,Flamengo,1,0,0,1,1,0,1
1280,5912,Gremio,4,1,Santos,5,0,5,5,9,1,10
1281,5913,Cruzeiro,4,0,Vitoria,4,0,4,4,8,0,8
1282,5914,Vasco,3,0,Athletico-PR,3,0,3,3,6,0,6
1283,5915,Ponte Preta,1,0,Fluminense,1,0,1,1,2,0,2
1284,5916,Sport,5,0,Fluminense,4,1,5,5,9,1,10
1285,5917,Chapecoense,5,0,Bahia,3,0,5,3,8,0,8
1286,5918,Atletico-MG,3,0,Corinthians,1,0,3,1,4,0,4
1287,5919,Vitoria,3,0,Ponte Preta,1,0,3,1,4,0,4
1288,5920,Santos,3,1,Flamengo,3,1,4,4,6,2,8
1289,5921,Atletico-GO,4,0,Gremio,2,0,4,2,6,0,6
1290,5922,Botafogo-RJ,5,0,Palmeiras,2,0,5,2,7,0,7
1291,5923,Athletico-PR,1,0,Avai,2,0,1,2,3,0,3
1292,5924,Sao Paulo,4,0,Coritiba,5,0,4,5,9,0,9
1293,5925,Vasco,4,0,Cruzeiro,1,0,4,1,5,0,5
1294,5926,Corinthians,1,0,Sport,2,0,1,2,3,0,3
1295,5927,Fluminense,1,0,Atletico-GO,3,0,1,3,4,0,4
1296,5928,Flamengo,4,0,Vitoria,2,0,4,2,6,0,6
1297,5929,Cruzeiro,3,0,Botafogo-RJ,3,0,3,3,6,0,6
1298,5930,Gremio,3,0,Atletico-MG,1,0,3,1,4,0,4
1299,5932,Palmeiras,1,0,Athletico-PR,3,0,1,3,4,0,4
1300,5933,Bahia,4,0,Sao Paulo,2,0,4,2,6,0,6
1301,5934,Avai,3,0,Santos,1,0,3,1,4,0,4
1302,5935,Ponte Preta,1,0,Vasco,4,0,1,4,5,0,5
1303,5936,Atletico-GO,2,0,Coritiba,3,0,2,3,5,0,5
1304,5937,Vitoria,1,0,Avai,3,0,1,3,4,0,4
1305,5938,Sao Paulo,5,1,Cruzeiro,4,2,6,6,9,3,12
1306,5939,Sport,1,0,Ponte Preta,1,0,1,1,2,0,2
1307,5940,Atletico-MG,4,0,Flamengo,2,1,4,3,6,1,7
1308,5941,Vasco,1,0,Palmeiras,2,0,1,2,3,0,3
1309,5942,Athletico-PR,2,0,Bahia,4,0,2,4,6,0,6
1310,5943,Botafogo-RJ,3,0,Gremio,1,0,3,1,4,0,4
1311,5944,Santos,2,0,Fluminense,2,0,2,2,4,0,4
1312,5945,Chapecoense,1,0,Corinthians,4,0,1,4,5,0,5
1313,5946,Corinthians,1,0,Vitoria,2,0,1,2,3,0,3
1314,5947,Flamengo,2,0,Atletico-GO,3,0,2,3,5,0,5
1315,5948,Gremio,2,0,Athletico-PR,2,0,2,2,4,0,4
1316,5949,Avai,1,0,Sao Paulo,3,0,1,3,4,0,4
1317,5950,Bahia,0,0,Vasco,4,0,0,4,4,0,4
1318,5951,Cruzeiro,1,0,Sport,0,0,1,0,1,0,1
1319,5952,Ponte Preta,4,0,Botafogo-RJ,4,0,4,4,8,0,8
1320,5953,Coritiba,3,0,Santos,1,0,3,1,4,0,4
1321,5954,Palmeiras,1,0,Chapecoense,4,0,1,4,5,0,5
1322,5955,Fluminense,1,0,Atletico-MG,2,0,1,2,3,0,3
1323,5956,Fluminense,2,0,Vasco,4,0,2,4,6,0,6
1324,5957,Corinthians,1,0,Atletico-GO,5,0,1,5,6,0,6
1325,5958,Ponte Preta,4,0,Atletico-MG,4,0,4,4,8,0,8
1326,5959,Palmeiras,1,0,Sao Paulo,2,0,1,2,3,0,3
1327,5960,Bahia,2,0,Botafogo-RJ,0,0,2,0,2,0,2
1328,5961,Flamengo,0,0,Athletico-PR,2,0,0,2,2,0,2
1329,5962,Cruzeiro,0,0,Santos,2,0,0,2,2,0,2
1330,5963,Avai,4,0,Chapecoense,5,0,4,5,9,0,9
1331,5964,Coritiba,2,2,Vitoria,2,1,4,3,4,3,7
1332,5965,Gremio,1,0,Sport,5,0,1,5,6,0,6
1333,5966,Atletico-MG,3,0,Palmeiras,3,2,3,5,6,2,8
1334,5967,Vasco,3,0,Gremio,0,0,3,0,3,0,3
1335,5968,Sao Paulo,2,1,Ponte Preta,1,0,3,1,3,1,4
1336,5969,Athletico-PR,1,0,Coritiba,3,1,1,4,4,1,5
1337,5970,Santos,3,0,Corinthians,5,0,3,5,8,0,8
1338,5971,Sport,4,0,Avai,5,0,4,5,9,0,9
1339,5972,Vitoria,1,0,Fluminense,3,1,1,4,4,1,5
1340,5973,Chapecoense,2,0,Cruzeiro,1,0,2,1,3,0,3
1341,5975,Atletico-GO,1,0,Bahia,2,0,1,2,3,0,3
1342,5976,Botafogo-RJ,2,0,Santos,2,0,2,2,4,0,4
1343,5977,Ponte Preta,2,0,Atletico-GO,2,0,2,2,4,0,4
1344,5978,Avai,2,0,Atletico-MG,3,1,2,4,5,1,6
1345,5979,Gremio,1,0,Chapecoense,5,0,1,5,6,0,6
1346,5980,Corinthians,1,0,Vasco,2,0,1,2,3,0,3
1347,5981,Athletico-PR,3,0,Fluminense,3,0,3,3,6,0,6
1348,5982,Vitoria,3,0,Sao Paulo,2,0,3,2,5,0,5
1349,5983,Flamengo,0,0,Sport,3,1,0,4,3,1,4
1350,5984,Cruzeiro,5,1,Bahia,1,0,6,1,6,1,7
1351,5985,Palmeiras,3,0,Coritiba,3,0,3,3,6,0,6
1352,5986,Flamengo,2,0,Avai,0,0,2,0,2,0,2
1353,5987,Santos,1,0,Athletico-PR,1,0,1,1,2,0,2
1354,5988,Sao Paulo,2,0,Corinthians,4,0,2,4,6,0,6
1355,5989,Chapecoense,4,0,Ponte Preta,3,0,4,3,7,0,7
1356,5990,Coritiba,2,0,Botafogo-RJ,3,0,2,3,5,0,5
1357,5991,Atletico-GO,4,0,Cruzeiro,2,0,4,2,6,0,6
1358,5992,Fluminense,2,0,Palmeiras,2,0,2,2,4,0,4
1359,5993,Atletico-MG,1,0,Vitoria,2,0,1,2,3,0,3
1360,5994,Bahia,4,0,Gremio,5,0,4,5,9,0,9
1361,5995,Sport,1,1,Vasco,4,0,2,4,5,1,6
1362,5996,Vasco,3,0,Chapecoense,0,0,3,0,3,0,3
1363,5997,Bahia,4,0,Coritiba,5,0,4,5,9,0,9
1364,5998,Palmeiras,3,0,Santos,5,0,3,5,8,0,8
1365,5999,Cruzeiro,3,0,Corinthians,4,0,3,4,7,0,7
1366,6000,Botafogo-RJ,2,1,Vitoria,2,0,3,2,4,1,5
1367,6001,Sao Paulo,0,0,Sport,2,0,0,2,2,0,2
1368,6002,Gremio,1,0,Fluminense,2,0,1,2,3,0,3
1369,6003,Avai,2,0,Atletico-GO,2,0,2,2,4,0,4
1370,6004,Athletico-PR,1,0,Atletico-MG,4,0,1,4,5,0,5
1371,6005,Ponte Preta,5,1,Flamengo,3,0,6,3,8,1,9
1372,6006,Cruzeiro,5,0,Ponte Preta,1,1,5,2,6,1,7
1373,6007,Vasco,5,0,Botafogo-RJ,3,0,5,3,8,0,8
1374,6008,Sao Paulo,1,0,Athletico-PR,2,1,1,3,3,1,4
1375,6009,Chapecoense,2,0,Flamengo,2,0,2,2,4,0,4
1376,6010,Atletico-GO,2,1,Palmeiras,1,0,3,1,3,1,4
1377,6011,Fluminense,2,0,Avai,2,0,2,2,4,0,4
1378,6012,Sport,2,0,Atletico-MG,2,0,2,2,4,0,4
1379,6013,Coritiba,4,0,Gremio,3,0,4,3,7,0,7
1380,6014,Bahia,0,0,Corinthians,2,0,0,2,2,0,2
1381,6015,Santos,2,0,Vitoria,4,0,2,4,6,0,6
1382,6016,Athletico-PR,3,0,Atletico-GO,2,0,3,2,5,0,5
1383,6017,Botafogo-RJ,1,0,Chapecoense,3,0,1,3,4,0,4
1384,6018,Corinthians,1,0,Coritiba,3,0,1,3,4,0,4
1385,6020,Avai,5,1,Vasco,3,1,6,4,8,2,10
1386,6021,Atletico-MG,1,0,Sao Paulo,3,0,1,3,4,0,4
1387,6022,Vitoria,2,1,Sport,3,0,3,3,5,1,6
1388,6023,Flamengo,2,0,Fluminense,4,0,2,4,6,0,6
1389,6024,Ponte Preta,3,1,Santos,2,0,4,2,5,1,6
1390,6025,Palmeiras,1,0,Bahia,2,0,1,2,3,0,3
1391,6026,Atletico-GO,2,1,Vasco,2,0,3,2,4,1,5
1392,6027,Coritiba,1,0,Cruzeiro,1,0,1,1,2,0,2
1393,6028,Atletico-MG,2,1,Chapecoense,3,0,3,3,5,1,6
1394,6029,Avai,2,0,Botafogo-RJ,4,0,2,4,6,0,6
1395,6030,Fluminense,2,0,Sao Paulo,0,0,2,0,2,0,2
1396,6031,Corinthians,1,0,Gremio,1,0,1,1,2,0,2
1397,6032,Vitoria,0,0,Athletico-PR,3,0,0,3,3,0,3
1398,6033,Palmeiras,0,0,Ponte Preta,4,0,0,4,4,0,4
1399,6034,Flamengo,5,0,Bahia,4,0,5,4,9,0,9
1400,6035,Sport,1,0,Santos,5,0,1,5,6,0,6
1401,6036,Vasco,1,1,Coritiba,2,0,2,2,3,1,4
1402,6037,Santos,1,0,Atletico-GO,1,0,1,1,2,0,2
1403,6038,Bahia,2,0,Vitoria,3,0,2,3,5,0,5
1404,6039,Gremio,2,0,Palmeiras,1,0,2,1,3,0,3
1405,6040,Sao Paulo,1,0,Flamengo,1,0,1,1,2,0,2
1406,6041,Athletico-PR,0,0,Sport,2,0,0,2,2,0,2
1407,6042,Cruzeiro,2,0,Atletico-MG,4,0,2,4,6,0,6
1408,6043,Chapecoense,1,0,Fluminense,1,0,1,1,2,0,2
1409,6044,Ponte Preta,5,0,Avai,2,0,5,2,7,0,7
1410,6045,Botafogo-RJ,3,0,Corinthians,2,0,3,2,5,0,5
1411,6046,Sao Paulo,1,0,Santos,6,0,1,6,7,0,7
1412,6047,Flamengo,1,0,Vasco,1,0,1,1,2,0,2
1413,6048,Athletico-PR,1,0,Chapecoense,4,0,1,4,5,0,5
1414,6049,Ponte Preta,4,0,Corinthians,1,0,4,1,5,0,5
1415,6050,Fluminense,1,0,Bahia,3,1,1,4,4,1,5
1416,6051,Atletico-MG,1,0,Botafogo-RJ,2,0,1,2,3,0,3
1417,6052,Vitoria,1,0,Atletico-GO,3,0,1,3,4,0,4
1418,6053,Sport,3,0,Coritiba,6,0,3,6,9,0,9
1419,6054,Avai,1,0,Gremio,2,0,1,2,3,0,3
1420,6055,Palmeiras,0,0,Cruzeiro,2,0,0,2,2,0,2
1421,6056,Santos,1,0,Atletico-MG,3,0,1,3,4,0,4
1422,6057,Botafogo-RJ,3,0,Fluminense,4,0,3,4,7,0,7
1423,6058,Atletico-GO,2,0,Sao Paulo,0,0,2,0,2,0,2
1424,6059,Coritiba,1,0,Avai,2,0,1,2,3,0,3
1425,6060,Corinthians,6,0,Palmeiras,5,1,6,6,11,1,12
1426,6061,Cruzeiro,1,0,Athletico-PR,2,0,1,2,3,0,3
1427,6063,Bahia,1,0,Ponte Preta,2,0,1,2,3,0,3
1428,6064,Vasco,3,0,Vitoria,4,0,3,4,7,0,7
1429,6065,Chapecoense,3,0,Sport,3,1,3,4,6,1,7
1430,6066,Ponte Preta,4,1,Gremio,3,0,5,3,7,1,8
1431,6067,Avai,2,0,Bahia,2,0,2,2,4,0,4
1432,6068,Sport,2,0,Botafogo-RJ,4,0,2,4,6,0,6
1433,6069,Athletico-PR,2,0,Corinthians,1,0,2,1,3,0,3
1434,6070,Santos,2,0,Vasco,5,0,2,5,7,0,7
1435,6071,Flamengo,2,0,Cruzeiro,3,0,2,3,5,0,5
1436,6072,Vitoria,4,1,Palmeiras,1,0,5,1,5,1,6
1437,6073,Sao Paulo,1,0,Chapecoense,2,0,1,2,3,0,3
1438,6074,Atletico-MG,6,0,Atletico-GO,5,0,6,5,11,0,11
1439,6075,Fluminense,3,0,Coritiba,4,0,3,4,7,0,7
1440,6076,Botafogo-RJ,0,0,Athletico-PR,1,0,0,1,1,0,1
1441,6077,Corinthians,3,0,Avai,3,0,3,3,6,0,6
1442,6078,Vasco,2,0,Sao Paulo,2,1,2,3,4,1,5
1443,6079,Palmeiras,0,0,Flamengo,1,0,0,1,1,0,1
1444,6080,Atletico-GO,0,0,Sport,3,0,0,3,3,0,3
1445,6081,Gremio,0,0,Vitoria,2,1,0,3,2,1,3
1446,6082,Bahia,1,0,Atletico-MG,4,0,1,4,5,0,5
1447,6083,Cruzeiro,4,0,Fluminense,3,1,4,4,7,1,8
1448,6084,Coritiba,2,0,Ponte Preta,2,0,2,2,4,0,4
1449,6085,Chapecoense,0,0,Santos,3,0,0,3,3,0,3
1450,6086,Ponte Preta,1,0,Athletico-PR,3,0,1,3,4,0,4
1451,6087,Cruzeiro,4,0,Avai,2,0,4,2,6,0,6
1452,6088,Gremio,1,0,Sao Paulo,3,0,1,3,4,0,4
1453,6089,Vasco,1,0,Atletico-MG,0,0,1,0,1,0,1
1454,6090,Corinthians,1,0,Fluminense,6,0,1,6,7,0,7
1455,6091,Botafogo-RJ,1,0,Atletico-GO,3,0,1,3,4,0,4
1456,6092,Chapecoense,1,0,Vitoria,4,0,1,4,5,0,5
1457,6093,Palmeiras,0,0,Sport,2,0,0,2,2,0,2
1458,6094,Coritiba,3,0,Flamengo,5,0,3,5,8,0,8
1459,6095,Bahia,3,0,Santos,2,0,3,2,5,0,5
1460,6096,Sport,4,0,Bahia,3,0,4,3,7,0,7
1461,6097,Flamengo,4,0,Corinthians,4,0,4,4,8,0,8
1462,6098,Vitoria,3,0,Cruzeiro,2,0,3,2,5,0,5
1463,6099,Atletico-GO,4,0,Chapecoense,4,0,4,4,8,0,8
1464,6100,Sao Paulo,2,0,Botafogo-RJ,3,0,2,3,5,0,5
1465,6101,Athletico-PR,1,0,Vasco,2,0,1,2,3,0,3
1466,6102,Atletico-MG,2,0,Coritiba,5,0,2,5,7,0,7
1467,6103,Santos,2,0,Gremio,2,0,2,2,4,0,4
1468,6104,Fluminense,2,0,Ponte Preta,2,1,2,3,4,1,5
1469,6105,Avai,2,0,Palmeiras,2,0,2,2,4,0,4
1470,6106,Fluminense,4,0,Sport,2,0,4,2,6,0,6
1471,6107,Avai,3,0,Athletico-PR,1,0,3,1,4,0,4
1472,6108,Corinthians,4,0,Atletico-MG,1,0,4,1,5,0,5
1473,6109,Ponte Preta,3,1,Vitoria,6,0,4,6,9,1,10
1474,6110,Coritiba,4,0,Sao Paulo,1,0,4,1,5,0,5
1475,6111,Cruzeiro,3,0,Vasco,2,0,3,2,5,0,5
1476,6112,Gremio,2,0,Atletico-GO,3,0,2,3,5,0,5
1477,6113,Flamengo,3,0,Santos,4,0,3,4,7,0,7
1478,6114,Bahia,5,1,Chapecoense,3,0,6,3,8,1,9
1479,6115,Palmeiras,3,0,Botafogo-RJ,4,0,3,4,7,0,7
1480,6116,Atletico-MG,7,1,Gremio,1,0,8,1,8,1,9
1481,6117,Botafogo-RJ,1,0,Cruzeiro,5,1,1,6,6,1,7
1482,6118,Santos,2,0,Avai,1,0,2,1,3,0,3
1483,6119,Sport,3,0,Corinthians,2,0,3,2,5,0,5
1484,6120,Vitoria,3,2,Flamengo,3,0,5,3,6,2,8
1485,6121,Atletico-GO,1,0,Fluminense,4,0,1,4,5,0,5
1486,6122,Sao Paulo,4,1,Bahia,4,1,5,5,8,2,10
1487,6123,Chapecoense,3,0,Coritiba,2,0,3,2,5,0,5
1488,6124,Vasco,5,0,Ponte Preta,5,0,5,5,10,0,10
1489,6125,Athletico-PR,3,0,Palmeiras,5,0,3,5,8,0,8
1490,6126,Cruzeiro,3,0,Gremio,1,1,3,2,4,1,5
1491,6127,Vitoria,3,0,Flamengo,2,1,3,3,5,1,6
1492,6128,Santos,0,0,Ceara,1,0,0,1,1,0,1
1493,6129,America-MG,1,0,Sport,3,0,1,3,4,0,4
1494,6130,Vasco,4,0,Atletico-MG,3,0,4,3,7,0,7
1495,6131,Internacional,2,0,Bahia,0,0,2,0,2,0,2
1496,6133,Athletico-PR,1,0,Chapecoense,3,0,1,3,4,0,4
1497,6134,Sao Paulo,4,0,Parana,2,0,4,2,6,0,6
1498,6135,Botafogo-RJ,1,0,Palmeiras,4,0,1,4,5,0,5
1499,6136,Bahia,4,0,Santos,3,0,4,3,7,0,7
1500,6137,Flamengo,1,0,America-MG,1,0,1,1,2,0,2
1501,6138,Parana,1,0,Corinthians,1,0,1,1,2,0,2
1502,6139,Ceara,1,0,Sao Paulo,1,0,1,1,2,0,2
1503,6140,Atletico-MG,2,0,Vitoria,4,0,2,4,6,0,6
1504,6141,Fluminense,3,1,Cruzeiro,2,0,4,2,5,1,6
1505,6142,Chapecoense,1,0,Vasco,2,0,1,2,3,0,3
1506,6143,Palmeiras,2,0,Internacional,2,0,2,2,4,0,4
1507,6144,Gremio,3,0,Athletico-PR,3,1,3,4,6,1,7
1508,6145,Sport,1,0,Botafogo-RJ,3,0,1,3,4,0,4
1509,6146,Botafogo-RJ,1,0,Gremio,1,0,1,1,2,0,2
1510,6147,Bahia,2,0,Athletico-PR,2,0,2,2,4,0,4
1511,6148,Ceara,1,0,Flamengo,2,0,1,2,3,0,3
1512,6149,Palmeiras,4,0,Chapecoense,6,0,4,6,10,0,10
1513,6150,Parana,1,0,Sport,1,0,1,1,2,0,2
1514,6151,Atletico-MG,4,0,Corinthians,3,0,4,3,7,0,7
1515,6152,Fluminense,3,0,Sao Paulo,2,0,3,2,5,0,5
1516,6153,Internacional,4,0,Cruzeiro,3,0,4,3,7,0,7
1517,6154,America-MG,2,1,Vitoria,2,0,3,2,4,1,5
1518,6155,Santos,1,0,Vasco,3,1,1,4,4,1,5
1519,6156,Vasco,4,0,America-MG,4,0,4,4,8,0,8
1520,6157,Sao Paulo,4,0,Atletico-MG,4,0,4,4,8,0,8
1521,6158,Corinthians,2,0,Ceara,4,0,2,4,6,0,6
1522,6159,Flamengo,5,0,Internacional,4,1,5,5,9,1,10
1523,6160,Cruzeiro,1,0,Botafogo-RJ,4,0,1,4,5,0,5
1524,6161,Athletico-PR,1,0,Palmeiras,2,0,1,2,3,0,3
1525,6162,Vitoria,2,0,Fluminense,1,0,2,1,3,0,3
1526,6163,Gremio,1,0,Santos,3,0,1,3,4,0,4
1527,6164,Sport,1,0,Bahia,2,1,1,3,3,1,4
1528,6165,Chapecoense,1,0,Parana,2,1,1,3,3,1,4
1529,6166,Gremio,3,0,Internacional,4,0,3,4,7,0,7
1530,6167,Cruzeiro,2,0,Sport,3,0,2,3,5,0,5
1531,6168,Athletico-PR,2,0,Atletico-MG,2,0,2,2,4,0,4
1532,6169,Vasco,2,0,Vitoria,3,0,2,3,5,0,5
1533,6170,Corinthians,2,0,Palmeiras,3,0,2,3,5,0,5
1534,6171,Bahia,5,0,Sao Paulo,3,0,5,3,8,0,8
1535,6172,Chapecoense,2,0,Flamengo,3,0,2,3,5,0,5
1536,6173,Santos,1,0,Parana,2,0,1,2,3,0,3
1537,6174,Botafogo-RJ,2,0,Fluminense,2,0,2,2,4,0,4
1538,6175,Ceara,1,0,America-MG,3,0,1,3,4,0,4
1539,6176,Atletico-MG,3,0,Cruzeiro,2,1,3,3,5,1,6
1540,6177,Flamengo,2,2,Vasco,3,2,4,5,5,4,9
1541,6178,Palmeiras,3,0,Bahia,2,0,3,2,5,0,5
1542,6179,Vitoria,4,0,Ceara,0,0,4,0,4,0,4
1543,6180,Sao Paulo,4,1,Santos,2,0,5,2,6,1,7
1544,6181,America-MG,2,0,Botafogo-RJ,4,0,2,4,6,0,6
1545,6182,Parana,2,0,Gremio,1,0,2,1,3,0,3
1546,6183,Sport,2,0,Corinthians,3,0,2,3,5,0,5
1547,6184,Fluminense,1,0,Athletico-PR,2,0,1,2,3,0,3
1548,6185,Internacional,1,0,Chapecoense,2,0,1,2,3,0,3
1549,6186,Fluminense,1,0,Chapecoense,1,0,1,1,2,0,2
1550,6187,Palmeiras,3,0,Sport,3,1,3,4,6,1,7
1551,6188,Atletico-MG,1,0,Flamengo,4,0,1,4,5,0,5
1552,6189,Parana,3,0,Athletico-PR,1,0,3,1,4,0,4
1553,6190,Internacional,3,0,Corinthians,1,0,3,1,4,0,4
1554,6191,Bahia,1,0,Vasco,6,1,1,7,7,1,8
1555,6192,Santos,1,0,Cruzeiro,4,0,1,4,5,0,5
1556,6193,Botafogo-RJ,1,0,Vitoria,4,0,1,4,5,0,5
1557,6194,Ceara,4,0,Gremio,2,0,4,2,6,0,6
1558,6195,America-MG,4,0,Sao Paulo,3,0,4,3,7,0,7
1559,6196,Vasco,3,1,Parana,3,1,4,4,6,2,8
1560,6197,Vitoria,3,0,Internacional,2,0,3,2,5,0,5
1561,6198,Sport,4,0,Atletico-MG,2,0,4,2,6,0,6
1562,6199,Chapecoense,2,0,Ceara,3,0,2,3,5,0,5
1563,6200,Sao Paulo,2,0,Botafogo-RJ,3,0,2,3,5,0,5
1564,6201,Gremio,1,0,Fluminense,5,0,1,5,6,0,6
1565,6202,Cruzeiro,3,0,Palmeiras,6,0,3,6,9,0,9
1566,6203,Flamengo,0,0,Bahia,2,0,0,2,2,0,2
1567,6204,Corinthians,2,0,America-MG,3,2,2,5,5,2,7
1568,6205,Athletico-PR,1,0,Santos,1,0,1,1,2,0,2
1569,6206,Internacional,3,0,Sport,3,0,3,3,6,0,6
1570,6207,Atletico-MG,2,0,Chapecoense,4,1,2,5,6,1,7
1571,6208,Vasco,2,0,Botafogo-RJ,4,0,2,4,6,0,6
1572,6209,Palmeiras,4,0,Sao Paulo,4,0,4,4,8,0,8
1573,6210,Flamengo,3,0,Corinthians,1,0,3,1,4,0,4
1574,6211,Bahia,2,0,Gremio,5,0,2,5,7,0,7
1575,6212,America-MG,1,0,Athletico-PR,2,0,1,2,3,0,3
1576,6213,Santos,0,0,Vitoria,4,0,0,4,4,0,4
1577,6214,Ceara,2,0,Cruzeiro,4,0,2,4,6,0,6
1578,6215,Parana,6,0,Fluminense,3,0,6,3,9,0,9
1579,6216,Sao Paulo,4,0,Internacional,2,0,4,2,6,0,6
1580,6217,Vitoria,3,0,Chapecoense,2,0,3,2,5,0,5
1581,6218,Botafogo-RJ,0,0,Ceara,3,0,0,3,3,0,3
1582,6219,Corinthians,3,0,Santos,2,0,3,2,5,0,5
1583,6220,Sport,2,0,Athletico-PR,4,0,2,4,6,0,6
1584,6221,Gremio,2,0,Palmeiras,5,0,2,5,7,0,7
1585,6222,Cruzeiro,1,0,Vasco,1,0,1,1,2,0,2
1586,6223,Parana,4,0,Bahia,2,0,4,2,6,0,6
1587,6224,Fluminense,5,0,Flamengo,2,0,5,2,7,0,7
1588,6225,America-MG,2,0,Atletico-MG,2,0,2,2,4,0,4
1589,6226,Athletico-PR,3,0,Sao Paulo,3,0,3,3,6,0,6
1590,6227,Chapecoense,2,0,Cruzeiro,3,0,2,3,5,0,5
1591,6228,Vasco,4,0,Sport,3,0,4,3,7,0,7
1592,6229,Corinthians,2,0,Vitoria,2,0,2,2,4,0,4
1593,6230,Atletico-MG,2,0,Fluminense,2,0,2,2,4,0,4
1594,6231,Bahia,4,0,Botafogo-RJ,3,1,4,4,7,1,8
1595,6232,Gremio,2,0,America-MG,3,0,2,3,5,0,5
1596,6233,Ceara,3,0,Palmeiras,2,0,3,2,5,0,5
1597,6234,Flamengo,2,0,Parana,0,0,2,0,2,0,2
1598,6235,Santos,3,1,Internacional,4,0,4,4,7,1,8
1599,6236,Sao Paulo,4,1,Vitoria,3,1,5,4,7,2,9
1600,6237,America-MG,5,0,Chapecoense,0,0,5,0,5,0,5
1601,6238,Fluminense,2,0,Santos,3,0,2,3,5,0,5
1602,6239,Sport,3,0,Gremio,2,0,3,2,5,0,5
1603,6240,Parana,8,0,Cruzeiro,2,0,8,2,10,0,10
1604,6241,Palmeiras,4,3,Flamengo,6,3,7,9,10,6,16
1605,6242,Botafogo-RJ,0,0,Athletico-PR,2,0,0,2,2,0,2
1606,6243,Bahia,2,0,Corinthians,1,0,2,1,3,0,3
1607,6244,Internacional,2,0,Vasco,0,0,2,0,2,0,2
1608,6245,Atletico-MG,1,0,Ceara,0,0,1,0,1,0,1
1609,6247,Vitoria,2,0,Parana,2,0,2,2,4,0,4
1610,6248,Corinthians,2,0,Botafogo-RJ,3,0,2,3,5,0,5
1611,6249,Gremio,1,0,Atletico-MG,2,0,1,2,3,0,3
1612,6250,Flamengo,3,0,Sao Paulo,4,1,3,5,7,1,8
1613,6251,Chapecoense,1,0,Bahia,2,0,1,2,3,0,3
1614,6252,Cruzeiro,3,0,America-MG,1,0,3,1,4,0,4
1615,6253,Vasco,4,0,Fluminense,2,0,4,2,6,0,6
1616,6254,Santos,4,0,Palmeiras,6,0,4,6,10,0,10
1617,6255,Athletico-PR,4,1,Internacional,5,0,5,5,9,1,10
1618,6256,Flamengo,0,0,Botafogo-RJ,1,1,0,2,1,1,2
1619,6257,Sao Paulo,2,0,Corinthians,7,0,2,7,9,0,9
1620,6258,Vasco,5,1,Gremio,6,0,6,6,11,1,12
1621,6259,Palmeiras,2,0,Atletico-MG,2,1,2,3,4,1,5
1622,6260,Parana,3,0,America-MG,3,0,3,3,6,0,6
1623,6261,Bahia,3,0,Vitoria,5,1,3,6,8,1,9
1624,6262,Sport,1,0,Fluminense,5,0,1,5,6,0,6
1625,6263,Cruzeiro,1,0,Athletico-PR,3,1,1,4,4,1,5
1626,6264,Chapecoense,1,0,Santos,4,0,1,4,5,0,5
1627,6265,Internacional,2,0,Ceara,3,0,2,3,5,0,5
1628,6266,Fluminense,2,0,Palmeiras,2,1,2,3,4,1,5
1629,6267,Atletico-MG,1,1,Parana,1,0,2,1,2,1,3
1630,6268,Corinthians,0,0,Cruzeiro,2,0,0,2,2,0,2
1631,6269,Santos,1,0,Flamengo,1,0,1,1,2,0,2
1632,6270,Botafogo-RJ,2,0,Chapecoense,3,0,2,3,5,0,5
1633,6271,Vitoria,2,0,Sport,2,0,2,2,4,0,4
1634,6272,Gremio,4,0,Sao Paulo,5,0,4,5,9,0,9
1635,6273,America-MG,2,1,Internacional,2,1,3,3,4,2,6
1636,6274,Ceara,3,0,Bahia,4,0,3,4,7,0,7
1637,6275,Athletico-PR,1,0,Vasco,2,0,1,2,3,0,3
1638,6276,Ceara,5,0,Fluminense,1,0,5,1,6,0,6
1639,6277,Palmeiras,2,0,Parana,2,0,2,2,4,0,4
1640,6278,Vasco,4,0,Corinthians,0,0,4,0,4,0,4
1641,6279,Flamengo,1,0,Sport,1,0,1,1,2,0,2
1642,6280,Athletico-PR,3,0,Vitoria,5,0,3,5,8,0,8
1643,6281,Internacional,1,0,Botafogo-RJ,2,0,1,2,3,0,3
1644,6282,Cruzeiro,2,0,Sao Paulo,1,0,2,1,3,0,3
1645,6283,Santos,2,0,America-MG,2,0,2,2,4,0,4
1646,6284,Chapecoense,1,0,Gremio,3,0,1,3,4,0,4
1647,6285,Bahia,4,0,Atletico-MG,2,0,4,2,6,0,6
1648,6286,Botafogo-RJ,1,0,Santos,5,0,1,5,6,0,6
1649,6287,Gremio,3,0,Flamengo,4,0,3,4,7,0,7
1650,6288,Corinthians,2,0,Athletico-PR,2,0,2,2,4,0,4
1651,6289,Vitoria,3,0,Cruzeiro,5,0,3,5,8,0,8
1652,6290,Parana,4,0,Ceara,2,0,4,2,6,0,6
1653,6291,America-MG,1,0,Palmeiras,2,0,1,2,3,0,3
1654,6292,Sao Paulo,2,0,Vasco,2,0,2,2,4,0,4
1655,6293,Fluminense,4,0,Bahia,2,0,4,2,6,0,6
1656,6294,Sport,1,0,Chapecoense,1,0,1,1,2,0,2
1657,6295,Atletico-MG,1,0,Internacional,1,0,1,1,2,0,2
1658,6296,Ceara,3,0,Santos,2,0,3,2,5,0,5
1659,6297,Bahia,1,0,Internacional,2,0,1,2,3,0,3
1660,6298,Parana,3,0,Sao Paulo,1,0,3,1,4,0,4
1661,6299,Palmeiras,2,0,Botafogo-RJ,5,1,2,6,7,1,8
1662,6300,Sport,2,0,America-MG,2,0,2,2,4,0,4
1663,6301,Fluminense,1,0,Corinthians,2,1,1,3,3,1,4
1664,6302,Gremio,2,0,Cruzeiro,4,0,2,4,6,0,6
1665,6303,Flamengo,2,0,Vitoria,2,0,2,2,4,0,4
1666,6304,Atletico-MG,2,0,Vasco,4,0,2,4,6,0,6
1667,6305,Chapecoense,1,0,Athletico-PR,3,0,1,3,4,0,4
1668,6306,Ceara,3,0,Athletico-PR,3,0,3,3,6,0,6
1669,6307,Bahia,1,0,America-MG,4,0,1,4,5,0,5
1670,6308,Parana,3,1,Botafogo-RJ,4,1,4,5,7,2,9
1671,6309,Atletico-MG,2,0,Santos,0,0,2,0,2,0,2
1672,6310,Sport,1,0,Sao Paulo,3,0,1,3,4,0,4
1673,6311,Flamengo,3,0,Cruzeiro,3,0,3,3,6,0,6
1674,6312,Chapecoense,1,1,Corinthians,2,0,2,2,3,1,4
1675,6313,Gremio,1,0,Vitoria,3,0,1,3,4,0,4
1676,6314,Palmeiras,1,0,Vasco,2,0,1,2,3,0,3
1677,6315,Fluminense,3,0,Internacional,3,0,3,3,6,0,6
1678,6316,Santos,3,0,Sport,3,1,3,4,6,1,7
1679,6317,Corinthians,1,0,Gremio,1,0,1,1,2,0,2
1680,6318,Athletico-PR,3,0,Flamengo,1,0,3,1,4,0,4
1681,6319,Internacional,3,0,Parana,5,0,3,5,8,0,8
1682,6320,Vitoria,2,0,Palmeiras,1,0,2,1,3,0,3
1683,6321,Botafogo-RJ,2,0,Atletico-MG,4,0,2,4,6,0,6
1684,6322,Cruzeiro,2,0,Bahia,2,0,2,2,4,0,4
1685,6323,America-MG,2,1,Fluminense,0,0,3,0,2,1,3
1686,6324,Sao Paulo,2,0,Chapecoense,1,0,2,1,3,0,3
1687,6325,Vasco,1,0,Ceara,1,1,1,2,2,1,3
1688,6326,Santos,1,0,Bahia,2,0,1,2,3,0,3
1689,6327,Corinthians,3,0,Parana,4,1,3,5,7,1,8
1690,6328,Athletico-PR,2,0,Gremio,2,0,2,2,4,0,4
1691,6329,Cruzeiro,4,0,Fluminense,3,0,4,3,7,0,7
1692,6330,Botafogo-RJ,2,0,Sport,2,0,2,2,4,0,4
1693,6331,Sao Paulo,3,0,Ceara,6,1,3,7,9,1,10
1694,6332,America-MG,3,0,Flamengo,2,1,3,3,5,1,6
1695,6333,Internacional,2,0,Palmeiras,3,0,2,3,5,0,5
1696,6334,Vitoria,2,0,Atletico-MG,3,0,2,3,5,0,5
1697,6335,Vasco,3,0,Chapecoense,2,0,3,2,5,0,5
1698,6336,Vitoria,5,0,America-MG,1,1,5,2,6,1,7
1699,6337,Gremio,2,0,Botafogo-RJ,3,0,2,3,5,0,5
1700,6338,Vasco,1,0,Santos,1,0,1,1,2,0,2
1701,6339,Corinthians,1,0,Atletico-MG,3,0,1,3,4,0,4
1702,6340,Flamengo,2,0,Ceara,2,0,2,2,4,0,4
1703,6341,Athletico-PR,2,0,Bahia,2,0,2,2,4,0,4
1704,6342,Sport,3,0,Parana,2,0,3,2,5,0,5
1705,6343,Sao Paulo,2,1,Fluminense,2,0,3,2,4,1,5
1706,6344,Cruzeiro,3,0,Internacional,2,0,3,2,5,0,5
1707,6345,Chapecoense,4,0,Palmeiras,4,0,4,4,8,0,8
1708,6346,Bahia,1,0,Sport,1,0,1,1,2,0,2
1709,6347,Botafogo-RJ,3,0,Cruzeiro,3,0,3,3,6,0,6
1710,6348,Ceara,6,0,Corinthians,2,0,6,2,8,0,8
1711,6349,Palmeiras,2,0,Athletico-PR,3,0,2,3,5,0,5
1712,6350,Parana,2,0,Chapecoense,2,0,2,2,4,0,4
1713,6351,Atletico-MG,3,0,Sao Paulo,1,0,3,1,4,0,4
1714,6352,Internacional,4,0,Flamengo,1,0,4,1,5,0,5
1715,6353,Santos,2,0,Gremio,1,0,2,1,3,0,3
1716,6354,Fluminense,1,0,Vitoria,1,0,1,1,2,0,2
1717,6355,America-MG,1,0,Vasco,1,0,1,1,2,0,2
1718,6356,Sport,3,0,Cruzeiro,1,0,3,1,4,0,4
1719,6357,Sao Paulo,3,0,Bahia,2,0,3,2,5,0,5
1720,6358,Flamengo,2,0,Chapecoense,2,0,2,2,4,0,4
1721,6359,America-MG,1,0,Ceara,1,0,1,1,2,0,2
1722,6360,Palmeiras,2,0,Corinthians,3,0,2,3,5,0,5
1723,6361,Fluminense,3,0,Botafogo-RJ,4,0,3,4,7,0,7
1724,6362,Internacional,5,0,Gremio,5,0,5,5,10,0,10
1725,6363,Parana,4,0,Santos,3,0,4,3,7,0,7
1726,6364,Vitoria,4,1,Vasco,1,1,5,2,5,2,7
1727,6365,Atletico-MG,4,0,Athletico-PR,5,1,4,6,9,1,10
1728,6366,Ceara,2,0,Vitoria,4,0,2,4,6,0,6
1729,6367,Gremio,1,0,Parana,1,0,1,1,2,0,2
1730,6368,Vasco,3,0,Flamengo,2,1,3,3,5,1,6
1731,6369,Botafogo-RJ,1,1,America-MG,1,1,2,2,2,2,4
1732,6370,Cruzeiro,3,0,Atletico-MG,1,0,3,1,4,0,4
1733,6371,Bahia,1,0,Palmeiras,2,0,1,2,3,0,3
1734,6372,Athletico-PR,3,0,Fluminense,2,0,3,2,5,0,5
1735,6373,Santos,7,0,Sao Paulo,4,0,7,4,11,0,11
1736,6374,Corinthians,2,0,Sport,1,0,2,1,3,0,3
1737,6375,Chapecoense,4,0,Internacional,3,1,4,4,7,1,8
1738,6376,Sao Paulo,1,0,America-MG,1,0,1,1,2,0,2
1739,6377,Gremio,3,0,Ceara,1,0,3,1,4,0,4
1740,6378,Athletico-PR,0,0,Parana,4,0,0,4,4,0,4
1741,6379,Flamengo,2,0,Atletico-MG,2,0,2,2,4,0,4
1742,6380,Corinthians,0,0,Internacional,2,0,0,2,2,0,2
1743,6381,Sport,2,0,Palmeiras,2,0,2,2,4,0,4
1744,6382,Vitoria,1,0,Botafogo-RJ,4,0,1,4,5,0,5
1745,6383,Cruzeiro,2,0,Santos,2,0,2,2,4,0,4
1746,6384,Chapecoense,3,1,Fluminense,3,0,4,3,6,1,7
1747,6385,Vasco,5,0,Bahia,2,1,5,3,7,1,8
1748,6386,Fluminense,1,0,Gremio,2,0,1,2,3,0,3
1749,6387,America-MG,0,0,Corinthians,1,0,0,1,1,0,1
1750,6388,Bahia,2,0,Flamengo,1,0,2,1,3,0,3
1751,6389,Palmeiras,5,0,Cruzeiro,6,0,5,6,11,0,11
1752,6390,Atletico-MG,1,0,Sport,4,1,1,5,5,1,6
1753,6391,Santos,2,0,Athletico-PR,6,0,2,6,8,0,8
1754,6392,Botafogo-RJ,1,0,Sao Paulo,2,0,1,2,3,0,3
1755,6393,Internacional,3,0,Vitoria,6,1,3,7,9,1,10
1756,6394,Ceara,4,0,Chapecoense,5,0,4,5,9,0,9
1757,6395,Parana,1,0,Vasco,0,1,1,1,1,1,2
1758,6396,Sport,4,0,Internacional,1,0,4,1,5,0,5
1759,6397,Corinthians,2,0,Flamengo,1,0,2,1,3,0,3
1760,6398,Vitoria,3,1,Santos,2,0,4,2,5,1,6
1761,6399,Athletico-PR,3,0,America-MG,3,0,3,3,6,0,6
1762,6400,Chapecoense,3,0,Atletico-MG,3,0,3,3,6,0,6
1763,6401,Sao Paulo,2,0,Palmeiras,3,0,2,3,5,0,5
1764,6402,Gremio,2,0,Bahia,4,1,2,5,6,1,7
1765,6403,Fluminense,1,0,Parana,2,0,1,2,3,0,3
1766,6404,Botafogo-RJ,3,0,Vasco,2,0,3,2,5,0,5
1767,6405,Cruzeiro,1,0,Ceara,3,0,1,3,4,0,4
1768,6406,Flamengo,2,0,Fluminense,3,0,2,3,5,0,5
1769,6407,Santos,3,0,Corinthians,3,0,3,3,6,0,6
1770,6408,Bahia,3,0,Parana,3,0,3,3,6,0,6
1771,6409,Chapecoense,3,0,Vitoria,2,0,3,2,5,0,5
1772,6410,Vasco,6,0,Cruzeiro,2,1,6,3,8,1,9
1773,6411,Internacional,0,0,Sao Paulo,4,1,0,5,4,1,5
1774,6412,Palmeiras,4,0,Gremio,2,0,4,2,6,0,6
1775,6413,Atletico-MG,1,0,America-MG,0,0,1,0,1,0,1
1776,6414,Athletico-PR,0,0,Sport,3,0,0,3,3,0,3
1777,6415,Ceara,1,0,Botafogo-RJ,3,0,1,3,4,0,4
1778,6417,Botafogo-RJ,2,0,Bahia,1,0,2,1,3,0,3
1779,6418,Sao Paulo,3,0,Athletico-PR,2,0,3,2,5,0,5
1780,6419,Sport,0,0,Vasco,3,0,0,3,3,0,3
1781,6420,Vitoria,1,0,Corinthians,4,0,1,4,5,0,5
1782,6421,Fluminense,2,1,Atletico-MG,2,0,3,2,4,1,5
1783,6422,Palmeiras,5,1,Ceara,2,0,6,2,7,1,8
1784,6423,Cruzeiro,2,0,Chapecoense,1,0,2,1,3,0,3
1785,6424,Parana,1,1,Flamengo,0,0,2,0,1,1,2
1786,6425,Internacional,1,0,Santos,3,0,1,3,4,0,4
1787,6426,Vitoria,1,0,Sao Paulo,2,1,1,3,3,1,4
1788,6427,Vasco,3,0,Internacional,5,1,3,6,8,1,9
1789,6428,Santos,2,0,Fluminense,3,0,2,3,5,0,5
1790,6429,Gremio,2,0,Sport,2,0,2,2,4,0,4
1791,6430,Corinthians,3,0,Bahia,3,0,3,3,6,0,6
1792,6431,Chapecoense,3,0,America-MG,4,0,3,4,7,0,7
1793,6432,Flamengo,2,0,Palmeiras,5,0,2,5,7,0,7
1794,6433,Cruzeiro,0,0,Parana,2,0,0,2,2,0,2
1795,6434,Athletico-PR,2,0,Botafogo-RJ,5,0,2,5,7,0,7
1796,6435,Ceara,2,0,Atletico-MG,4,0,2,4,6,0,6
1797,6436,Fluminense,2,1,Vasco,3,0,3,3,5,1,6
1798,6437,Atletico-MG,4,0,Gremio,1,0,4,1,5,0,5
1799,6438,Palmeiras,3,0,Santos,5,1,3,6,8,1,9
1800,6439,America-MG,3,0,Cruzeiro,1,0,3,1,4,0,4
1801,6440,Parana,3,0,Vitoria,4,1,3,5,7,1,8
1802,6441,Sao Paulo,2,0,Flamengo,1,0,2,1,3,0,3
1803,6442,Botafogo-RJ,1,0,Corinthians,2,0,1,2,3,0,3
1804,6443,Internacional,2,0,Athletico-PR,3,0,2,3,5,0,5
1805,6444,Bahia,1,0,Chapecoense,1,0,1,1,2,0,2
1806,6445,Sport,3,0,Ceara,3,0,3,3,6,0,6
1807,6446,America-MG,3,1,Parana,1,1,4,2,4,2,6
1808,6447,Corinthians,1,1,Sao Paulo,3,0,2,3,4,1,5
1809,6448,Botafogo-RJ,4,0,Flamengo,6,0,4,6,10,0,10
1810,6449,Athletico-PR,4,0,Cruzeiro,7,0,4,7,11,0,11
1811,6450,Vitoria,3,0,Bahia,4,0,3,4,7,0,7
1812,6451,Ceara,2,0,Internacional,5,0,2,5,7,0,7
1813,6452,Atletico-MG,3,0,Palmeiras,2,0,3,2,5,0,5
1814,6453,Gremio,2,0,Vasco,4,0,2,4,6,0,6
1815,6454,Fluminense,0,0,Sport,2,0,0,2,2,0,2
1816,6455,Santos,2,0,Chapecoense,1,0,2,1,3,0,3
1817,6456,Vasco,1,0,Athletico-PR,0,0,1,0,1,0,1
1818,6457,Bahia,2,0,Ceara,3,0,2,3,5,0,5
1819,6458,Parana,4,2,Atletico-MG,3,0,6,3,7,2,9
1820,6459,Sport,4,0,Vitoria,4,0,4,4,8,0,8
1821,6460,Palmeiras,6,0,Fluminense,5,1,6,6,11,1,12
1822,6461,Cruzeiro,2,0,Corinthians,2,1,2,3,4,1,5
1823,6462,Chapecoense,1,0,Botafogo-RJ,2,0,1,2,3,0,3
1824,6463,Flamengo,3,0,Santos,5,0,3,5,8,0,8
1825,6464,Sao Paulo,1,0,Gremio,2,0,1,2,3,0,3
1826,6465,Internacional,1,0,America-MG,2,0,1,2,3,0,3
1827,6466,Corinthians,2,0,Vasco,2,0,2,2,4,0,4
1828,6467,Vitoria,3,1,Athletico-PR,3,0,4,3,6,1,7
1829,6468,Atletico-MG,3,1,Bahia,3,0,4,3,6,1,7
1830,6469,Parana,4,0,Palmeiras,2,0,4,2,6,0,6
1831,6470,America-MG,6,0,Santos,1,0,6,1,7,0,7
1832,6471,Sport,1,0,Flamengo,1,1,1,2,2,1,3
1833,6472,Botafogo-RJ,2,0,Internacional,4,2,2,6,6,2,8
1834,6473,Sao Paulo,2,0,Cruzeiro,2,0,2,2,4,0,4
1835,6474,Gremio,2,0,Chapecoense,2,0,2,2,4,0,4
1836,6475,Fluminense,4,0,Ceara,3,0,4,3,7,0,7
1837,6476,Internacional,1,0,Atletico-MG,2,0,1,2,3,0,3
1838,6477,Santos,2,0,Botafogo-RJ,2,0,2,2,4,0,4
1839,6478,Athletico-PR,2,0,Corinthians,4,0,2,4,6,0,6
1840,6479,Palmeiras,0,0,America-MG,6,0,0,6,6,0,6
1841,6480,Flamengo,2,0,Gremio,3,0,2,3,5,0,5
1842,6481,Cruzeiro,2,0,Vitoria,1,0,2,1,3,0,3
1843,6482,Vasco,2,0,Sao Paulo,4,0,2,4,6,0,6
1844,6483,Ceara,2,0,Parana,1,0,2,1,3,0,3
1845,6484,Bahia,2,0,Fluminense,1,0,2,1,3,0,3
1846,6485,Chapecoense,2,0,Sport,1,0,2,1,3,0,3
1847,6486,Santos,4,1,Atletico-MG,1,0,5,1,5,1,6
1848,6487,Athletico-PR,3,0,Ceara,4,0,3,4,7,0,7
1849,6488,Cruzeiro,6,0,Flamengo,3,0,6,3,9,0,9
1850,6489,Vitoria,2,0,Gremio,4,0,2,4,6,0,6
1851,6490,Vasco,4,1,Palmeiras,5,0,5,5,9,1,10
1852,6491,Internacional,3,0,Fluminense,2,1,3,3,5,1,6
1853,6492,America-MG,2,0,Bahia,2,1,2,3,4,1,5
1854,6493,Corinthians,2,0,Chapecoense,1,0,2,1,3,0,3
1855,6494,Botafogo-RJ,1,0,Parana,3,0,1,3,4,0,4
1856,6495,Sao Paulo,2,0,Sport,3,1,2,4,5,1,6
1857,6496,Flamengo,4,1,Athletico-PR,1,1,5,2,5,2,7
1858,6497,Atletico-MG,4,0,Botafogo-RJ,3,0,4,3,7,0,7
1859,6498,Ceara,3,1,Vasco,2,0,4,2,5,1,6
1860,6499,Gremio,2,0,Corinthians,4,0,2,4,6,0,6
1861,6500,Bahia,4,0,Cruzeiro,1,0,4,1,5,0,5
1862,6501,Sport,3,0,Santos,1,0,3,1,4,0,4
1863,6502,Parana,1,1,Internacional,2,0,2,2,3,1,4
1864,6503,Fluminense,5,0,America-MG,2,0,5,2,7,0,7
1865,6504,Chapecoense,0,0,Sao Paulo,3,0,0,3,3,0,3
1866,6505,Palmeiras,2,0,Vitoria,2,0,2,2,4,0,4
1867,6506,Sao Paulo,0,0,Botafogo-RJ,4,0,0,4,4,0,4
1868,6507,Atletico-MG,0,0,Avai,1,0,0,1,1,0,1
1869,6508,Chapecoense,1,0,Internacional,1,0,1,1,2,0,2
1870,6509,Flamengo,4,0,Cruzeiro,5,1,4,6,9,1,10
1871,6510,Gremio,3,0,Santos,4,1,3,5,7,1,8
1872,6511,Bahia,1,0,Corinthians,4,0,1,4,5,0,5
1873,6512,Athletico-PR,1,0,Vasco,1,0,1,1,2,0,2
1874,6513,Ceara,0,0,CSA,0,1,0,1,0,1,1
1875,6514,Palmeiras,1,0,Fortaleza,2,0,1,2,3,0,3
1876,6515,Fluminense,4,0,Goias,1,0,4,1,5,0,5
1877,6516,Internacional,3,0,Flamengo,2,0,3,2,5,0,5
1878,6518,Corinthians,2,0,Chapecoense,1,0,2,1,3,0,3
1879,6519,Cruzeiro,1,0,Ceara,0,0,1,0,1,0,1
1880,6520,Avai,4,0,Gremio,3,0,4,3,7,0,7
1881,6521,Goias,3,0,Sao Paulo,2,1,3,3,5,1,6
1882,6523,Fortaleza,3,0,Athletico-PR,3,0,3,3,6,0,6
1883,6524,Santos,3,0,Fluminense,2,0,3,2,5,0,5
1884,6525,Botafogo-RJ,3,0,Bahia,0,0,3,0,3,0,3
1885,6526,Vasco,2,0,Corinthians,1,0,2,1,3,0,3
1886,6527,Palmeiras,2,0,Internacional,5,0,2,5,7,0,7
1887,6528,Ceara,0,0,Atletico-MG,1,0,0,1,1,0,1
1888,6529,Chapecoense,1,0,Athletico-PR,3,0,1,3,4,0,4
1889,6530,Sao Paulo,1,0,Flamengo,7,0,1,7,8,0,8
1890,6531,Botafogo-RJ,0,0,Fortaleza,2,0,0,2,2,0,2
1891,6532,CSA,1,0,Santos,4,0,1,4,5,0,5
1892,6533,Cruzeiro,1,0,Goias,2,1,1,3,3,1,4
1893,6534,Gremio,2,0,Fluminense,1,0,2,1,3,0,3
1894,6535,Bahia,1,0,Avai,2,0,1,2,3,0,3
1895,6536,Fluminense,3,0,Botafogo-RJ,5,0,3,5,8,0,8
1896,6537,Corinthians,2,0,Gremio,4,0,2,4,6,0,6
1897,6538,Goias,2,0,Ceara,2,0,2,2,4,0,4
1898,6539,Flamengo,2,0,Chapecoense,3,0,2,3,5,0,5
1899,6540,Santos,2,0,Vasco,4,1,2,5,6,1,7
1900,6541,Atletico-MG,1,0,Palmeiras,3,0,1,3,4,0,4
1901,6542,Internacional,0,0,Cruzeiro,0,1,0,1,0,1,1
1902,6543,Avai,1,0,CSA,2,0,1,2,3,0,3
1903,6544,Athletico-PR,2,0,Bahia,3,0,2,3,5,0,5
1904,6545,Fortaleza,2,0,Sao Paulo,2,0,2,2,4,0,4
1905,6546,Fluminense,3,0,Cruzeiro,2,0,3,2,5,0,5
1906,6547,Palmeiras,2,0,Santos,4,0,2,4,6,0,6
1907,6548,Atletico-MG,3,1,Flamengo,1,0,4,1,4,1,5
1908,6549,Sao Paulo,1,1,Bahia,3,0,2,3,4,1,5
1909,6550,Internacional,2,0,CSA,3,0,2,3,5,0,5
1910,6551,Athletico-PR,1,0,Corinthians,4,0,1,4,5,0,5
1911,6552,Goias,1,0,Botafogo-RJ,3,0,1,3,4,0,4
1912,6553,Chapecoense,1,0,Fortaleza,1,0,1,1,2,0,2
1913,6554,Vasco,1,0,Avai,2,0,1,2,3,0,3
1914,6555,Ceara,3,0,Gremio,6,0,3,6,9,0,9
1915,6556,Botafogo-RJ,10,0,Palmeiras,0,0,10,0,10,0,10
1916,6557,Gremio,1,0,Atletico-MG,4,0,1,4,5,0,5
1917,6558,Flamengo,4,0,Athletico-PR,3,0,4,3,7,0,7
1918,6559,Santos,5,0,Internacional,5,0,5,5,10,0,10
1919,6560,Fortaleza,1,0,Vasco,2,0,1,2,3,0,3
1920,6561,Cruzeiro,1,0,Chapecoense,3,0,1,3,4,0,4
1921,6562,Bahia,2,0,Fluminense,3,1,2,4,5,1,6
1922,6563,Corinthians,3,0,Sao Paulo,4,0,3,4,7,0,7
1923,6564,CSA,3,0,Goias,1,0,3,1,4,0,4
1924,6565,Avai,4,0,Ceara,3,0,4,3,7,0,7
1925,6566,Flamengo,1,0,Fortaleza,0,0,1,0,1,0,1
1926,6567,Bahia,1,0,Gremio,2,0,1,2,3,0,3
1927,6568,Botafogo-RJ,2,0,Vasco,3,0,2,3,5,0,5
1928,6569,Ceara,2,0,Santos,1,0,2,1,3,0,3
1929,6570,Athletico-PR,1,0,Fluminense,3,1,1,4,4,1,5
1930,6571,Sao Paulo,2,1,Cruzeiro,3,0,3,3,5,1,6
1931,6572,Atletico-MG,0,0,CSA,3,0,0,3,3,0,3
1932,6573,Chapecoense,2,0,Palmeiras,5,0,2,5,7,0,7
1933,6575,Corinthians,1,0,Goias,2,1,1,3,3,1,4
1934,6576,Vasco,0,0,Internacional,2,0,0,2,2,0,2
1935,6577,Palmeiras,2,0,Athletico-PR,4,0,2,4,6,0,6
1936,6578,Gremio,1,0,Fortaleza,4,1,1,5,5,1,6
1937,6579,Cruzeiro,1,0,Corinthians,1,0,1,1,2,0,2
1938,6580,Ceara,2,0,Bahia,2,0,2,2,4,0,4
1939,6581,Avai,5,0,Sao Paulo,2,0,5,2,7,0,7
1940,6582,CSA,2,0,Botafogo-RJ,1,0,2,1,3,0,3
1941,6583,Fluminense,2,0,Flamengo,3,0,2,3,5,0,5
1942,6584,Santos,1,0,Atletico-MG,2,0,1,2,3,0,3
1943,6585,Goias,2,0,Chapecoense,0,1,2,1,2,1,3
1944,6586,Botafogo-RJ,1,0,Gremio,2,0,1,2,3,0,3
1945,6587,Fortaleza,1,1,Cruzeiro,6,0,2,6,7,1,8
1946,6588,Internacional,1,0,Bahia,1,0,1,1,2,0,2
1947,6589,CSA,3,0,Flamengo,1,0,3,1,4,0,4
1948,6590,Santos,4,0,Corinthians,4,0,4,4,8,0,8
1949,6591,Vasco,0,0,Ceara,2,0,0,2,2,0,2
1950,6592,Chapecoense,2,0,Fluminense,6,1,2,7,8,1,9
1951,6593,Palmeiras,1,0,Avai,1,0,1,1,2,0,2
1952,6594,Atletico-MG,2,0,Sao Paulo,4,0,2,4,6,0,6
1953,6595,Goias,1,0,Athletico-PR,3,0,1,3,4,0,4
1954,6596,Gremio,2,0,Vasco,4,0,2,4,6,0,6
1955,6597,Fortaleza,2,0,Avai,2,0,2,2,4,0,4
1956,6598,Bahia,2,0,Santos,3,0,2,3,5,0,5
1957,6599,Sao Paulo,3,0,Palmeiras,3,0,3,3,6,0,6
1958,6600,Flamengo,1,0,Goias,2,0,1,2,3,0,3
1959,6601,Corinthians,2,0,CSA,6,0,2,6,8,0,8
1960,6602,Athletico-PR,3,0,Internacional,3,0,3,3,6,0,6
1961,6604,Chapecoense,3,0,Atletico-MG,5,0,3,5,8,0,8
1962,6605,Fluminense,2,0,Ceara,2,0,2,2,4,0,4
1963,6606,Vasco,4,0,Fluminense,3,2,4,5,7,2,9
1964,6607,Bahia,2,1,Cruzeiro,1,0,3,1,3,1,4
1965,6608,Ceara,3,0,Palmeiras,2,0,3,2,5,0,5
1966,6609,CSA,2,0,Athletico-PR,1,0,2,1,3,0,3
1967,6610,Internacional,3,0,Gremio,2,0,3,2,5,0,5
1968,6611,Botafogo-RJ,2,1,Santos,3,1,3,4,5,2,7
1969,6612,Atletico-MG,1,0,Fortaleza,4,0,1,4,5,0,5
1970,6613,Corinthians,1,0,Flamengo,4,1,1,5,5,1,6
1971,6614,Avai,4,0,Goias,2,0,4,2,6,0,6
1972,6615,Sao Paulo,1,0,Chapecoense,3,0,1,3,4,0,4
1973,6616,Palmeiras,1,0,Vasco,4,0,1,4,5,0,5
1974,6617,Cruzeiro,1,0,Athletico-PR,0,0,1,0,1,0,1
1975,6618,Fluminense,1,0,Sao Paulo,3,0,1,3,4,0,4
1976,6619,Internacional,3,0,Ceara,3,0,3,3,6,0,6
1977,6620,Chapecoense,1,0,Bahia,1,0,1,1,2,0,2
1978,6621,Flamengo,5,0,Botafogo-RJ,2,0,5,2,7,0,7
1979,6622,Santos,2,0,Avai,2,0,2,2,4,0,4
1980,6623,Goias,1,0,Atletico-MG,0,0,1,0,1,0,1
1981,6624,Fortaleza,2,0,Corinthians,1,0,2,1,3,0,3
1982,6625,CSA,4,0,Gremio,2,0,4,2,6,0,6
1983,6626,Ceara,3,0,Fortaleza,1,1,3,2,4,1,5
1984,6627,Fluminense,1,0,Internacional,2,0,1,2,3,0,3
1985,6628,Santos,3,0,Goias,4,0,3,4,7,0,7
1986,6629,Avai,2,1,Botafogo-RJ,1,0,3,1,3,1,4
1987,6630,Bahia,1,1,Flamengo,1,0,2,1,2,1,3
1988,6631,Corinthians,1,0,Palmeiras,3,0,1,3,4,0,4
1989,6632,Vasco,4,0,CSA,1,0,4,1,5,0,5
1990,6633,Atletico-MG,2,0,Cruzeiro,3,0,2,3,5,0,5
1991,6634,Gremio,4,0,Chapecoense,3,0,4,3,7,0,7
1992,6635,Athletico-PR,3,0,Sao Paulo,3,0,3,3,6,0,6
1993,6636,Ceara,3,0,Chapecoense,2,0,3,2,5,0,5
1994,6637,Sao Paulo,6,0,Santos,1,0,6,1,7,0,7
1995,6638,Flamengo,4,0,Gremio,2,0,4,2,6,0,6
1996,6639,Atletico-MG,4,0,Fluminense,3,1,4,4,7,1,8
1997,6640,Internacional,3,0,Corinthians,2,0,3,2,5,0,5
1998,6641,Palmeiras,6,1,Bahia,4,1,7,5,10,2,12
1999,6642,Avai,4,1,Cruzeiro,2,1,5,3,6,2,8
2000,6643,Botafogo-RJ,3,0,Athletico-PR,1,0,3,1,4,0,4
2001,6644,Goias,4,0,Vasco,4,1,4,5,8,1,9
2002,6645,CSA,3,0,Fortaleza,1,0,3,1,4,0,4
2003,6646,Corinthians,2,0,Botafogo-RJ,3,0,2,3,5,0,5
2004,6647,Fortaleza,2,1,Internacional,2,0,3,2,4,1,5
2005,6648,Vasco,0,0,Flamengo,3,0,0,3,3,0,3
2006,6649,Athletico-PR,3,0,Atletico-MG,1,0,3,1,4,0,4
2007,6651,Fluminense,1,0,CSA,2,0,1,2,3,0,3
2008,6652,Sao Paulo,3,0,Ceara,2,0,3,2,5,0,5
2009,6653,Bahia,2,1,Goias,3,0,3,3,5,1,6
2010,6654,Cruzeiro,2,0,Santos,0,1,2,1,2,1,3
2011,6655,Chapecoense,1,0,Avai,0,0,1,0,1,0,1
2012,6656,Atletico-MG,0,0,Bahia,2,0,0,2,2,0,2
2013,6657,Gremio,3,0,Athletico-PR,1,0,3,1,4,0,4
2014,6658,Goias,2,1,Internacional,2,0,3,2,4,1,5
2015,6659,Vasco,4,0,Sao Paulo,3,1,4,4,7,1,8
2016,6660,Santos,3,0,Fortaleza,3,0,3,3,6,0,6
2017,6661,Ceara,3,0,Flamengo,0,0,3,0,3,0,3
2018,6662,Avai,0,1,Corinthians,1,1,1,2,1,2,3
2019,6663,CSA,3,0,Cruzeiro,3,0,3,3,6,0,6
2020,6664,Botafogo-RJ,2,0,Chapecoense,1,0,2,1,3,0,3
2021,6665,Palmeiras,0,0,Fluminense,2,0,0,2,2,0,2
2022,6666,Sao Paulo,1,1,Gremio,1,0,2,1,2,1,3
2023,6667,Bahia,1,0,CSA,1,0,1,1,2,0,2
2024,6668,Chapecoense,2,0,Santos,4,0,2,4,6,0,6
2025,6669,Athletico-PR,1,0,Ceara,3,0,1,3,4,0,4
2026,6670,Internacional,4,0,Botafogo-RJ,4,0,4,4,8,0,8
2027,6671,Flamengo,2,0,Palmeiras,2,1,2,3,4,1,5
2028,6672,Fortaleza,3,0,Goias,2,1,3,3,5,1,6
2029,6673,Cruzeiro,3,0,Vasco,4,0,3,4,7,0,7
2030,6674,Corinthians,0,0,Atletico-MG,1,0,0,1,1,0,1
2031,6675,Fluminense,3,0,Avai,1,0,3,1,4,0,4
2032,6676,Vasco,3,0,Bahia,1,0,3,1,4,0,4
2033,6677,Corinthians,1,0,Ceara,1,0,1,1,2,0,2
2034,6678,Avai,1,1,Flamengo,2,0,2,2,3,1,4
2035,6679,Fortaleza,1,0,Fluminense,2,0,1,2,3,0,3
2036,6680,Internacional,1,0,Sao Paulo,5,0,1,5,6,0,6
2037,6681,Goias,5,0,Palmeiras,1,1,5,2,6,1,7
2038,6682,Cruzeiro,2,0,Gremio,1,0,2,1,3,0,3
2039,6683,Santos,3,0,Athletico-PR,6,0,3,6,9,0,9
2040,6684,Botafogo-RJ,4,0,Atletico-MG,3,1,4,4,7,1,8
2041,6685,CSA,3,0,Chapecoense,2,2,3,4,5,2,7
2042,6686,Flamengo,2,0,Santos,5,0,2,5,7,0,7
2043,6687,Chapecoense,2,0,Vasco,5,0,2,5,7,0,7
2044,6688,Palmeiras,2,0,Cruzeiro,3,0,2,3,5,0,5
2045,6689,Ceara,1,0,Botafogo-RJ,1,0,1,1,2,0,2
2046,6690,Athletico-PR,1,0,Avai,0,0,1,0,1,0,1
2047,6691,Atletico-MG,0,0,Internacional,1,0,0,1,1,0,1
2048,6692,Bahia,1,0,Fortaleza,1,0,1,1,2,0,2
2049,6693,Gremio,0,0,Goias,1,0,0,1,1,0,1
2050,6694,Fluminense,4,0,Corinthians,1,0,4,1,5,0,5
2051,6695,Sao Paulo,1,0,CSA,3,0,1,3,4,0,4
2052,6696,Botafogo-RJ,3,0,Sao Paulo,1,0,3,1,4,0,4
2053,6697,Cruzeiro,2,0,Flamengo,2,0,2,2,4,0,4
2054,6698,Corinthians,2,0,Bahia,4,0,2,4,6,0,6
2055,6699,Santos,1,0,Gremio,4,0,1,4,5,0,5
2056,6700,Internacional,0,0,Chapecoense,4,0,0,4,4,0,4
2057,6701,Fortaleza,4,0,Palmeiras,1,0,4,1,5,0,5
2058,6702,CSA,1,0,Ceara,2,0,1,2,3,0,3
2059,6703,Vasco,3,0,Athletico-PR,3,0,3,3,6,0,6
2060,6704,Goias,4,1,Fluminense,0,0,5,0,4,1,5
2061,6705,Avai,3,0,Atletico-MG,1,0,3,1,4,0,4
2062,6706,Ceara,2,0,Cruzeiro,3,0,2,3,5,0,5
2063,6707,Bahia,1,0,Botafogo-RJ,0,1,1,1,1,1,2
2064,6708,Flamengo,1,0,Internacional,1,2,1,3,2,2,4
2065,6709,Sao Paulo,2,0,Goias,4,0,2,4,6,0,6
2066,6710,Palmeiras,0,0,CSA,1,0,0,1,1,0,1
2067,6711,Fluminense,2,2,Santos,3,1,4,4,5,3,8
2068,6712,Gremio,1,0,Avai,1,0,1,1,2,0,2
2069,6713,Athletico-PR,3,0,Fortaleza,0,0,3,0,3,0,3
2070,6714,Atletico-MG,3,0,Vasco,2,0,3,2,5,0,5
2071,6715,Chapecoense,3,0,Corinthians,2,0,3,2,5,0,5
2072,6716,Flamengo,3,0,Sao Paulo,4,0,3,4,7,0,7
2073,6717,Corinthians,3,0,Vasco,5,0,3,5,8,0,8
2074,6718,Santos,1,1,CSA,2,0,2,2,3,1,4
2075,6719,Internacional,3,0,Palmeiras,2,0,3,2,5,0,5
2076,6720,Fluminense,1,0,Gremio,4,0,1,4,5,0,5
2077,6721,Athletico-PR,0,0,Chapecoense,1,0,0,1,1,0,1
2078,6722,Atletico-MG,0,0,Ceara,2,0,0,2,2,0,2
2079,6723,Avai,1,0,Bahia,2,0,1,2,3,0,3
2080,6724,Fortaleza,3,0,Botafogo-RJ,2,0,3,2,5,0,5
2081,6725,Goias,0,0,Cruzeiro,3,0,0,3,3,0,3
2082,6726,Vasco,4,0,Santos,2,1,4,3,6,1,7
2083,6727,Sao Paulo,3,0,Fortaleza,2,0,3,2,5,0,5
2084,6728,Gremio,3,0,Corinthians,2,0,3,2,5,0,5
2085,6729,Bahia,2,0,Athletico-PR,3,0,2,3,5,0,5
2086,6730,Cruzeiro,5,0,Internacional,3,0,5,3,8,0,8
2087,6731,Chapecoense,1,0,Flamengo,0,0,1,0,1,0,1
2088,6732,Ceara,1,0,Goias,0,0,1,0,1,0,1
2089,6733,Palmeiras,3,0,Atletico-MG,4,0,3,4,7,0,7
2090,6734,Botafogo-RJ,4,0,Fluminense,1,0,4,1,5,0,5
2091,6735,CSA,3,0,Avai,3,0,3,3,6,0,6
2092,6736,CSA,2,0,Internacional,2,0,2,2,4,0,4
2093,6737,Botafogo-RJ,4,0,Goias,2,0,4,2,6,0,6
2094,6738,Fortaleza,4,0,Chapecoense,2,0,4,2,6,0,6
2095,6739,Bahia,2,0,Sao Paulo,1,0,2,1,3,0,3
2096,6740,Gremio,0,0,Ceara,3,0,0,3,3,0,3
2097,6741,Cruzeiro,4,0,Fluminense,3,0,4,3,7,0,7
2098,6742,Santos,1,0,Palmeiras,2,1,1,3,3,1,4
2099,6743,Corinthians,2,0,Athletico-PR,2,0,2,2,4,0,4
2100,6744,Avai,1,0,Vasco,1,0,1,1,2,0,2
2101,6745,Flamengo,0,0,Atletico-MG,3,0,0,3,3,0,3
2102,6746,Goias,2,0,CSA,3,0,2,3,5,0,5
2103,6747,Fluminense,0,0,Bahia,1,0,0,1,1,0,1
2104,6748,Palmeiras,2,0,Botafogo-RJ,2,0,2,2,4,0,4
2105,6749,Internacional,2,0,Santos,3,0,2,3,5,0,5
2106,6750,Athletico-PR,2,0,Flamengo,4,0,2,4,6,0,6
2107,6751,Ceara,1,0,Avai,3,0,1,3,4,0,4
2108,6752,Vasco,2,0,Fortaleza,4,1,2,5,6,1,7
2109,6753,Sao Paulo,0,0,Corinthians,1,0,0,1,1,0,1
2110,6754,Atletico-MG,4,1,Gremio,1,0,5,1,5,1,6
2111,6755,Chapecoense,1,0,Cruzeiro,1,0,1,1,2,0,2
2112,6756,CSA,3,0,Atletico-MG,3,1,3,4,6,1,7
2113,6757,Gremio,3,0,Bahia,2,0,3,2,5,0,5
2114,6758,Fortaleza,1,0,Flamengo,3,0,1,3,4,0,4
2115,6759,Cruzeiro,2,0,Sao Paulo,2,0,2,2,4,0,4
2116,6760,Palmeiras,1,0,Chapecoense,3,1,1,4,4,1,5
2117,6761,Goias,3,2,Corinthians,4,0,5,4,7,2,9
2118,6762,Vasco,1,0,Botafogo-RJ,0,0,1,0,1,0,1
2119,6763,Avai,1,1,Internacional,3,0,2,3,4,1,5
2120,6764,Santos,3,0,Ceara,4,0,3,4,7,0,7
2121,6765,Fluminense,0,0,Athletico-PR,1,0,0,1,1,0,1
2122,6766,Fortaleza,4,0,Gremio,2,1,4,3,6,1,7
2123,6767,Corinthians,3,0,Cruzeiro,1,0,3,1,4,0,4
2124,6768,Internacional,3,0,Vasco,1,0,3,1,4,0,4
2125,6769,Sao Paulo,4,0,Avai,1,1,4,2,5,1,6
2126,6770,Atletico-MG,3,0,Santos,4,0,3,4,7,0,7
2127,6771,Flamengo,3,0,Fluminense,5,0,3,5,8,0,8
2128,6772,Chapecoense,2,0,Goias,5,0,2,5,7,0,7
2129,6773,Athletico-PR,1,0,Palmeiras,2,0,1,2,3,0,3
2130,6774,Bahia,2,0,Ceara,3,0,2,3,5,0,5
2131,6775,Botafogo-RJ,2,0,CSA,2,1,2,3,4,1,5
2132,6776,Corinthians,3,0,Santos,1,0,3,1,4,0,4
2133,6777,Ceara,3,0,Vasco,3,0,3,3,6,0,6
2134,6778,Bahia,1,0,Internacional,5,0,1,5,6,0,6
2135,6779,Fluminense,1,0,Chapecoense,4,0,1,4,5,0,5
2136,6780,Cruzeiro,3,0,Fortaleza,1,0,3,1,4,0,4
2137,6781,Athletico-PR,1,0,Goias,1,0,1,1,2,0,2
2138,6782,Gremio,3,0,Botafogo-RJ,2,0,3,2,5,0,5
2139,6784,Avai,3,0,Palmeiras,2,0,3,2,5,0,5
2140,6785,Flamengo,1,0,CSA,2,0,1,2,3,0,3
2141,6787,Avai,4,1,Fortaleza,1,0,5,1,5,1,6
2142,6788,Atletico-MG,3,0,Chapecoense,3,0,3,3,6,0,6
2143,6789,Ceara,1,0,Fluminense,1,0,1,1,2,0,2
2144,6790,Vasco,2,0,Gremio,2,0,2,2,4,0,4
2145,6791,CSA,6,0,Corinthians,2,0,6,2,8,0,8
2146,6792,Santos,5,0,Bahia,3,0,5,3,8,0,8
2147,6793,Goias,5,0,Flamengo,3,1,5,4,8,1,9
2148,6794,Internacional,3,0,Athletico-PR,2,0,3,2,5,0,5
2149,6795,Botafogo-RJ,1,0,Cruzeiro,3,0,1,3,4,0,4
2150,6796,Fortaleza,3,0,Atletico-MG,3,1,3,4,6,1,7
2151,6797,Fluminense,2,0,Vasco,3,0,2,3,5,0,5
2152,6798,Palmeiras,2,0,Ceara,2,0,2,2,4,0,4
2153,6799,Chapecoense,2,0,Sao Paulo,2,0,2,2,4,0,4
2154,6800,Flamengo,0,0,Corinthians,1,0,0,1,1,0,1
2155,6801,Athletico-PR,3,0,CSA,4,0,3,4,7,0,7
2156,6802,Gremio,2,0,Internacional,2,1,2,3,4,1,5
2157,6803,Santos,1,0,Botafogo-RJ,0,0,1,0,1,0,1
2158,6804,Cruzeiro,3,1,Bahia,0,0,4,0,3,1,4
2159,6805,Goias,1,0,Avai,3,0,1,3,4,0,4
2160,6806,Corinthians,2,0,Fortaleza,3,0,2,3,5,0,5
2161,6807,Atletico-MG,0,0,Goias,2,0,0,2,2,0,2
2162,6808,Avai,5,1,Santos,2,1,6,3,7,2,9
2163,6809,Athletico-PR,3,0,Cruzeiro,1,1,3,2,4,1,5
2164,6810,Vasco,7,1,Palmeiras,4,0,8,4,11,1,12
2165,6811,Bahia,1,0,Chapecoense,3,0,1,3,4,0,4
2166,6812,Ceara,2,0,Internacional,2,0,2,2,4,0,4
2167,6813,Sao Paulo,2,0,Fluminense,1,0,2,1,3,0,3
2168,6814,Botafogo-RJ,5,1,Flamengo,2,0,6,2,7,1,8
2169,6815,Gremio,3,0,CSA,2,0,3,2,5,0,5
2170,6816,Goias,4,0,Santos,2,0,4,2,6,0,6
2171,6817,Palmeiras,2,0,Corinthians,1,0,2,1,3,0,3
2172,6818,Internacional,3,0,Fluminense,2,0,3,2,5,0,5
2173,6819,Cruzeiro,1,0,Atletico-MG,1,0,1,1,2,0,2
2174,6820,Sao Paulo,2,0,Athletico-PR,2,0,2,2,4,0,4
2175,6821,Flamengo,1,0,Bahia,0,0,1,0,1,0,1
2176,6822,Chapecoense,2,0,Gremio,2,0,2,2,4,0,4
2177,6823,Fortaleza,4,0,Ceara,4,0,4,4,8,0,8
2178,6824,CSA,2,1,Vasco,2,0,3,2,4,1,5
2179,6825,Botafogo-RJ,4,0,Avai,3,1,4,4,7,1,8
2180,6826,Flamengo,6,0,Vasco,5,0,6,5,11,0,11
2181,6827,Santos,2,0,Cruzeiro,2,0,2,2,4,0,4
2182,6828,Palmeiras,2,0,Gremio,3,0,2,3,5,0,5
2183,6829,Atletico-MG,3,0,Athletico-PR,2,0,3,2,5,0,5
2184,6830,Goias,2,0,Bahia,2,0,2,2,4,0,4
2185,6831,Botafogo-RJ,4,0,Corinthians,2,0,4,2,6,0,6
2186,6832,Ceara,3,0,Sao Paulo,1,0,3,1,4,0,4
2187,6833,Internacional,4,0,Fortaleza,2,0,4,2,6,0,6
2188,6834,Avai,0,1,Chapecoense,1,1,1,2,1,2,3
2189,6835,CSA,2,0,Fluminense,2,0,2,2,4,0,4
2190,6836,Santos,0,0,Sao Paulo,3,0,0,3,3,0,3
2191,6837,Fluminense,2,0,Atletico-MG,3,0,2,3,5,0,5
2192,6838,Gremio,1,0,Flamengo,3,1,1,4,4,1,5
2193,6839,Bahia,2,0,Palmeiras,0,0,2,0,2,0,2
2194,6840,Chapecoense,2,0,Ceara,1,0,2,1,3,0,3
2195,6841,Athletico-PR,4,0,Botafogo-RJ,1,0,4,1,5,0,5
2196,6842,Corinthians,0,0,Internacional,2,0,0,2,2,0,2
2197,6843,Fortaleza,0,0,CSA,1,0,0,1,1,0,1
2198,6844,Vasco,2,0,Goias,2,0,2,2,4,0,4
2199,6845,Cruzeiro,3,0,Avai,2,0,3,2,5,0,5
2200,6846,Internacional,2,0,Goias,4,0,2,4,6,0,6
2201,6847,Chapecoense,2,0,Botafogo-RJ,3,0,2,3,5,0,5
2202,6848,Bahia,1,0,Atletico-MG,1,0,1,1,2,0,2
2203,6849,Athletico-PR,3,0,Gremio,4,1,3,5,7,1,8
2204,6850,Flamengo,2,0,Ceara,1,1,2,2,3,1,4
2205,6851,Corinthians,0,0,Avai,1,0,0,1,1,0,1
2206,6852,Fluminense,3,0,Palmeiras,4,0,3,4,7,0,7
2207,6853,Fortaleza,2,0,Santos,8,2,2,10,10,2,12
2208,6854,Sao Paulo,4,0,Vasco,2,0,4,2,6,0,6
2209,6855,Cruzeiro,0,0,CSA,4,0,0,4,4,0,4
2210,6856,Botafogo-RJ,2,0,Internacional,3,0,2,3,5,0,5
2211,6857,Ceara,7,0,Athletico-PR,2,1,7,3,9,1,10
2212,6858,Avai,4,0,Fluminense,5,0,4,5,9,0,9
2213,6859,Palmeiras,1,0,Flamengo,2,0,1,2,3,0,3
2214,6860,Goias,1,0,Fortaleza,4,0,1,4,5,0,5
2215,6861,CSA,3,0,Bahia,4,1,3,5,7,1,8
2216,6862,Atletico-MG,3,0,Corinthians,1,0,3,1,4,0,4
2217,6863,Santos,3,0,Chapecoense,4,0,3,4,7,0,7
2218,6865,Vasco,3,0,Cruzeiro,3,0,3,3,6,0,6
2219,6866,Athletico-PR,2,0,Santos,4,1,2,5,6,1,7
2220,6867,Ceara,3,1,Corinthians,4,0,4,4,7,1,8
2221,6868,Atletico-MG,1,0,Botafogo-RJ,3,0,1,3,4,0,4
2222,6869,Chapecoense,1,0,CSA,2,1,1,3,3,1,4
2223,6870,Fluminense,2,1,Fortaleza,1,1,3,2,3,2,5
2224,6871,Sao Paulo,3,0,Internacional,4,0,3,4,7,0,7
2225,6872,Gremio,0,0,Cruzeiro,4,1,0,5,4,1,5
2226,6873,Palmeiras,5,0,Goias,1,0,5,1,6,0,6
2227,6874,Bahia,3,1,Vasco,2,1,4,3,5,2,7
2228,6875,Flamengo,0,0,Avai,1,0,0,1,1,0,1
2229,6876,Corinthians,1,0,Fluminense,3,0,1,3,4,0,4
2230,6877,Santos,2,0,Flamengo,3,0,2,3,5,0,5
2231,6878,Botafogo-RJ,0,0,Ceara,2,0,0,2,2,0,2
2232,6879,CSA,1,0,Sao Paulo,3,1,1,4,4,1,5
2233,6880,Internacional,4,0,Atletico-MG,1,0,4,1,5,0,5
2234,6881,Cruzeiro,0,0,Palmeiras,1,0,0,1,1,0,1
2235,6882,Goias,1,0,Gremio,1,0,1,1,2,0,2
2236,6883,Vasco,2,0,Chapecoense,3,0,2,3,5,0,5
2237,6884,Avai,2,0,Athletico-PR,1,0,2,1,3,0,3
2238,6885,Fortaleza,2,0,Bahia,1,0,2,1,3,0,3
2239,6886,Fortaleza,3,1,Athletico-PR,2,0,4,2,5,1,6
2240,6887,Coritiba,3,0,Internacional,4,0,3,4,7,0,7
2241,6888,Sport,3,0,Ceara,3,0,3,3,6,0,6
2242,6889,Santos,0,0,Bragantino,1,0,0,1,1,0,1
2243,6890,Flamengo,3,0,Atletico-MG,2,0,3,2,5,0,5
2244,6891,Gremio,2,0,Fluminense,3,0,2,3,5,0,5
2245,6892,Corinthians,2,0,Atletico-GO,0,0,2,0,2,0,2
2246,6893,Botafogo-RJ,2,1,Bahia,3,0,3,3,5,1,6
2247,6894,Goias,3,0,Sao Paulo,0,0,3,0,3,0,3
2248,6895,Palmeiras,1,0,Vasco,1,0,1,1,2,0,2
2249,6896,Athletico-PR,3,0,Goias,3,0,3,3,6,0,6
2250,6897,Atletico-MG,0,0,Corinthians,1,0,0,1,1,0,1
2251,6898,Bragantino,3,0,Botafogo-RJ,1,0,3,1,4,0,4
2252,6899,Bahia,0,0,Coritiba,5,0,0,5,5,0,5
2253,6900,Atletico-GO,1,0,Flamengo,1,1,1,2,2,1,3
2254,6901,Ceara,3,0,Gremio,1,0,3,1,4,0,4
2255,6902,Fluminense,3,0,Palmeiras,3,0,3,3,6,0,6
2256,6903,Sao Paulo,1,0,Fortaleza,2,0,1,2,3,0,3
2257,6904,Internacional,2,0,Santos,3,0,2,3,5,0,5
2258,6905,Vasco,2,0,Sport,3,1,2,4,5,1,6
2259,6906,Gremio,2,0,Corinthians,3,0,2,3,5,0,5
2260,6907,Coritiba,5,1,Flamengo,3,0,6,3,8,1,9
2261,6908,Palmeiras,1,0,Goias,3,0,1,3,4,0,4
2262,6909,Atletico-MG,2,0,Ceara,4,0,2,4,6,0,6
2263,6910,Bahia,1,0,Bragantino,1,0,1,1,2,0,2
2264,6911,Vasco,2,0,Sao Paulo,5,0,2,5,7,0,7
2265,6912,Fluminense,2,0,Internacional,2,0,2,2,4,0,4
2266,6913,Atletico-GO,1,1,Sport,2,0,2,2,3,1,4
2267,6914,Fortaleza,2,0,Botafogo-RJ,1,0,2,1,3,0,3
2268,6915,Santos,1,0,Athletico-PR,1,0,1,1,2,0,2
2269,6916,Flamengo,3,0,Gremio,3,0,3,3,6,0,6
2270,6917,Bragantino,5,0,Fluminense,5,0,5,5,10,0,10
2271,6918,Athletico-PR,5,0,Palmeiras,0,0,5,0,5,0,5
2272,6919,Goias,4,0,Fortaleza,2,0,4,2,6,0,6
2273,6920,Internacional,3,1,Atletico-GO,3,0,4,3,6,1,7
2274,6921,Corinthians,2,0,Coritiba,1,1,2,2,3,1,4
2275,6922,Botafogo-RJ,2,0,Atletico-MG,0,0,2,0,2,0,2
2276,6923,Sport,5,0,Santos,2,0,5,2,7,0,7
2277,6924,Ceara,3,0,Vasco,3,0,3,3,6,0,6
2278,6925,Sao Paulo,2,0,Bahia,2,0,2,2,4,0,4
2279,6926,Athletico-PR,4,0,Fluminense,3,0,4,3,7,0,7
2280,6927,Internacional,1,0,Atletico-MG,2,0,1,2,3,0,3
2281,6928,Goias,5,0,Atletico-GO,2,0,5,2,7,0,7
2282,6929,Flamengo,3,0,Botafogo-RJ,3,0,3,3,6,0,6
2283,6930,Vasco,5,0,Gremio,2,0,5,2,7,0,7
2284,6931,Palmeiras,5,0,Santos,3,1,5,4,8,1,9
2285,6932,Bragantino,2,1,Coritiba,0,0,3,0,2,1,3
2286,6933,Sport,2,0,Sao Paulo,3,0,2,3,5,0,5
2287,6934,Ceara,1,0,Bahia,2,0,1,2,3,0,3
2288,6935,Corinthians,0,0,Fortaleza,2,0,0,2,2,0,2
2289,6936,Sao Paulo,2,0,Athletico-PR,1,0,2,1,3,0,3
2290,6937,Corinthians,3,0,Bahia,2,0,3,2,5,0,5
2291,6938,Fortaleza,1,0,Internacional,3,0,1,3,4,0,4
2292,6939,Bragantino,4,0,Ceara,3,0,4,3,7,0,7
2293,6940,Atletico-GO,2,0,Atletico-MG,0,0,2,0,2,0,2
2294,6941,Gremio,2,0,Palmeiras,3,0,2,3,5,0,5
2295,6942,Coritiba,1,0,Vasco,2,0,1,2,3,0,3
2296,6943,Botafogo-RJ,4,0,Santos,2,0,4,2,6,0,6
2297,6944,Sport,0,0,Fluminense,1,0,0,1,1,0,1
2298,6945,Flamengo,1,0,Goias,4,0,1,4,5,0,5
2299,6946,Botafogo-RJ,3,0,Internacional,1,0,3,1,4,0,4
2300,6947,Fluminense,4,0,Vasco,1,1,4,2,5,1,6
2301,6948,Bahia,2,0,Palmeiras,2,0,2,2,4,0,4
2302,6949,Fortaleza,2,0,Bragantino,2,1,2,3,4,1,5
2303,6950,Sao Paulo,3,0,Corinthians,0,0,3,0,3,0,3
2304,6951,Coritiba,1,0,Sport,4,0,1,4,5,0,5
2305,6952,Santos,6,0,Flamengo,7,0,6,7,13,0,13
2306,6953,Atletico-GO,1,1,Ceara,2,0,2,2,3,1,4
2307,6954,Atletico-MG,1,0,Athletico-PR,2,0,1,2,3,0,3
2308,6955,Gremio,2,0,Goias,2,0,2,2,4,0,4
2309,6956,Ceara,2,0,Fortaleza,2,0,2,2,4,0,4
2310,6957,Fluminense,3,1,Atletico-GO,1,0,4,1,4,1,5
2311,6958,Goias,1,0,Corinthians,3,0,1,3,4,0,4
2312,6959,Botafogo-RJ,1,0,Coritiba,1,0,1,1,2,0,2
2313,6960,Athletico-PR,2,0,Bragantino,2,0,2,2,4,0,4
2314,6961,Bahia,1,0,Flamengo,2,0,1,2,3,0,3
2315,6962,Palmeiras,3,0,Internacional,5,0,3,5,8,0,8
2316,6963,Santos,2,0,Vasco,3,0,2,3,5,0,5
2317,6964,Gremio,1,0,Sport,5,0,1,5,6,0,6
2318,6966,Flamengo,1,0,Fortaleza,1,0,1,1,2,0,2
2319,6967,Corinthians,3,0,Botafogo-RJ,1,0,3,1,4,0,4
2320,6968,Ceara,3,2,Santos,4,2,5,6,7,4,11
2321,6969,Bragantino,1,1,Palmeiras,3,0,2,3,4,1,5
2322,6970,Internacional,2,0,Bahia,3,0,2,3,5,0,5
2323,6971,Sao Paulo,3,0,Fluminense,0,0,3,0,3,0,3
2324,6972,Vasco,1,0,Athletico-PR,1,0,1,1,2,0,2
2325,6973,Atletico-GO,1,0,Gremio,3,1,1,4,4,1,5
2326,6974,Sport,1,0,Goias,0,0,1,0,1,0,1
2327,6975,Coritiba,1,0,Atletico-MG,3,0,1,3,4,0,4
2328,6976,Athletico-PR,1,0,Botafogo-RJ,0,0,1,0,1,0,1
2329,6977,Fortaleza,5,0,Sport,1,0,5,1,6,0,6
2330,6978,Goias,5,1,Coritiba,2,1,6,3,7,2,9
2331,6979,Sao Paulo,4,0,Bragantino,2,0,4,2,6,0,6
2332,6980,Fluminense,1,0,Flamengo,1,0,1,1,2,0,2
2333,6981,Santos,1,0,Atletico-MG,2,1,1,3,3,1,4
2334,6982,Internacional,0,0,Ceara,2,0,0,2,2,0,2
2335,6983,Corinthians,3,2,Palmeiras,2,0,5,2,5,2,7
2336,6984,Bahia,1,1,Gremio,3,1,2,4,4,2,6
2337,6985,Vasco,2,1,Atletico-GO,1,0,3,1,3,1,4
2338,6986,Athletico-PR,4,0,Coritiba,1,1,4,2,5,1,6
2339,6987,Santos,3,0,Sao Paulo,2,0,3,2,5,0,5
2340,6988,Fluminense,2,1,Corinthians,4,0,3,4,6,1,7
2341,6989,Gremio,1,1,Fortaleza,2,1,2,3,3,2,5
2342,6990,Atletico-MG,1,0,Bragantino,1,0,1,1,2,0,2
2343,6991,Bahia,2,1,Atletico-GO,2,0,3,2,4,1,5
2344,6992,Ceara,1,0,Flamengo,0,0,1,0,1,0,1
2345,6993,Goias,4,1,Internacional,3,0,5,3,7,1,8
2346,6994,Palmeiras,2,1,Sport,3,1,3,4,5,2,7
2347,6995,Botafogo-RJ,2,0,Vasco,2,0,2,2,4,0,4
2348,6996,Sport,3,0,Corinthians,4,0,3,4,7,0,7
2349,6997,Athletico-PR,4,0,Bahia,1,0,4,1,5,0,5
2350,6998,Internacional,2,1,Sao Paulo,0,0,3,0,2,1,3
2351,6999,Atletico-MG,1,0,Gremio,1,0,1,1,2,0,2
2352,7000,Vasco,2,0,Bragantino,1,0,2,1,3,0,3
2353,7001,Palmeiras,4,0,Flamengo,2,0,4,2,6,0,6
2354,7002,Ceara,3,0,Goias,4,0,3,4,7,0,7
2355,7003,Atletico-GO,2,0,Botafogo-RJ,3,0,2,3,5,0,5
2356,7004,Santos,1,0,Fortaleza,1,0,1,1,2,0,2
2357,7005,Fluminense,1,0,Coritiba,1,1,1,2,2,1,3
2358,7006,Gremio,1,1,Internacional,1,1,2,2,2,2,4
2359,7007,Palmeiras,1,0,Ceara,4,0,1,4,5,0,5
2360,7008,Bragantino,1,0,Corinthians,2,0,1,2,3,0,3
2361,7009,Botafogo-RJ,0,0,Fluminense,1,0,0,1,1,0,1
2362,7010,Coritiba,2,0,Sao Paulo,3,0,2,3,5,0,5
2363,7011,Flamengo,3,0,Athletico-PR,4,0,3,4,7,0,7
2364,7012,Fortaleza,5,0,Atletico-GO,5,0,5,5,10,0,10
2365,7013,Goias,4,1,Santos,3,1,5,4,7,2,9
2366,7014,Bahia,2,0,Sport,3,0,2,3,5,0,5
2367,7015,Atletico-MG,3,0,Vasco,3,1,3,4,6,1,7
2368,7016,Corinthians,2,0,Santos,2,0,2,2,4,0,4
2369,7017,Flamengo,0,0,Sport,3,0,0,3,3,0,3
2370,7018,Bahia,4,0,Vasco,3,1,4,4,7,1,8
2371,7019,Gremio,2,0,Coritiba,2,0,2,2,4,0,4
2372,7020,Sao Paulo,3,0,Atletico-GO,2,0,3,2,5,0,5
2373,7021,Goias,3,0,Fluminense,2,0,3,2,5,0,5
2374,7022,Botafogo-RJ,4,0,Palmeiras,4,0,4,4,8,0,8
2375,7023,Fortaleza,3,1,Atletico-MG,3,0,4,3,6,1,7
2376,7024,Athletico-PR,3,0,Ceara,2,0,3,2,5,0,5
2377,7025,Bragantino,3,1,Internacional,3,0,4,3,6,1,7
2378,7026,Vasco,2,0,Flamengo,5,0,2,5,7,0,7
2379,7027,Coritiba,1,0,Fortaleza,0,0,1,0,1,0,1
2380,7028,Palmeiras,2,0,Sao Paulo,1,0,2,1,3,0,3
2381,7029,Atletico-MG,0,0,Goias,1,0,0,1,1,0,1
2382,7030,Fluminense,2,0,Bahia,3,0,2,3,5,0,5
2383,7031,Santos,2,0,Gremio,3,1,2,4,5,1,6
2384,7032,Sport,3,0,Botafogo-RJ,2,1,3,3,5,1,6
2385,7033,Atletico-GO,1,0,Bragantino,1,0,1,1,2,0,2
2386,7034,Ceara,4,1,Corinthians,1,1,5,2,5,2,7
2387,7035,Internacional,2,0,Athletico-PR,0,0,2,0,2,0,2
2388,7036,Palmeiras,3,0,Coritiba,2,0,3,2,5,0,5
2389,7037,Gremio,3,1,Botafogo-RJ,2,0,4,2,5,1,6
2390,7038,Santos,3,0,Atletico-GO,3,0,3,3,6,0,6
2391,7039,Athletico-PR,3,0,Corinthians,3,1,3,4,6,1,7
2392,7040,Atletico-MG,3,0,Fluminense,1,0,3,1,4,0,4
2393,7041,Sport,3,0,Internacional,2,0,3,2,5,0,5
2394,7042,Flamengo,2,0,Bragantino,1,0,2,1,3,0,3
2395,7043,Goias,5,0,Bahia,4,2,5,6,9,2,11
2396,7044,Vasco,2,0,Fortaleza,0,0,2,0,2,0,2
2397,7045,Ceara,5,0,Sao Paulo,3,0,5,3,8,0,8
2398,7046,Atletico-GO,3,2,Athletico-PR,5,0,5,5,8,2,10
2399,7047,Coritiba,5,0,Santos,2,0,5,2,7,0,7
2400,7048,Fluminense,3,0,Ceara,3,0,3,3,6,0,6
2401,7049,Sao Paulo,4,0,Gremio,2,0,4,2,6,0,6
2402,7050,Corinthians,4,0,Flamengo,5,0,4,5,9,0,9
2403,7051,Internacional,1,0,Vasco,1,0,1,1,2,0,2
2404,7052,Bragantino,2,0,Sport,2,0,2,2,4,0,4
2405,7053,Fortaleza,2,0,Palmeiras,3,1,2,4,5,1,6
2406,7054,Bahia,4,0,Atletico-MG,1,0,4,1,5,0,5
2407,7055,Botafogo-RJ,2,0,Goias,1,0,2,1,3,0,3
2408,7056,Vasco,1,0,Corinthians,2,0,1,2,3,0,3
2409,7057,Bragantino,0,0,Goias,3,0,0,3,3,0,3
2410,7058,Ceara,3,0,Coritiba,1,0,3,1,4,0,4
2411,7059,Atletico-MG,1,0,Sport,0,0,1,0,1,0,1
2412,7060,Atletico-GO,1,0,Palmeiras,4,0,1,4,5,0,5
2413,7061,Fluminense,5,0,Santos,4,0,5,4,9,0,9
2414,7062,Athletico-PR,3,0,Gremio,1,0,3,1,4,0,4
2415,7063,Internacional,6,0,Flamengo,5,0,6,5,11,0,11
2416,7064,Bahia,3,0,Fortaleza,3,0,3,3,6,0,6
2417,7065,Sao Paulo,0,0,Botafogo-RJ,2,1,0,3,2,1,3
2418,7066,Botafogo-RJ,4,1,Ceara,5,1,5,6,9,2,11
2419,7067,Coritiba,2,0,Atletico-GO,5,0,2,5,7,0,7
2420,7068,Corinthians,4,0,Internacional,3,1,4,4,7,1,8
2421,7069,Fortaleza,2,1,Fluminense,1,0,3,1,3,1,4
2422,7070,Flamengo,4,0,Sao Paulo,3,0,4,3,7,0,7
2423,7071,Sport,2,1,Athletico-PR,1,0,3,1,3,1,4
2424,7072,Santos,4,0,Bahia,2,0,4,2,6,0,6
2425,7073,Goias,5,0,Vasco,7,0,5,7,12,0,12
2426,7074,Palmeiras,2,0,Atletico-MG,1,0,2,1,3,0,3
2427,7075,Gremio,1,0,Bragantino,1,0,1,1,2,0,2
2428,7076,Athletico-PR,3,0,Fortaleza,2,0,3,2,5,0,5
2429,7077,Sao Paulo,2,0,Goias,1,1,2,2,3,1,4
2430,7078,Atletico-GO,3,0,Corinthians,4,0,3,4,7,0,7
2431,7079,Vasco,1,0,Palmeiras,3,0,1,3,4,0,4
2432,7080,Internacional,2,1,Coritiba,3,0,3,3,5,1,6
2433,7081,Bragantino,1,0,Santos,4,0,1,4,5,0,5
2434,7082,Atletico-MG,5,0,Flamengo,4,0,5,4,9,0,9
2435,7083,Bahia,2,0,Botafogo-RJ,3,0,2,3,5,0,5
2436,7084,Fluminense,0,0,Gremio,1,0,0,1,1,0,1
2437,7085,Ceara,0,0,Sport,3,0,0,3,3,0,3
2438,7086,Sport,0,0,Vasco,2,0,0,2,2,0,2
2439,7087,Santos,1,0,Internacional,2,0,1,2,3,0,3
2440,7088,Goias,5,0,Athletico-PR,1,0,5,1,6,0,6
2441,7089,Corinthians,3,0,Atletico-MG,5,0,3,5,8,0,8
2442,7090,Fortaleza,2,0,Sao Paulo,4,0,2,4,6,0,6
2443,7091,Gremio,1,0,Ceara,2,0,1,2,3,0,3
2444,7092,Palmeiras,2,0,Fluminense,2,0,2,2,4,0,4
2445,7093,Flamengo,2,0,Atletico-GO,1,0,2,1,3,0,3
2446,7094,Coritiba,3,0,Bahia,4,0,3,4,7,0,7
2447,7095,Botafogo-RJ,0,0,Bragantino,3,0,0,3,3,0,3
2448,7096,Bragantino,2,0,Bahia,4,0,2,4,6,0,6
2449,7097,Athletico-PR,0,0,Santos,2,0,0,2,2,0,2
2450,7098,Flamengo,1,0,Coritiba,3,0,1,3,4,0,4
2451,7099,Goias,2,0,Palmeiras,2,1,2,3,4,1,5
2452,7100,Sao Paulo,2,0,Vasco,4,0,2,4,6,0,6
2453,7101,Ceara,4,0,Atletico-MG,1,1,4,2,5,1,6
2454,7102,Internacional,2,0,Fluminense,4,0,2,4,6,0,6
2455,7103,Botafogo-RJ,1,0,Fortaleza,1,0,1,1,2,0,2
2456,7104,Corinthians,2,2,Gremio,1,0,4,1,3,2,5
2457,7105,Sport,1,0,Atletico-GO,3,0,1,3,4,0,4
2458,7106,Atletico-MG,2,0,Botafogo-RJ,4,0,2,4,6,0,6
2459,7107,Coritiba,2,0,Corinthians,2,0,2,2,4,0,4
2460,7108,Fortaleza,2,0,Goias,0,0,2,0,2,0,2
2461,7109,Palmeiras,2,0,Athletico-PR,1,0,2,1,3,0,3
2462,7110,Santos,3,0,Sport,3,0,3,3,6,0,6
2463,7111,Bahia,0,0,Sao Paulo,2,0,0,2,2,0,2
2464,7112,Atletico-GO,1,0,Internacional,3,1,1,4,4,1,5
2465,7113,Vasco,3,0,Ceara,2,0,3,2,5,0,5
2466,7114,Fluminense,2,0,Bragantino,3,0,2,3,5,0,5
2467,7115,Gremio,5,0,Flamengo,3,0,5,3,8,0,8
2468,7116,Fortaleza,2,1,Corinthians,2,1,3,3,4,2,6
2469,7117,Santos,3,0,Palmeiras,3,1,3,4,6,1,7
2470,7118,Botafogo-RJ,1,1,Flamengo,1,1,2,2,2,2,4
2471,7119,Fluminense,4,0,Athletico-PR,3,1,4,4,7,1,8
2472,7120,Bahia,2,0,Ceara,2,0,2,2,4,0,4
2473,7121,Coritiba,4,0,Bragantino,3,0,4,3,7,0,7
2474,7122,Sao Paulo,4,0,Sport,4,0,4,4,8,0,8
2475,7123,Gremio,2,0,Vasco,1,0,2,1,3,0,3
2476,7124,Atletico-MG,2,0,Internacional,6,0,2,6,8,0,8
2477,7125,Atletico-GO,3,0,Goias,3,0,3,3,6,0,6
2478,7126,Athletico-PR,2,0,Atletico-MG,2,0,2,2,4,0,4
2479,7127,Bragantino,3,0,Fortaleza,2,0,3,2,5,0,5
2480,7128,Internacional,4,0,Botafogo-RJ,5,0,4,5,9,0,9
2481,7129,Palmeiras,2,0,Bahia,3,0,2,3,5,0,5
2482,7130,Goias,4,0,Gremio,1,0,4,1,5,0,5
2483,7131,Ceara,0,0,Atletico-GO,3,0,0,3,3,0,3
2484,7132,Flamengo,2,0,Santos,1,0,2,1,3,0,3
2485,7133,Corinthians,0,0,Sao Paulo,1,0,0,1,1,0,1
2486,7134,Sport,0,0,Coritiba,1,0,0,1,1,0,1
2487,7135,Vasco,6,0,Fluminense,2,0,6,2,8,0,8
2488,7136,Sao Paulo,2,0,Atletico-MG,3,1,2,4,5,1,6
2489,7137,Atletico-GO,3,0,Fluminense,4,0,3,4,7,0,7
2490,7138,Sport,2,0,Gremio,2,1,2,3,4,1,5
2491,7139,Internacional,4,0,Palmeiras,2,0,4,2,6,0,6
2492,7140,Coritiba,3,0,Botafogo-RJ,1,0,3,1,4,0,4
2493,7141,Bragantino,2,0,Athletico-PR,5,0,2,5,7,0,7
2494,7142,Vasco,2,0,Santos,0,0,2,0,2,0,2
2495,7143,Flamengo,1,1,Bahia,3,1,2,4,4,2,6
2496,7144,Fortaleza,1,1,Ceara,1,0,2,1,2,1,3
2497,7145,Corinthians,1,0,Goias,0,0,1,0,1,0,1
2498,7147,Goias,4,0,Sport,1,0,4,1,5,0,5
2499,7148,Fortaleza,3,0,Flamengo,3,0,3,3,6,0,6
2500,7149,Fluminense,3,0,Sao Paulo,1,0,3,1,4,0,4
2501,7150,Botafogo-RJ,1,0,Corinthians,1,0,1,1,2,0,2
2502,7151,Bahia,3,0,Internacional,1,0,3,1,4,0,4
2503,7152,Athletico-PR,0,0,Vasco,1,0,0,1,1,0,1
2504,7153,Palmeiras,3,0,Bragantino,0,0,3,0,3,0,3
2505,7154,Santos,2,0,Ceara,3,0,2,3,5,0,5
2506,7155,Gremio,2,0,Atletico-GO,3,0,2,3,5,0,5
2507,7156,Gremio,2,0,Bahia,4,0,2,4,6,0,6
2508,7157,Botafogo-RJ,3,0,Athletico-PR,2,0,3,2,5,0,5
2509,7158,Coritiba,4,0,Goias,3,0,4,3,7,0,7
2510,7159,Sport,3,0,Fortaleza,1,0,3,1,4,0,4
2511,7160,Flamengo,1,0,Fluminense,4,0,1,4,5,0,5
2512,7161,Bragantino,2,0,Sao Paulo,2,1,2,3,4,1,5
2513,7162,Ceara,6,0,Internacional,4,0,6,4,10,0,10
2514,7163,Atletico-GO,3,0,Vasco,2,0,3,2,5,0,5
2515,7164,Palmeiras,2,0,Corinthians,3,1,2,4,5,1,6
2516,7165,Atletico-MG,1,0,Santos,1,0,1,1,2,0,2
2517,7166,Sport,5,0,Palmeiras,3,0,5,3,8,0,8
2518,7167,Coritiba,2,0,Athletico-PR,1,0,2,1,3,0,3
2519,7168,Fortaleza,4,0,Gremio,2,0,4,2,6,0,6
2520,7169,Sao Paulo,2,0,Santos,4,0,2,4,6,0,6
2521,7170,Flamengo,3,0,Ceara,1,0,3,1,4,0,4
2522,7171,Atletico-GO,2,0,Bahia,0,0,2,0,2,0,2
2523,7172,Internacional,0,0,Goias,2,0,0,2,2,0,2
2524,7173,Vasco,1,0,Botafogo-RJ,0,0,1,0,1,0,1
2525,7174,Bragantino,4,0,Atletico-MG,0,0,4,0,4,0,4
2526,7175,Corinthians,1,0,Fluminense,2,0,1,2,3,0,3
2527,7176,Palmeiras,3,0,Gremio,1,0,3,1,4,0,4
2528,7177,Fluminense,1,0,Sport,1,1,1,2,2,1,3
2529,7178,Vasco,2,1,Coritiba,2,0,3,2,4,1,5
2530,7179,Athletico-PR,2,0,Sao Paulo,1,0,2,1,3,0,3
2531,7180,Santos,2,0,Botafogo-RJ,1,0,2,1,3,0,3
2532,7181,Atletico-MG,2,0,Atletico-GO,3,0,2,3,5,0,5
2533,7182,Ceara,1,0,Bragantino,2,0,1,2,3,0,3
2534,7183,Internacional,0,0,Fortaleza,3,0,0,3,3,0,3
2535,7184,Goias,5,0,Flamengo,1,0,5,1,6,0,6
2536,7185,Bahia,3,0,Corinthians,1,0,3,1,4,0,4
2537,7186,Botafogo-RJ,2,0,Atletico-GO,3,0,2,3,5,0,5
2538,7187,Bahia,2,0,Athletico-PR,0,0,2,0,2,0,2
2539,7188,Gremio,1,0,Atletico-MG,1,0,1,1,2,0,2
2540,7189,Coritiba,1,1,Fluminense,4,1,2,5,5,2,7
2541,7190,Sao Paulo,2,0,Internacional,1,0,2,1,3,0,3
2542,7192,Flamengo,2,0,Palmeiras,2,0,2,2,4,0,4
2543,7193,Fortaleza,3,0,Santos,0,0,3,0,3,0,3
2544,7194,Goias,1,0,Ceara,0,0,1,0,1,0,1
2545,7195,Corinthians,1,0,Sport,0,0,1,0,1,0,1
2546,7196,Sao Paulo,1,0,Coritiba,2,0,1,2,3,0,3
2547,7197,Vasco,4,0,Atletico-MG,1,0,4,1,5,0,5
2548,7198,Internacional,2,0,Gremio,2,0,2,2,4,0,4
2549,7199,Athletico-PR,2,0,Flamengo,0,0,2,0,2,0,2
2550,7200,Ceara,3,1,Palmeiras,5,0,4,5,8,1,9
2551,7201,Atletico-GO,2,0,Fortaleza,2,1,2,3,4,1,5
2552,7202,Sport,3,0,Bahia,0,0,3,0,3,0,3
2553,7203,Santos,4,0,Goias,4,0,4,4,8,0,8
2554,7204,Fluminense,2,0,Botafogo-RJ,1,0,2,1,3,0,3
2555,7205,Corinthians,5,0,Bragantino,4,0,5,4,9,0,9
2556,7206,Vasco,1,1,Bahia,3,0,2,3,4,1,5
2557,7207,Ceara,0,0,Athletico-PR,2,0,0,2,2,0,2
2558,7208,Atletico-GO,3,0,Sao Paulo,1,0,3,1,4,0,4
2559,7209,Coritiba,3,0,Gremio,3,0,3,3,6,0,6
2560,7210,Atletico-MG,0,0,Fortaleza,1,0,0,1,1,0,1
2561,7211,Internacional,3,0,Bragantino,0,0,3,0,3,0,3
2562,7212,Fluminense,1,0,Goias,2,0,1,2,3,0,3
2563,7213,Sport,2,0,Flamengo,2,0,2,2,4,0,4
2564,7214,Palmeiras,2,0,Botafogo-RJ,1,0,2,1,3,0,3
2565,7216,Gremio,5,0,Santos,2,1,5,3,7,1,8
2566,7217,Bragantino,3,0,Atletico-GO,3,0,3,3,6,0,6
2567,7219,Goias,3,0,Atletico-MG,3,0,3,3,6,0,6
2568,7220,Bahia,1,0,Fluminense,1,0,1,1,2,0,2
2569,7221,Fortaleza,2,0,Coritiba,5,2,2,7,7,2,9
2570,7222,Flamengo,1,0,Vasco,3,0,1,3,4,0,4
2571,7223,Athletico-PR,3,0,Internacional,2,0,3,2,5,0,5
2572,7224,Botafogo-RJ,1,0,Sport,3,0,1,3,4,0,4
2573,7225,Sao Paulo,2,0,Palmeiras,1,0,2,1,3,0,3
2574,7226,Bahia,3,1,Goias,4,0,4,4,7,1,8
2575,7227,Atletico-GO,2,1,Santos,2,0,3,2,4,1,5
2576,7228,Bragantino,4,0,Flamengo,2,0,4,2,6,0,6
2577,7230,Internacional,2,2,Sport,3,0,4,3,5,2,7
2578,7231,Fortaleza,2,0,Vasco,3,0,2,3,5,0,5
2579,7232,Sao Paulo,4,0,Ceara,4,0,4,4,8,0,8
2580,7233,Fluminense,0,0,Atletico-MG,1,0,0,1,1,0,1
2581,7234,Corinthians,3,0,Athletico-PR,0,0,3,0,3,0,3
2582,7235,Coritiba,2,0,Palmeiras,3,1,2,4,5,1,6
2583,7236,Goias,4,0,Botafogo-RJ,3,1,4,4,7,1,8
2584,7237,Atletico-MG,1,0,Bahia,1,0,1,1,2,0,2
2585,7238,Santos,0,0,Coritiba,4,0,0,4,4,0,4
2586,7239,Flamengo,1,0,Corinthians,5,0,1,5,6,0,6
2587,7240,Vasco,1,0,Internacional,6,0,1,6,7,0,7
2588,7241,Athletico-PR,3,0,Atletico-GO,1,0,3,1,4,0,4
2589,7242,Palmeiras,0,0,Fortaleza,3,0,0,3,3,0,3
2590,7243,Gremio,5,1,Sao Paulo,4,0,6,4,9,1,10
2591,7244,Ceara,1,0,Fluminense,1,0,1,1,2,0,2
2592,7245,Sport,3,0,Bragantino,0,0,3,0,3,0,3
2593,7246,Coritiba,1,0,Ceara,0,0,1,0,1,0,1
2594,7247,Fortaleza,4,1,Bahia,3,0,5,3,7,1,8
2595,7248,Sport,4,0,Atletico-MG,4,0,4,4,8,0,8
2596,7249,Corinthians,1,0,Vasco,2,0,1,2,3,0,3
2597,7250,Flamengo,4,0,Internacional,0,1,4,1,4,1,5
2598,7251,Santos,3,0,Fluminense,4,1,3,5,7,1,8
2599,7252,Gremio,3,0,Athletico-PR,1,2,3,3,4,2,6
2600,7253,Goias,2,0,Bragantino,0,0,2,0,2,0,2
2601,7254,Palmeiras,2,0,Atletico-GO,1,0,2,1,3,0,3
2602,7255,Botafogo-RJ,3,0,Sao Paulo,5,1,3,6,8,1,9
2603,7256,Bragantino,4,0,Gremio,0,0,4,0,4,0,4
2604,7258,Athletico-PR,0,0,Sport,1,0,0,1,1,0,1
2605,7259,Atletico-GO,0,0,Coritiba,1,0,0,1,1,0,1
2606,7260,Internacional,0,0,Corinthians,2,0,0,2,2,0,2
2607,7261,Ceara,3,1,Botafogo-RJ,0,0,4,0,3,1,4
2608,7262,Sao Paulo,6,0,Flamengo,3,0,6,3,9,0,9
2609,7263,Atletico-MG,3,0,Palmeiras,0,0,3,0,3,0,3
2610,7264,Vasco,1,0,Goias,2,0,1,2,3,0,3
2611,7266,Cuiaba,1,0,Juventude,3,0,1,3,4,0,4
2612,7267,Bahia,3,0,Santos,3,0,3,3,6,0,6
2613,7268,Sao Paulo,1,0,Fluminense,2,0,1,2,3,0,3
2614,7269,Atletico-MG,2,0,Fortaleza,4,0,2,4,6,0,6
2615,7270,Flamengo,2,0,Palmeiras,3,0,2,3,5,0,5
2616,7271,Ceara,3,0,Gremio,3,0,3,3,6,0,6
2617,7272,Corinthians,5,0,Atletico-GO,3,0,5,3,8,0,8
2618,7273,Chapecoense,1,0,Bragantino,0,0,1,0,1,0,1
2619,7274,Athletico-PR,1,0,America-MG,2,0,1,2,3,0,3
2620,7275,Internacional,4,0,Sport,2,0,4,2,6,0,6
2621,7276,Atletico-GO,4,0,Sao Paulo,5,0,4,5,9,0,9
2622,7277,Santos,3,0,Ceara,1,0,3,1,4,0,4
2623,7278,Bragantino,2,0,Bahia,4,0,2,4,6,0,6
2624,7279,Fluminense,2,0,Cuiaba,1,0,2,1,3,0,3
2625,7280,America-MG,2,0,Corinthians,3,0,2,3,5,0,5
2626,7281,Fortaleza,1,0,Internacional,4,2,1,6,5,2,7
2627,7282,Juventude,0,0,Athletico-PR,2,0,0,2,2,0,2
2628,7283,Palmeiras,2,0,Chapecoense,0,0,2,0,2,0,2
2629,7284,Sport,3,0,Atletico-MG,2,0,3,2,5,0,5
2630,7285,Gremio,3,2,Flamengo,2,0,5,2,5,2,7
2631,7286,Santos,2,0,Juventude,3,0,2,3,5,0,5
2632,7287,Palmeiras,3,0,Corinthians,0,0,3,0,3,0,3
2633,7288,Atletico-MG,0,0,Sao Paulo,1,0,0,1,1,0,1
2634,7289,Gremio,5,0,Athletico-PR,4,0,5,4,9,0,9
2635,7291,Bahia,4,0,Internacional,4,1,4,5,8,1,9
2636,7292,Fortaleza,3,0,Sport,3,1,3,4,6,1,7
2637,7293,Bragantino,3,0,Fluminense,1,0,3,1,4,0,4
2638,7294,Chapecoense,2,0,Ceara,2,0,2,2,4,0,4
2639,7295,Cuiaba,5,0,Atletico-GO,4,1,5,5,9,1,10
2640,7296,Internacional,3,0,Atletico-MG,1,0,3,1,4,0,4
2641,7297,Sao Paulo,3,1,Chapecoense,2,0,4,2,5,1,6
2642,7298,Corinthians,2,0,Bragantino,0,0,2,0,2,0,2
2643,7299,Juventude,0,0,Palmeiras,3,0,0,3,3,0,3
2644,7300,America-MG,1,0,Cuiaba,1,0,1,1,2,0,2
2645,7301,Ceara,3,0,Bahia,5,0,3,5,8,0,8
2646,7302,Sport,5,0,Gremio,4,0,5,4,9,0,9
2647,7303,Atletico-GO,3,0,Fortaleza,1,0,3,1,4,0,4
2648,7304,Fluminense,4,0,Santos,3,0,4,3,7,0,7
2649,7305,Athletico-PR,4,0,Flamengo,2,0,4,2,6,0,6
2650,7306,Flamengo,2,0,Bragantino,3,0,2,3,5,0,5
2651,7307,Palmeiras,3,0,America-MG,4,0,3,4,7,0,7
2652,7308,Bahia,1,0,Corinthians,3,0,1,3,4,0,4
2653,7309,Internacional,2,0,Ceara,3,0,2,3,5,0,5
2654,7310,Fortaleza,3,0,Fluminense,0,0,3,0,3,0,3
2655,7311,Athletico-PR,2,0,Atletico-GO,2,0,2,2,4,0,4
2656,7312,Santos,2,0,Sao Paulo,4,0,2,4,6,0,6
2657,7313,Juventude,4,0,Sport,0,0,4,0,4,0,4
2658,7314,Atletico-MG,1,0,Chapecoense,1,0,1,1,2,0,2
2659,7315,Cuiaba,1,0,Gremio,5,0,1,5,6,0,6
2660,7316,Atletico-GO,3,0,Fluminense,3,0,3,3,6,0,6
2661,7317,Sao Paulo,1,0,Cuiaba,1,0,1,1,2,0,2
2662,7318,Flamengo,1,0,Fortaleza,1,0,1,1,2,0,2
2663,7319,Bragantino,3,0,Palmeiras,3,0,3,3,6,0,6
2664,7320,America-MG,2,1,Juventude,2,0,3,2,4,1,5
2665,7321,Chapecoense,2,1,Internacional,3,2,3,5,5,3,8
2666,7322,Corinthians,0,0,Sport,3,0,0,3,3,0,3
2667,7323,Ceara,3,0,Atletico-MG,4,0,3,4,7,0,7
2668,7324,Bahia,2,0,Athletico-PR,1,2,2,3,3,2,5
2669,7325,Gremio,2,0,Santos,3,0,2,3,5,0,5
2670,7326,Juventude,2,0,Flamengo,1,0,2,1,3,0,3
2671,7327,Fluminense,3,1,Corinthians,1,0,4,1,4,1,5
2672,7328,Palmeiras,3,0,Bahia,4,0,3,4,7,0,7
2673,7329,Athletico-PR,1,0,Chapecoense,1,0,1,1,2,0,2
2674,7330,Gremio,2,1,Fortaleza,4,0,3,4,6,1,7
2675,7331,Santos,4,0,Atletico-MG,3,1,4,4,7,1,8
2676,7332,America-MG,2,0,Internacional,3,0,2,3,5,0,5
2677,7333,Sport,0,0,Cuiaba,1,0,0,1,1,0,1
2678,7334,Ceara,4,0,Sao Paulo,6,0,4,6,10,0,10
2679,7335,Atletico-GO,2,0,Bragantino,2,0,2,2,4,0,4
2680,7336,Fluminense,1,0,Athletico-PR,2,0,1,2,3,0,3
2681,7337,Fortaleza,3,1,Chapecoense,3,0,4,3,6,1,7
2682,7338,Internacional,3,0,Palmeiras,2,1,3,3,5,1,6
2683,7339,Bahia,4,0,America-MG,0,0,4,0,4,0,4
2684,7340,Santos,1,0,Sport,4,0,1,4,5,0,5
2685,7341,Corinthians,1,0,Sao Paulo,1,0,1,1,2,0,2
2686,7342,Juventude,3,0,Gremio,0,0,3,0,3,0,3
2687,7343,Bragantino,1,0,Ceara,3,1,1,4,4,1,5
2688,7344,Atletico-MG,0,0,Atletico-GO,2,0,0,2,2,0,2
2689,7345,Cuiaba,3,0,Flamengo,5,0,3,5,8,0,8
2690,7346,Athletico-PR,3,0,Fortaleza,3,0,3,3,6,0,6
2691,7347,America-MG,4,0,Santos,3,0,4,3,7,0,7
2692,7348,Corinthians,2,0,Internacional,2,0,2,2,4,0,4
2693,7349,Chapecoense,2,0,Bahia,1,0,2,1,3,0,3
2694,7350,Flamengo,2,0,Fluminense,1,0,2,1,3,0,3
2695,7351,Sport,2,0,Palmeiras,1,0,2,1,3,0,3
2696,7352,Ceara,2,0,Juventude,2,1,2,3,4,1,5
2697,7353,Sao Paulo,1,0,Bragantino,2,0,1,2,3,0,3
2698,7354,Cuiaba,5,0,Atletico-MG,2,0,5,2,7,0,7
2699,7355,Gremio,3,0,Atletico-GO,0,0,3,0,3,0,3
2700,7356,Santos,2,0,Athletico-PR,2,0,2,2,4,0,4
2701,7357,Bahia,2,0,Juventude,3,0,2,3,5,0,5
2702,7358,Bragantino,3,0,Cuiaba,2,0,3,2,5,0,5
2703,7359,Fortaleza,2,0,America-MG,1,0,2,1,3,0,3
2704,7360,Palmeiras,2,0,Gremio,2,0,2,2,4,0,4
2705,7361,Atletico-MG,1,0,Flamengo,1,0,1,1,2,0,2
2706,7362,Atletico-GO,4,0,Sport,1,0,4,1,5,0,5
2707,7363,Internacional,2,0,Sao Paulo,3,0,2,3,5,0,5
2708,7364,Fluminense,2,0,Ceara,3,0,2,3,5,0,5
2709,7365,Chapecoense,3,0,Corinthians,0,0,3,0,3,0,3
2710,7366,Palmeiras,1,0,Santos,6,0,1,6,7,0,7
2711,7367,Gremio,1,0,Internacional,2,0,1,2,3,0,3
2712,7368,Athletico-PR,0,0,Bragantino,4,0,0,4,4,0,4
2713,7369,Sport,1,0,Fluminense,3,0,1,3,4,0,4
2714,7370,Sao Paulo,0,0,Bahia,1,0,0,1,1,0,1
2715,7371,America-MG,1,0,Atletico-MG,1,0,1,1,2,0,2
2716,7372,Juventude,2,0,Atletico-GO,2,0,2,2,4,0,4
2717,7373,Cuiaba,1,1,Ceara,2,0,2,2,3,1,4
2718,7374,Flamengo,3,0,Chapecoense,3,0,3,3,6,0,6
2719,7375,Fortaleza,4,0,Corinthians,3,0,4,3,7,0,7
2720,7376,Ceara,4,0,Athletico-PR,3,0,4,3,7,0,7
2721,7377,Sao Paulo,3,0,Fortaleza,2,0,3,2,5,0,5
2722,7378,Corinthians,0,0,Atletico-MG,2,0,0,2,2,0,2
2723,7379,Fluminense,1,0,Gremio,4,0,1,4,5,0,5
2724,7380,Chapecoense,2,0,Cuiaba,2,0,2,2,4,0,4
2725,7381,Atletico-GO,2,0,Palmeiras,1,0,2,1,3,0,3
2726,7382,Bahia,5,0,Flamengo,1,0,5,1,6,0,6
2727,7383,Internacional,4,0,Juventude,4,1,4,5,8,1,9
2728,7384,Bragantino,3,0,Santos,6,0,3,6,9,0,9
2729,7385,America-MG,1,0,Sport,3,0,1,3,4,0,4
2730,7386,Gremio,3,0,America-MG,3,0,3,3,6,0,6
2731,7387,Palmeiras,1,0,Fluminense,2,0,1,2,3,0,3
2732,7388,Atletico-MG,2,0,Bahia,1,0,2,1,3,0,3
2733,7389,Fortaleza,4,0,Bragantino,2,0,4,2,6,0,6
2734,7390,Flamengo,3,0,Sao Paulo,6,0,3,6,9,0,9
2735,7391,Santos,2,0,Atletico-GO,2,0,2,2,4,0,4
2736,7392,Athletico-PR,4,0,Internacional,3,0,4,3,7,0,7
2737,7393,Sport,4,0,Ceara,1,0,4,1,5,0,5
2738,7394,Juventude,5,0,Chapecoense,1,0,5,1,6,0,6
2739,7395,Cuiaba,2,1,Corinthians,1,0,3,1,3,1,4
2740,7396,Sao Paulo,3,1,Palmeiras,3,0,4,3,6,1,7
2741,7397,Internacional,2,1,Cuiaba,3,0,3,3,5,1,6
2742,7398,Bragantino,1,0,Gremio,2,0,1,2,3,0,3
2743,7399,Corinthians,1,0,Flamengo,1,0,1,1,2,0,2
2744,7400,Atletico-MG,3,1,Athletico-PR,3,0,4,3,6,1,7
2745,7402,Bahia,2,0,Sport,3,0,2,3,5,0,5
2746,7403,Atletico-GO,4,0,America-MG,0,0,4,0,4,0,4
2747,7404,Ceara,2,0,Fortaleza,3,0,2,3,5,0,5
2748,7405,Fluminense,2,0,Juventude,1,0,2,1,3,0,3
2749,7406,Sport,3,0,Bragantino,1,0,3,1,4,0,4
2750,7407,Athletico-PR,2,0,Sao Paulo,4,1,2,5,6,1,7
2751,7408,Palmeiras,5,1,Fortaleza,2,1,6,3,7,2,9
2752,7409,Cuiaba,1,1,Bahia,2,0,2,2,3,1,4
2753,7410,Juventude,1,0,Atletico-MG,3,0,1,3,4,0,4
2754,7411,America-MG,2,0,Fluminense,2,0,2,2,4,0,4
2755,7412,Santos,1,0,Corinthians,1,0,1,1,2,0,2
2756,7413,Ceara,2,0,Atletico-GO,2,0,2,2,4,0,4
2757,7414,Flamengo,2,1,Internacional,2,0,3,2,4,1,5
2758,7415,Gremio,1,0,Chapecoense,3,0,1,3,4,0,4
2759,7416,Bragantino,4,0,Juventude,4,0,4,4,8,0,8
2760,7417,Atletico-MG,2,0,Palmeiras,1,1,2,2,3,1,4
2761,7418,Sao Paulo,3,0,Gremio,1,0,3,1,4,0,4
2762,7419,Flamengo,4,0,Sport,1,0,4,1,5,0,5
2763,7420,Corinthians,1,0,Ceara,1,0,1,1,2,0,2
2764,7421,Bahia,2,0,Atletico-GO,0,0,2,0,2,0,2
2765,7422,Cuiaba,1,0,Athletico-PR,1,0,1,1,2,0,2
2766,7423,Fortaleza,2,0,Santos,1,0,2,1,3,0,3
2767,7424,Internacional,2,0,Fluminense,0,0,2,0,2,0,2
2768,7425,Chapecoense,1,1,America-MG,1,0,2,1,2,1,3
2769,7426,Atletico-GO,2,1,Chapecoense,5,0,3,5,7,1,8
2770,7427,Gremio,1,0,Bahia,1,0,1,1,2,0,2
2771,7428,Juventude,1,0,Fortaleza,1,0,1,1,2,0,2
2772,7429,Palmeiras,1,0,Cuiaba,1,0,1,1,2,0,2
2773,7430,Ceara,0,0,Flamengo,2,0,0,2,2,0,2
2774,7431,Athletico-PR,1,1,Corinthians,0,0,2,0,1,1,2
2775,7432,Santos,2,0,Internacional,2,0,2,2,4,0,4
2776,7433,Sport,2,0,Sao Paulo,2,0,2,2,4,0,4
2777,7434,America-MG,2,0,Bragantino,0,0,2,0,2,0,2
2778,7435,Fluminense,3,0,Atletico-MG,3,0,3,3,6,0,6
2779,7436,Sport,1,1,Chapecoense,1,0,2,1,2,1,3
2780,7437,Santos,4,0,Flamengo,4,0,4,4,8,0,8
2781,7438,Gremio,1,1,Corinthians,2,0,2,2,3,1,4
2782,7439,Palmeiras,3,0,Athletico-PR,0,0,3,0,3,0,3
2783,7440,America-MG,1,0,Ceara,2,0,1,2,3,0,3
2784,7441,Juventude,2,0,Sao Paulo,5,0,2,5,7,0,7
2785,7442,Atletico-GO,1,0,Internacional,2,0,1,2,3,0,3
2786,7443,Bragantino,3,0,Atletico-MG,4,0,3,4,7,0,7
2787,7444,Fluminense,2,0,Bahia,4,0,2,4,6,0,6
2788,7445,Fortaleza,2,0,Cuiaba,5,0,2,5,7,0,7
2789,7446,Bahia,3,0,Fortaleza,1,0,3,1,4,0,4
2790,7447,Cuiaba,3,0,Santos,1,0,3,1,4,0,4
2791,7448,Athletico-PR,1,0,Sport,2,1,1,3,3,1,4
2792,7449,Corinthians,3,0,Juventude,4,0,3,4,7,0,7
2793,7451,Sao Paulo,3,0,America-MG,1,0,3,1,4,0,4
2794,7452,Ceara,4,0,Palmeiras,2,0,4,2,6,0,6
2795,7453,Internacional,5,0,Bragantino,2,0,5,2,7,0,7
2796,7454,Atletico-MG,5,0,Gremio,6,0,5,6,11,0,11
2797,7455,Flamengo,2,0,Atletico-GO,1,0,2,1,3,0,3
2798,7456,America-MG,1,0,Athletico-PR,1,0,1,1,2,0,2
2799,7457,Juventude,3,0,Cuiaba,5,1,3,6,8,1,9
2800,7458,Bragantino,4,1,Chapecoense,2,0,5,2,6,1,7
2801,7459,Santos,1,0,Bahia,4,0,1,4,5,0,5
2802,7461,Fortaleza,1,0,Atletico-MG,2,0,1,2,3,0,3
2803,7462,Palmeiras,0,1,Flamengo,2,0,1,2,2,1,3
2804,7463,Atletico-GO,4,0,Corinthians,2,0,4,2,6,0,6
2805,7464,Fluminense,5,0,Sao Paulo,4,0,5,4,9,0,9
2806,7465,Sport,4,0,Internacional,1,0,4,1,5,0,5
2807,7466,Chapecoense,2,0,Palmeiras,2,0,2,2,4,0,4
2808,7467,Athletico-PR,5,0,Juventude,1,1,5,2,6,1,7
2809,7468,Atletico-MG,2,0,Sport,3,0,2,3,5,0,5
2810,7469,Bahia,1,0,Bragantino,4,0,1,4,5,0,5
2811,7470,Ceara,3,0,Santos,2,0,3,2,5,0,5
2812,7471,Internacional,3,1,Fortaleza,1,1,4,2,4,2,6
2813,7472,Sao Paulo,1,0,Atletico-GO,2,0,1,2,3,0,3
2814,7473,Corinthians,1,1,America-MG,0,0,2,0,1,1,2
2815,7474,Flamengo,3,0,Gremio,4,0,3,4,7,0,7
2816,7475,Cuiaba,2,1,Fluminense,2,0,3,2,4,1,5
2817,7476,Ceara,0,0,Chapecoense,3,1,0,4,3,1,4
2818,7477,Corinthians,1,0,Palmeiras,1,0,1,1,2,0,2
2819,7478,Sao Paulo,1,0,Atletico-MG,1,0,1,1,2,0,2
2820,7479,America-MG,1,0,Flamengo,1,0,1,1,2,0,2
2821,7480,Internacional,2,0,Bahia,2,0,2,2,4,0,4
2822,7481,Fluminense,2,0,Bragantino,2,0,2,2,4,0,4
2823,7482,Juventude,3,0,Santos,0,0,3,0,3,0,3
2824,7483,Sport,5,0,Fortaleza,2,0,5,2,7,0,7
2825,7484,Athletico-PR,1,0,Gremio,5,0,1,5,6,0,6
2826,7485,Atletico-GO,1,0,Cuiaba,4,0,1,4,5,0,5
2827,7486,Cuiaba,1,0,America-MG,2,0,1,2,3,0,3
2828,7487,Fortaleza,1,0,Atletico-GO,4,0,1,4,5,0,5
2829,7489,Atletico-MG,4,0,Internacional,2,0,4,2,6,0,6
2830,7490,Flamengo,2,0,Athletico-PR,2,0,2,2,4,0,4
2831,7491,Chapecoense,1,0,Sao Paulo,1,0,1,1,2,0,2
2832,7492,Palmeiras,1,0,Juventude,1,0,1,1,2,0,2
2833,7493,Gremio,2,0,Sport,1,0,2,1,3,0,3
2834,7494,Santos,2,0,Fluminense,2,0,2,2,4,0,4
2835,7495,Bahia,3,0,Ceara,2,1,3,3,5,1,6
2836,7496,Corinthians,0,0,Bahia,1,1,0,2,1,1,2
2837,7497,Chapecoense,2,0,Atletico-MG,1,0,2,1,3,0,3
2838,7498,Atletico-GO,3,0,Athletico-PR,3,0,3,3,6,0,6
2839,7499,Sport,2,0,Juventude,2,0,2,2,4,0,4
2840,7500,Ceara,5,0,Internacional,2,0,5,2,7,0,7
2841,7501,Bragantino,1,0,Flamengo,3,0,1,3,4,0,4
2842,7502,Fluminense,2,0,Fortaleza,2,0,2,2,4,0,4
2843,7503,America-MG,2,0,Palmeiras,3,0,2,3,5,0,5
2844,7504,Gremio,2,0,Cuiaba,2,0,2,2,4,0,4
2845,7505,Sao Paulo,2,0,Santos,4,0,2,4,6,0,6
2846,7506,Fluminense,2,0,Atletico-GO,2,0,2,2,4,0,4
2847,7507,Atletico-MG,1,0,Ceara,3,0,1,3,4,0,4
2848,7508,Sport,3,0,Corinthians,0,0,3,0,3,0,3
2849,7509,Fortaleza,0,1,Flamengo,2,0,1,2,2,1,3
2850,7510,Athletico-PR,1,0,Bahia,2,0,1,2,3,0,3
2851,7511,Palmeiras,1,0,Bragantino,2,0,1,2,3,0,3
2852,7512,Juventude,6,0,America-MG,3,0,6,3,9,0,9
2853,7513,Internacional,3,0,Chapecoense,1,0,3,1,4,0,4
2854,7514,Santos,4,0,Gremio,6,1,4,7,10,1,11
2855,7515,Cuiaba,2,0,Sao Paulo,2,0,2,2,4,0,4
2856,7516,Bragantino,2,1,Atletico-GO,4,0,3,4,6,1,7
2857,7517,Bahia,4,0,Palmeiras,2,1,4,3,6,1,7
2858,7518,Atletico-MG,2,0,Santos,7,0,2,7,9,0,9
2859,7519,Chapecoense,4,0,Athletico-PR,5,0,4,5,9,0,9
2860,7520,Flamengo,2,0,Juventude,3,0,2,3,5,0,5
2861,7521,Fortaleza,2,0,Gremio,2,0,2,2,4,0,4
2862,7522,Corinthians,1,0,Fluminense,1,0,1,1,2,0,2
2863,7523,Internacional,1,0,America-MG,2,0,1,2,3,0,3
2864,7524,Sao Paulo,3,0,Ceara,3,0,3,3,6,0,6
2865,7525,Cuiaba,4,0,Sport,0,0,4,0,4,0,4
2866,7526,Chapecoense,3,0,Fortaleza,1,0,3,1,4,0,4
2867,7527,America-MG,1,0,Bahia,2,0,1,2,3,0,3
2868,7528,Athletico-PR,2,0,Fluminense,1,0,2,1,3,0,3
2869,7529,Palmeiras,3,0,Internacional,4,1,3,5,7,1,8
2870,7530,Ceara,2,0,Bragantino,7,0,2,7,9,0,9
2871,7531,Gremio,1,0,Juventude,3,0,1,3,4,0,4
2872,7532,Atletico-GO,1,0,Atletico-MG,0,0,1,0,1,0,1
2873,7533,Sport,1,0,Santos,3,0,1,3,4,0,4
2874,7534,Flamengo,1,0,Cuiaba,1,0,1,1,2,0,2
2875,7535,Sao Paulo,3,0,Corinthians,2,0,3,2,5,0,5
2876,7536,Santos,1,1,America-MG,2,0,2,2,3,1,4
2877,7537,Juventude,1,0,Ceara,2,0,1,2,3,0,3
2878,7538,Fluminense,6,0,Flamengo,3,0,6,3,9,0,9
2879,7539,Fortaleza,2,0,Athletico-PR,2,0,2,2,4,0,4
2880,7540,Internacional,3,1,Corinthians,3,1,4,4,6,2,8
2881,7542,Bragantino,3,0,Sao Paulo,0,0,3,0,3,0,3
2882,7543,Bahia,1,0,Chapecoense,1,0,1,1,2,0,2
2883,7544,Atletico-GO,2,0,Gremio,7,1,2,8,9,1,10
2884,7545,Palmeiras,1,0,Sport,3,0,1,3,4,0,4
2885,7546,Bragantino,3,0,Sport,6,0,3,6,9,0,9
2886,7547,Atletico-MG,1,0,Juventude,2,0,1,2,3,0,3
2887,7548,Fortaleza,3,0,Palmeiras,2,0,3,2,5,0,5
2888,7549,Chapecoense,1,0,Gremio,1,0,1,1,2,0,2
2889,7550,Atletico-GO,0,0,Ceara,3,0,0,3,3,0,3
2890,7551,Internacional,2,0,Flamengo,1,0,2,1,3,0,3
2891,7552,Corinthians,1,0,Santos,0,0,1,0,1,0,1
2892,7553,Fluminense,1,0,America-MG,2,0,1,2,3,0,3
2893,7554,Bahia,1,0,Cuiaba,0,0,1,0,1,0,1
2894,7555,Sao Paulo,3,0,Athletico-PR,2,0,3,2,5,0,5
2895,7556,Athletico-PR,1,0,Santos,2,0,1,2,3,0,3
2896,7557,Flamengo,4,0,Atletico-MG,2,0,4,2,6,0,6
2897,7558,Juventude,2,0,Bahia,1,0,2,1,3,0,3
2898,7559,America-MG,0,0,Fortaleza,5,0,0,5,5,0,5
2899,7560,Gremio,5,0,Palmeiras,2,0,5,2,7,0,7
2900,7561,Ceara,4,1,Fluminense,2,0,5,2,6,1,7
2901,7562,Sao Paulo,0,0,Internacional,2,0,0,2,2,0,2
2902,7563,Sport,4,0,Atletico-GO,3,0,4,3,7,0,7
2903,7564,Cuiaba,2,0,Bragantino,3,0,2,3,5,0,5
2904,7565,Corinthians,1,0,Chapecoense,4,0,1,4,5,0,5
2905,7566,Cuiaba,1,0,Chapecoense,1,0,1,1,2,0,2
2906,7567,Gremio,3,0,Fluminense,1,0,3,1,4,0,4
2907,7568,Athletico-PR,4,0,Ceara,3,1,4,4,7,1,8
2908,7569,Atletico-MG,2,0,Corinthians,2,0,2,2,4,0,4
2909,7570,Santos,2,0,Bragantino,1,0,2,1,3,0,3
2910,7571,Palmeiras,1,0,Atletico-GO,3,0,1,3,4,0,4
2911,7572,Fortaleza,4,0,Sao Paulo,5,0,4,5,9,0,9
2912,7573,Sport,2,1,America-MG,3,0,3,3,5,1,6
2913,7574,Juventude,2,0,Internacional,4,0,2,4,6,0,6
2914,7575,Flamengo,0,1,Bahia,2,2,1,4,2,3,5
2915,7576,Corinthians,3,0,Fortaleza,3,0,3,3,6,0,6
2916,7577,Internacional,1,1,Gremio,3,1,2,4,4,2,6
2917,7578,Fluminense,1,0,Sport,1,0,1,1,2,0,2
2918,7579,Bragantino,2,0,Athletico-PR,3,0,2,3,5,0,5
2919,7580,Atletico-MG,3,0,America-MG,2,0,3,2,5,0,5
2920,7581,Santos,3,0,Palmeiras,2,0,3,2,5,0,5
2921,7582,Bahia,1,0,Sao Paulo,2,0,1,2,3,0,3
2922,7583,Ceara,3,0,Cuiaba,1,0,3,1,4,0,4
2923,7584,Chapecoense,3,1,Flamengo,3,1,4,4,6,2,8
2924,7585,Atletico-GO,1,0,Juventude,2,0,1,2,3,0,3
2925,7586,Atletico-GO,2,0,Santos,3,0,2,3,5,0,5
2926,7587,America-MG,3,0,Gremio,1,0,3,1,4,0,4
2927,7588,Bragantino,3,0,Fortaleza,4,0,3,4,7,0,7
2928,7589,Internacional,7,0,Athletico-PR,3,0,7,3,10,0,10
2929,7590,Corinthians,1,0,Cuiaba,1,0,1,1,2,0,2
2930,7591,Sao Paulo,1,1,Flamengo,1,0,2,1,2,1,3
2931,7592,Fluminense,4,1,Palmeiras,6,2,5,8,10,3,13
2932,7593,Ceara,1,0,Sport,2,0,1,2,3,0,3
2933,7594,Chapecoense,3,0,Juventude,3,0,3,3,6,0,6
2934,7595,Bahia,2,0,Atletico-MG,3,0,2,3,5,0,5
2935,7596,Athletico-PR,1,0,Atletico-MG,2,0,1,2,3,0,3
2936,7597,Gremio,0,0,Bragantino,2,0,0,2,2,0,2
2937,7598,America-MG,1,0,Atletico-GO,1,0,1,1,2,0,2
2938,7599,Santos,1,0,Chapecoense,2,0,1,2,3,0,3
2939,7600,Cuiaba,4,0,Internacional,1,0,4,1,5,0,5
2940,7601,Fortaleza,1,0,Ceara,4,0,1,4,5,0,5
2941,7602,Palmeiras,1,0,Sao Paulo,2,0,1,2,3,0,3
2942,7603,Juventude,2,0,Fluminense,1,0,2,1,3,0,3
2943,7604,Flamengo,1,0,Corinthians,2,0,1,2,3,0,3
2944,7605,Sport,1,0,Bahia,3,0,1,3,4,0,4
2945,7606,Palmeiras,4,0,Atletico-MG,3,0,4,3,7,0,7
2946,7607,Fluminense,5,0,Internacional,5,1,5,6,10,1,11
2947,7608,Santos,3,0,Fortaleza,2,0,3,2,5,0,5
2948,7609,Ceara,3,0,Corinthians,4,0,3,4,7,0,7
2949,7610,Atletico-GO,5,0,Bahia,3,1,5,4,8,1,9
2950,7611,Juventude,3,0,Bragantino,3,0,3,3,6,0,6
2951,7612,America-MG,2,0,Chapecoense,2,0,2,2,4,0,4
2952,7613,Gremio,3,0,Sao Paulo,2,0,3,2,5,0,5
2953,7614,Athletico-PR,4,0,Cuiaba,6,1,4,7,10,1,11
2954,7615,Sport,2,0,Flamengo,3,0,2,3,5,0,5
2955,7616,Bahia,3,0,Gremio,3,0,3,3,6,0,6
2956,7617,Bragantino,3,0,America-MG,2,0,3,2,5,0,5
2957,7618,Sao Paulo,0,0,Sport,1,0,0,1,1,0,1
2958,7619,Corinthians,5,0,Athletico-PR,3,0,5,3,8,0,8
2959,7620,Atletico-MG,6,0,Fluminense,3,0,6,3,9,0,9
2960,7621,Internacional,1,0,Santos,2,0,1,2,3,0,3
2961,7622,Flamengo,6,0,Ceara,1,0,6,1,7,0,7
2962,7623,Cuiaba,4,0,Palmeiras,2,1,4,3,6,1,7
2963,7624,Chapecoense,2,0,Atletico-GO,3,0,2,3,5,0,5
2964,7625,Fortaleza,2,0,Juventude,0,0,2,0,2,0,2
2965,7626,Bahia,2,1,Fluminense,5,1,3,6,7,2,9
2966,7627,Corinthians,1,0,Gremio,3,0,1,3,4,0,4
2967,7628,Atletico-MG,1,0,Bragantino,2,0,1,2,3,0,3
2968,7629,Ceara,0,0,America-MG,2,0,0,2,2,0,2
2969,7630,Sao Paulo,5,0,Juventude,3,0,5,3,8,0,8
2970,7631,Athletico-PR,1,0,Palmeiras,1,0,1,1,2,0,2
2971,7632,Cuiaba,1,0,Fortaleza,3,0,1,3,4,0,4
2972,7633,Internacional,3,0,Atletico-GO,2,0,3,2,5,0,5
2973,7634,Flamengo,3,0,Santos,3,0,3,3,6,0,6
2974,7635,Chapecoense,3,1,Sport,4,0,4,4,7,1,8
2975,7636,Fortaleza,4,0,Bahia,2,0,4,2,6,0,6
2976,7637,Atletico-GO,4,0,Flamengo,2,0,4,2,6,0,6
2977,7638,Palmeiras,2,0,Ceara,0,0,2,0,2,0,2
2978,7639,Fluminense,3,0,Chapecoense,2,0,3,2,5,0,5
2979,7640,America-MG,2,0,Sao Paulo,2,0,2,2,4,0,4
2980,7641,Bragantino,4,0,Internacional,5,0,4,5,9,0,9
2981,7642,Sport,1,0,Athletico-PR,1,0,1,1,2,0,2
2982,7643,Juventude,1,0,Corinthians,2,1,1,3,3,1,4
2983,7644,Gremio,3,0,Atletico-MG,1,0,3,1,4,0,4
2984,7645,Santos,1,0,Cuiaba,2,0,1,2,3,0,3
2985,7646,Fluminense,1,0,Santos,0,0,1,0,1,0,1
2986,7647,Atletico-GO,3,0,Flamengo,2,0,3,2,5,0,5
2987,7648,Palmeiras,4,0,Ceara,9,1,4,10,13,1,14
2988,7649,Coritiba,2,0,Goias,4,0,2,4,6,0,6
2989,7650,Botafogo-RJ,1,0,Corinthians,4,0,1,4,5,0,5
2990,7651,Atletico-MG,2,0,Internacional,4,0,2,4,6,0,6
2991,7652,Fortaleza,2,0,Cuiaba,3,0,2,3,5,0,5
2992,7653,Avai,3,0,America-MG,3,2,3,5,6,2,8
2993,7654,Sao Paulo,1,0,Athletico-PR,3,0,1,3,4,0,4
2994,7655,Juventude,4,0,Bragantino,5,0,4,5,9,0,9
2995,7656,Goias,4,0,Palmeiras,0,0,4,0,4,0,4
2996,7657,America-MG,3,0,Juventude,0,1,3,1,3,1,4
2997,7658,Corinthians,1,0,Avai,1,0,1,1,2,0,2
2998,7659,Cuiaba,2,0,Fluminense,1,0,2,1,3,0,3
2999,7660,Santos,2,0,Coritiba,4,0,2,4,6,0,6
3000,7661,Flamengo,2,0,Sao Paulo,6,0,2,6,8,0,8
3001,7662,Athletico-PR,2,0,Atletico-MG,3,0,2,3,5,0,5
3002,7663,Internacional,5,0,Fortaleza,5,0,5,5,10,0,10
3003,7664,Bragantino,1,0,Atletico-GO,4,0,1,4,5,0,5
3004,7665,Ceara,1,1,Botafogo-RJ,4,0,2,4,5,1,6
3005,7666,Flamengo,3,0,Palmeiras,4,0,3,4,7,0,7
3006,7667,Ceara,1,0,Bragantino,5,1,1,6,6,1,7
3007,7668,America-MG,1,0,Athletico-PR,0,0,1,0,1,0,1
3008,7669,Goias,5,0,Atletico-MG,4,0,5,4,9,0,9
3009,7670,Cuiaba,2,0,Atletico-GO,0,0,2,0,2,0,2
3010,7671,Botafogo-RJ,2,0,Juventude,5,0,2,5,7,0,7
3011,7672,Corinthians,1,0,Fortaleza,3,0,1,3,4,0,4
3012,7673,Coritiba,0,0,Fluminense,3,1,0,4,3,1,4
3013,7674,Internacional,2,0,Avai,4,0,2,4,6,0,6
3014,7675,Sao Paulo,2,0,Santos,4,0,2,4,6,0,6
3015,7676,Bragantino,5,0,Sao Paulo,2,0,5,2,7,0,7
3016,7677,Athletico-PR,4,0,Flamengo,2,0,4,2,6,0,6
3017,7678,Palmeiras,1,0,Corinthians,2,0,1,2,3,0,3
3018,7679,Fluminense,5,0,Internacional,3,0,5,3,8,0,8
3019,7680,Atletico-MG,2,0,Coritiba,1,0,2,1,3,0,3
3020,7681,Santos,2,0,America-MG,0,0,2,0,2,0,2
3021,7682,Juventude,2,1,Cuiaba,4,0,3,4,6,1,7
3022,7683,Atletico-GO,2,0,Botafogo-RJ,1,0,2,1,3,0,3
3023,7684,Avai,5,1,Goias,5,0,6,5,10,1,11
3024,7685,Fortaleza,5,1,Ceara,4,0,6,4,9,1,10
3025,7686,Atletico-MG,4,0,America-MG,4,1,4,5,8,1,9
3026,7687,Athletico-PR,5,0,Ceara,4,0,5,4,9,0,9
3027,7688,Flamengo,1,0,Botafogo-RJ,3,0,1,3,4,0,4
3028,7689,Palmeiras,1,0,Fluminense,2,0,1,2,3,0,3
3029,7690,Atletico-GO,4,0,Goias,3,1,4,4,7,1,8
3030,7691,Bragantino,1,0,Corinthians,2,0,1,2,3,0,3
3031,7692,Santos,1,0,Cuiaba,2,0,1,2,3,0,3
3032,7693,Juventude,5,0,Internacional,5,0,5,5,10,0,10
3033,7694,Fortaleza,2,0,Sao Paulo,3,0,2,3,5,0,5
3034,7695,Avai,3,0,Coritiba,3,0,3,3,6,0,6
3035,7696,Bragantino,3,1,Atletico-MG,2,0,4,2,5,1,6
3036,7697,Atletico-GO,4,0,Coritiba,1,2,4,3,5,2,7
3037,7698,Flamengo,1,0,Goias,3,0,1,3,4,0,4
3038,7699,Santos,1,0,Ceara,5,1,1,6,6,1,7
3039,7700,Juventude,3,0,Palmeiras,0,0,3,0,3,0,3
3040,7701,Cuiaba,2,2,Internacional,7,0,4,7,9,2,11
3041,7702,America-MG,2,0,Botafogo-RJ,1,0,2,1,3,0,3
3042,7703,Corinthians,2,0,Sao Paulo,3,0,2,3,5,0,5
3043,7704,Fortaleza,1,0,Fluminense,1,0,1,1,2,0,2
3044,7705,Athletico-PR,2,0,Avai,6,0,2,6,8,0,8
3045,7706,Palmeiras,2,0,Bragantino,2,0,2,2,4,0,4
3046,7707,Ceara,5,0,Flamengo,5,0,5,5,10,0,10
3047,7708,Internacional,2,0,Corinthians,2,0,2,2,4,0,4
3048,7709,Atletico-MG,1,0,Atletico-GO,2,0,1,2,3,0,3
3049,7710,Fluminense,3,0,Athletico-PR,2,0,3,2,5,0,5
3050,7711,Sao Paulo,2,0,Cuiaba,1,1,2,2,3,1,4
3051,7712,Coritiba,1,0,America-MG,5,1,1,6,6,1,7
3052,7713,Botafogo-RJ,3,0,Fortaleza,1,1,3,2,4,1,5
3053,7714,Avai,2,0,Juventude,5,2,2,7,7,2,9
3054,7716,Goias,2,0,Bragantino,3,1,2,4,5,1,6
3055,7717,Sao Paulo,3,1,Ceara,5,0,4,5,8,1,9
3056,7718,Fortaleza,2,0,Juventude,3,0,2,3,5,0,5
3057,7719,Coritiba,5,0,Botafogo-RJ,3,0,5,3,8,0,8
3058,7720,Santos,5,0,Palmeiras,1,0,5,1,6,0,6
3059,7721,Cuiaba,5,0,Athletico-PR,0,0,5,0,5,0,5
3060,7722,Corinthians,2,0,America-MG,1,0,2,1,3,0,3
3061,7723,Fluminense,3,1,Flamengo,5,1,4,6,8,2,10
3062,7724,Atletico-MG,3,0,Avai,2,1,3,3,5,1,6
3063,7725,Internacional,1,0,Atletico-GO,2,0,1,2,3,0,3
3064,7726,America-MG,0,0,Cuiaba,1,0,0,1,1,0,1
3065,7727,Athletico-PR,5,0,Santos,3,0,5,3,8,0,8
3066,7728,Ceara,1,0,Coritiba,4,0,1,4,5,0,5
3067,7729,Avai,2,0,Sao Paulo,2,0,2,2,4,0,4
3068,7730,Atletico-GO,3,0,Corinthians,3,0,3,3,6,0,6
3069,7731,Juventude,3,0,Fluminense,4,1,3,5,7,1,8
3070,7732,Flamengo,3,0,Fortaleza,4,0,3,4,7,0,7
3071,7733,Palmeiras,1,0,Atletico-MG,3,0,1,3,4,0,4
3072,7734,Bragantino,3,0,Internacional,3,0,3,3,6,0,6
3073,7735,Botafogo-RJ,2,0,Goias,2,0,2,2,4,0,4
3074,7736,Cuiaba,1,1,Corinthians,2,0,2,2,3,1,4
3075,7737,America-MG,2,0,Ceara,3,0,2,3,5,0,5
3076,7738,Juventude,2,0,Athletico-PR,4,0,2,4,6,0,6
3077,7739,Atletico-GO,1,0,Avai,4,1,1,5,5,1,6
3078,7740,Bragantino,1,1,Flamengo,4,0,2,4,5,1,6
3079,7741,Fluminense,3,0,Atletico-MG,3,0,3,3,6,0,6
3080,7742,Santos,2,0,Internacional,1,0,2,1,3,0,3
3081,7743,Palmeiras,1,0,Botafogo-RJ,1,0,1,1,2,0,2
3082,7744,Coritiba,3,0,Sao Paulo,3,0,3,3,6,0,6
3083,7745,Fortaleza,1,0,Goias,2,0,1,2,3,0,3
3084,7746,Corinthians,1,0,Juventude,4,0,1,4,5,0,5
3085,7747,Atletico-MG,4,0,Santos,4,1,4,5,8,1,9
3086,7748,Fluminense,3,1,Atletico-GO,2,0,4,2,5,1,6
3087,7749,Cuiaba,1,0,Bragantino,3,0,1,3,4,0,4
3088,7750,Internacional,3,0,Flamengo,3,0,3,3,6,0,6
3089,7751,Goias,6,0,Ceara,2,1,6,3,8,1,9
3090,7752,Sao Paulo,2,0,America-MG,2,0,2,2,4,0,4
3091,7753,Coritiba,1,1,Palmeiras,2,0,2,2,3,1,4
3092,7754,Fortaleza,1,0,Athletico-PR,3,0,1,3,4,0,4
3093,7755,Botafogo-RJ,4,0,Avai,5,1,4,6,9,1,10
3094,7756,Juventude,1,1,Santos,2,0,2,2,3,1,4
3095,7757,Ceara,2,0,Atletico-MG,3,0,2,3,5,0,5
3096,7758,Bragantino,2,0,Coritiba,1,0,2,1,3,0,3
3097,7759,Goias,4,0,Internacional,3,0,4,3,7,0,7
3098,7760,Flamengo,1,0,Cuiaba,2,0,1,2,3,0,3
3099,7761,Athletico-PR,2,1,Corinthians,2,1,3,3,4,2,6
3100,7762,America-MG,3,1,Fluminense,1,0,4,1,4,1,5
3101,7763,Botafogo-RJ,6,0,Sao Paulo,3,0,6,3,9,0,9
3102,7764,Palmeiras,2,0,Atletico-GO,1,1,2,2,3,1,4
3103,7765,Avai,1,0,Fortaleza,3,0,1,3,4,0,4
3104,7766,Cuiaba,0,0,Ceara,2,0,0,2,2,0,2
3105,7767,Santos,4,0,Bragantino,3,0,4,3,7,0,7
3106,7768,Atletico-MG,4,0,Flamengo,1,0,4,1,5,0,5
3107,7769,Coritiba,5,2,Athletico-PR,6,0,7,6,11,2,13
3108,7770,Corinthians,1,0,Goias,4,0,1,4,5,0,5
3109,7771,Internacional,5,2,Botafogo-RJ,6,2,7,8,11,4,15
3110,7772,Fortaleza,1,0,America-MG,0,0,1,0,1,0,1
3111,7773,Atletico-GO,3,0,Juventude,4,1,3,5,7,1,8
3112,7774,Fluminense,0,0,Avai,3,0,0,3,3,0,3
3113,7775,Sao Paulo,3,0,Palmeiras,1,0,3,1,4,0,4
3114,7776,Internacional,2,0,Coritiba,4,0,2,4,6,0,6
3115,7777,Athletico-PR,4,0,Bragantino,1,0,4,1,5,0,5
3116,7778,Flamengo,1,0,America-MG,2,0,1,2,3,0,3
3117,7779,Corinthians,3,0,Santos,3,0,3,3,6,0,6
3118,7780,Atletico-MG,0,0,Fortaleza,5,0,0,5,5,0,5
3119,7781,Avai,4,0,Palmeiras,1,0,4,1,5,0,5
3120,7782,Botafogo-RJ,3,0,Fluminense,2,0,3,2,5,0,5
3121,7783,Goias,3,0,Cuiaba,4,1,3,5,7,1,8
3122,7784,Ceara,2,0,Atletico-GO,2,0,2,2,4,0,4
3123,7785,Sao Paulo,3,0,Juventude,4,0,3,4,7,0,7
3124,7786,Juventude,2,0,Atletico-MG,1,0,2,1,3,0,3
3125,7787,Fluminense,0,0,Corinthians,3,0,0,3,3,0,3
3126,7788,Santos,4,0,Flamengo,2,0,4,2,6,0,6
3127,7789,Ceara,4,0,Internacional,3,1,4,4,7,1,8
3128,7790,Palmeiras,1,1,Athletico-PR,2,0,2,2,3,1,4
3129,7792,Atletico-GO,5,0,Sao Paulo,7,0,5,7,12,0,12
3130,7793,America-MG,2,0,Goias,2,0,2,2,4,0,4
3131,7794,Coritiba,2,1,Fortaleza,3,0,3,3,5,1,6
3132,7795,Bragantino,1,1,Botafogo-RJ,4,0,2,4,5,1,6
3133,7796,Bragantino,1,0,Avai,3,0,1,3,4,0,4
3134,7797,Fluminense,2,0,Ceara,3,0,2,3,5,0,5
3135,7798,Goias,2,0,Athletico-PR,1,0,2,1,3,0,3
3136,7799,Coritiba,1,0,Juventude,2,0,1,2,3,0,3
3137,7800,Corinthians,2,0,Flamengo,4,0,2,4,6,0,6
3138,7801,Santos,5,0,Atletico-GO,4,0,5,4,9,0,9
3139,7802,Fortaleza,0,0,Palmeiras,1,0,0,1,1,0,1
3140,7803,Atletico-MG,1,0,Sao Paulo,1,0,1,1,2,0,2
3141,7804,Cuiaba,1,0,Botafogo-RJ,2,2,1,4,3,2,5
3142,7805,Internacional,0,0,America-MG,5,0,0,5,5,0,5
3143,7806,Athletico-PR,1,0,Internacional,2,0,1,2,3,0,3
3144,7807,Flamengo,0,0,Coritiba,1,0,0,1,1,0,1
3145,7808,Avai,5,0,Santos,3,0,5,3,8,0,8
3146,7809,Ceara,1,0,Corinthians,1,0,1,1,2,0,2
3147,7810,Juventude,2,0,Goias,3,0,2,3,5,0,5
3148,7811,Sao Paulo,4,0,Fluminense,2,0,4,2,6,0,6
3149,7812,Botafogo-RJ,4,0,Atletico-MG,3,0,4,3,7,0,7
3150,7813,Atletico-GO,1,0,Fortaleza,0,0,1,0,1,0,1
3151,7814,America-MG,3,0,Bragantino,1,0,3,1,4,0,4
3152,7815,Palmeiras,3,0,Cuiaba,1,0,3,1,4,0,4
3153,7816,Ceara,0,0,Avai,2,0,0,2,2,0,2
3154,7817,Bragantino,4,0,Fortaleza,3,0,4,3,7,0,7
3155,7818,Goias,2,0,Fluminense,0,0,2,0,2,0,2
3156,7819,Athletico-PR,3,0,Atletico-GO,0,0,3,0,3,0,3
3157,7820,Flamengo,3,0,Juventude,3,1,3,4,6,1,7
3158,7821,Internacional,4,0,Sao Paulo,5,0,4,5,9,0,9
3159,7822,Santos,2,0,Botafogo-RJ,2,0,2,2,4,0,4
3160,7823,Corinthians,1,0,Coritiba,3,0,1,3,4,0,4
3161,7824,Cuiaba,1,0,Atletico-MG,1,0,1,1,2,0,2
3162,7825,America-MG,5,0,Palmeiras,3,0,5,3,8,0,8
3163,7826,Sao Paulo,2,0,Goias,5,0,2,5,7,0,7
3164,7827,Botafogo-RJ,0,0,Athletico-PR,2,0,0,2,2,0,2
3165,7828,Avai,1,0,Flamengo,1,0,1,1,2,0,2
3166,7829,Fluminense,5,1,Bragantino,2,0,6,2,7,1,8
3167,7830,Palmeiras,0,0,Internacional,1,0,0,1,1,0,1
3168,7831,Juventude,1,0,Ceara,3,0,1,3,4,0,4
3169,7832,Atletico-MG,2,0,Corinthians,1,0,2,1,3,0,3
3170,7833,Atletico-GO,0,0,America-MG,1,0,0,1,1,0,1
3171,7834,Fortaleza,4,0,Santos,4,0,4,4,8,0,8
3172,7835,Coritiba,5,1,Cuiaba,3,0,6,3,8,1,9
3173,7836,Goias,1,0,Coritiba,2,1,1,3,3,1,4
3174,7837,Ceara,3,1,Palmeiras,3,0,4,3,6,1,7
3175,7839,Flamengo,0,0,Atletico-GO,7,1,0,8,7,1,8
3176,7840,Athletico-PR,3,0,Sao Paulo,4,0,3,4,7,0,7
3177,7841,Internacional,1,0,Atletico-MG,1,0,1,1,2,0,2
3178,7842,Cuiaba,2,0,Fortaleza,4,0,2,4,6,0,6
3179,7843,America-MG,1,0,Avai,0,0,1,0,1,0,1
3180,7844,Bragantino,1,0,Juventude,1,0,1,1,2,0,2
3181,7845,Santos,2,0,Fluminense,5,0,2,5,7,0,7
3182,7846,Juventude,1,0,America-MG,2,0,1,2,3,0,3
3183,7847,Botafogo-RJ,3,0,Ceara,4,0,3,4,7,0,7
3184,7848,Avai,2,0,Corinthians,1,0,2,1,3,0,3
3185,7849,Atletico-GO,2,0,Bragantino,1,0,2,1,3,0,3
3186,7850,Sao Paulo,2,0,Flamengo,2,0,2,2,4,0,4
3187,7851,Fluminense,2,0,Cuiaba,1,0,2,1,3,0,3
3188,7852,Palmeiras,2,0,Goias,3,0,2,3,5,0,5
3189,7853,Fortaleza,1,1,Internacional,5,0,2,5,6,1,7
3190,7854,Atletico-MG,1,0,Athletico-PR,2,0,1,2,3,0,3
3191,7855,Coritiba,3,0,Santos,3,0,3,3,6,0,6
3192,7856,Goias,1,1,Avai,2,0,2,2,3,1,4
3193,7857,Corinthians,2,0,Palmeiras,2,0,2,2,4,0,4
3194,7858,Cuiaba,4,0,Juventude,5,1,4,6,9,1,10
3195,7859,Botafogo-RJ,1,1,Atletico-GO,3,0,2,3,4,1,5
3196,7860,Coritiba,3,0,Atletico-MG,0,0,3,0,3,0,3
3197,7861,Ceara,3,0,Fortaleza,4,0,3,4,7,0,7
3198,7862,Flamengo,3,0,Athletico-PR,2,0,3,2,5,0,5
3199,7863,Sao Paulo,1,0,Bragantino,0,0,1,0,1,0,1
3200,7864,America-MG,1,0,Santos,0,0,1,0,1,0,1
3201,7865,Internacional,1,0,Fluminense,1,0,1,1,2,0,2
3202,7867,Fluminense,1,0,Coritiba,2,0,1,2,3,0,3
3203,7868,Juventude,2,0,Botafogo-RJ,2,0,2,2,4,0,4
3204,7869,Palmeiras,0,0,Flamengo,2,0,0,2,2,0,2
3205,7871,Atletico-GO,2,1,Cuiaba,2,0,3,2,4,1,5
3206,7872,Fortaleza,1,0,Corinthians,2,0,1,2,3,0,3
3207,7873,Bragantino,3,0,Ceara,4,0,3,4,7,0,7
3208,7874,Santos,4,0,Sao Paulo,2,0,4,2,6,0,6
3209,7875,Avai,5,0,Internacional,1,0,5,1,6,0,6
3210,7876,Goias,2,1,Atletico-GO,2,1,3,3,4,2,6
3211,7877,Coritiba,4,0,Avai,3,0,4,3,7,0,7
3212,7878,Fluminense,3,0,Palmeiras,3,0,3,3,6,0,6
3213,7879,Ceara,0,0,Athletico-PR,1,0,0,1,1,0,1
3214,7880,Sao Paulo,2,0,Fortaleza,2,0,2,2,4,0,4
3215,7881,America-MG,4,0,Atletico-MG,4,0,4,4,8,0,8
3216,7882,Botafogo-RJ,3,0,Flamengo,2,0,3,2,5,0,5
3217,7884,Internacional,0,0,Juventude,3,0,0,3,3,0,3
3218,7885,Corinthians,1,0,Bragantino,1,0,1,1,2,0,2
3219,7886,Juventude,6,0,Avai,6,0,6,6,12,0,12
3220,7887,Bragantino,4,0,Palmeiras,4,0,4,4,8,0,8
3221,7888,Athletico-PR,2,0,Fluminense,0,0,2,0,2,0,2
3222,7889,America-MG,2,0,Coritiba,3,0,2,3,5,0,5
3223,7890,Flamengo,4,1,Ceara,6,1,5,7,10,2,12
3224,7891,Corinthians,2,0,Internacional,2,0,2,2,4,0,4
3225,7892,Fortaleza,1,0,Botafogo-RJ,2,0,1,2,3,0,3
3226,7893,Atletico-GO,1,0,Atletico-MG,2,0,1,2,3,0,3
3227,7894,Cuiaba,3,0,Sao Paulo,2,1,3,3,5,1,6
3228,7895,Santos,1,0,Goias,2,0,1,2,3,0,3
3229,7896,Atletico-MG,1,0,Bragantino,2,0,1,2,3,0,3
3230,7897,Internacional,1,0,Cuiaba,3,0,1,3,4,0,4
3231,7898,Ceara,4,0,Santos,3,0,4,3,7,0,7
3232,7899,Fluminense,1,0,Fortaleza,2,0,1,2,3,0,3
3233,7900,Palmeiras,0,0,Juventude,3,0,0,3,3,0,3
3234,7901,Avai,3,0,Athletico-PR,4,1,3,5,7,1,8
3235,7902,Botafogo-RJ,1,0,America-MG,5,0,1,5,6,0,6
3236,7903,Sao Paulo,3,0,Corinthians,1,0,3,1,4,0,4
3237,7904,Coritiba,6,0,Atletico-GO,3,1,6,4,9,1,10
3238,7905,Goias,3,0,Flamengo,1,0,3,1,4,0,4
3239,7906,Avai,4,0,Atletico-MG,3,0,4,3,7,0,7
3240,7907,Botafogo-RJ,2,0,Coritiba,4,0,2,4,6,0,6
3241,7908,Bragantino,0,0,Goias,5,0,0,5,5,0,5
3242,7909,Flamengo,1,2,Fluminense,5,3,3,8,6,5,11
3243,7910,Ceara,5,2,Sao Paulo,2,0,7,2,7,2,9
3244,7911,America-MG,1,0,Corinthians,3,0,1,3,4,0,4
3245,7912,Juventude,2,0,Fortaleza,3,0,2,3,5,0,5
3246,7913,Palmeiras,3,1,Santos,4,0,4,4,7,1,8
3247,7914,Athletico-PR,3,0,Cuiaba,2,1,3,3,5,1,6
3248,7915,Atletico-GO,3,0,Internacional,2,0,3,2,5,0,5
3249,7916,Sao Paulo,2,0,Avai,4,0,2,4,6,0,6
3250,7917,Santos,3,0,Athletico-PR,3,0,3,3,6,0,6
3251,7918,Coritiba,2,0,Ceara,4,0,2,4,6,0,6
3252,7919,Corinthians,0,0,Atletico-GO,3,0,0,3,3,0,3
3253,7920,Fluminense,1,0,Juventude,1,0,1,1,2,0,2
3254,7921,Fortaleza,2,0,Flamengo,5,0,2,5,7,0,7
3255,7922,Cuiaba,1,0,America-MG,6,0,1,6,7,0,7
3256,7923,Internacional,1,0,Bragantino,2,0,1,2,3,0,3
3257,7924,Atletico-MG,3,0,Palmeiras,3,0,3,3,6,0,6
3258,7925,Goias,4,0,Botafogo-RJ,4,0,4,4,8,0,8
3259,7926,Atletico-MG,2,0,Fluminense,3,1,2,4,5,1,6
3260,7927,Internacional,1,0,Santos,4,0,1,4,5,0,5
3261,7928,Ceara,3,0,America-MG,4,0,3,4,7,0,7
3262,7929,Avai,2,0,Atletico-GO,4,0,2,4,6,0,6
3263,7930,Athletico-PR,3,0,Juventude,5,0,3,5,8,0,8
3264,7931,Flamengo,1,0,Bragantino,0,1,1,1,1,1,2
3265,7932,Goias,3,0,Fortaleza,2,0,3,2,5,0,5
3266,7933,Corinthians,1,0,Cuiaba,0,0,1,0,1,0,1
3267,7934,Botafogo-RJ,4,0,Palmeiras,2,1,4,3,6,1,7
3268,7935,Sao Paulo,2,0,Coritiba,6,0,2,6,8,0,8
3269,7936,Juventude,1,0,Corinthians,2,0,1,2,3,0,3
3270,7937,Atletico-GO,4,0,Fluminense,0,0,4,0,4,0,4
3271,7938,Ceara,4,1,Goias,4,0,5,4,8,1,9
3272,7939,Bragantino,2,0,Cuiaba,3,0,2,3,5,0,5
3273,7940,Athletico-PR,2,0,Fortaleza,1,0,2,1,3,0,3
3274,7941,Flamengo,3,0,Internacional,2,0,3,2,5,0,5
3275,7942,Santos,2,1,Atletico-MG,4,0,3,4,6,1,7
3276,7943,Palmeiras,1,0,Coritiba,2,0,1,2,3,0,3
3277,7944,America-MG,2,0,Sao Paulo,4,0,2,4,6,0,6
3278,7945,Avai,2,0,Botafogo-RJ,4,0,2,4,6,0,6
3279,7946,Cuiaba,2,0,Flamengo,2,0,2,2,4,0,4
3280,7947,Corinthians,1,0,Athletico-PR,0,0,1,0,1,0,1
3281,7948,Internacional,1,0,Goias,7,0,1,7,8,0,8
3282,7949,Sao Paulo,3,1,Botafogo-RJ,2,0,4,2,5,1,6
3283,7950,Fortaleza,1,0,Avai,1,0,1,1,2,0,2
3284,7951,Coritiba,0,1,Bragantino,3,0,1,3,3,1,4
3285,7952,Atletico-MG,3,0,Ceara,5,0,3,5,8,0,8
3286,7953,Fluminense,1,0,America-MG,3,0,1,3,4,0,4
3287,7954,Atletico-GO,4,0,Palmeiras,2,0,4,2,6,0,6
3288,7955,Santos,2,0,Juventude,0,0,2,0,2,0,2
3289,7956,Flamengo,4,0,Atletico-MG,0,0,4,0,4,0,4
3290,7957,America-MG,1,0,Fortaleza,3,1,1,4,4,1,5
3291,7958,Ceara,4,0,Cuiaba,5,1,4,6,9,1,10
3292,7959,Palmeiras,3,0,Sao Paulo,3,2,3,5,6,2,8
3293,7960,Juventude,2,0,Atletico-GO,1,0,2,1,3,0,3
3294,7961,Botafogo-RJ,3,0,Internacional,5,0,3,5,8,0,8
3295,7962,Avai,2,0,Fluminense,0,0,2,0,2,0,2
3296,7963,Athletico-PR,3,0,Coritiba,2,0,3,2,5,0,5
3297,7964,Bragantino,3,1,Santos,4,0,4,4,7,1,8
3298,7965,Goias,2,0,Corinthians,3,0,2,3,5,0,5
3299,7966,Bragantino,0,0,Athletico-PR,3,0,0,3,3,0,3
3300,7967,America-MG,1,0,Flamengo,1,0,1,1,2,0,2
3301,7968,Santos,2,1,Corinthians,4,1,3,5,6,2,8
3302,7969,Palmeiras,2,0,Avai,2,0,2,2,4,0,4
3303,7970,Fluminense,3,0,Botafogo-RJ,2,0,3,2,5,0,5
3304,7971,Juventude,2,0,Sao Paulo,2,0,2,2,4,0,4
3305,7972,Coritiba,3,0,Internacional,1,0,3,1,4,0,4
3306,7973,Atletico-GO,3,0,Ceara,2,0,3,2,5,0,5
3307,7974,Cuiaba,3,0,Goias,4,0,3,4,7,0,7
3308,7975,Fortaleza,4,0,Atletico-MG,1,0,4,1,5,0,5
3309,7976,Flamengo,3,0,Santos,4,0,3,4,7,0,7
3310,7977,Athletico-PR,3,1,Palmeiras,5,0,4,5,8,1,9
3311,7978,Botafogo-RJ,1,0,Bragantino,4,0,1,4,5,0,5
3312,7979,Corinthians,2,0,Fluminense,3,0,2,3,5,0,5
3313,7980,Internacional,0,0,Ceara,2,0,0,2,2,0,2
3314,7981,Goias,2,0,America-MG,3,0,2,3,5,0,5
3315,7982,Fortaleza,1,0,Coritiba,1,1,1,2,2,1,3
3316,7983,Sao Paulo,2,0,Atletico-GO,4,1,2,5,6,1,7
3317,7984,Atletico-MG,2,0,Juventude,1,0,2,1,3,0,3
3318,7985,Cuiaba,1,0,Avai,1,0,1,1,2,0,2
3319,7986,Ceara,2,1,Fluminense,2,0,3,2,4,1,5
3320,7987,Botafogo-RJ,1,0,Cuiaba,1,0,1,1,2,0,2
3321,7988,Sao Paulo,3,0,Atletico-MG,5,0,3,5,8,0,8
3322,7989,Athletico-PR,2,0,Goias,1,0,2,1,3,0,3
3323,7991,Juventude,3,0,Coritiba,4,0,3,4,7,0,7
3324,7992,Avai,2,0,Bragantino,1,0,2,1,3,0,3
3325,7993,Atletico-GO,3,0,Santos,2,0,3,2,5,0,5
3326,7994,Palmeiras,3,0,Fortaleza,1,0,3,1,4,0,4
3327,7995,Flamengo,0,0,Corinthians,1,0,0,1,1,0,1
3328,7996,Santos,3,0,Avai,0,0,3,0,3,0,3
3329,7997,Fluminense,1,0,Sao Paulo,1,1,1,2,2,1,3
3330,7998,Bragantino,6,0,America-MG,2,0,6,2,8,0,8
3331,7999,Goias,4,0,Juventude,6,0,4,6,10,0,10
3332,8000,Corinthians,4,0,Ceara,4,0,4,4,8,0,8
3333,8001,Internacional,0,0,Athletico-PR,1,1,0,2,1,1,2
3334,8002,Fortaleza,2,0,Atletico-GO,5,1,2,6,7,1,8
3335,8003,Coritiba,5,0,Flamengo,3,0,5,3,8,0,8
3336,8004,Cuiaba,2,0,Palmeiras,0,0,2,0,2,0,2
3337,8005,Atletico-MG,2,0,Botafogo-RJ,5,0,2,5,7,0,7
3338,8006,Sao Paulo,4,0,Internacional,5,0,4,5,9,0,9
3339,8007,Coritiba,4,0,Corinthians,5,1,4,6,9,1,10
3340,8008,Fluminense,3,0,Goias,2,2,3,4,5,2,7
3341,8009,Avai,4,0,Ceara,5,0,4,5,9,0,9
3342,8010,Fortaleza,1,0,Bragantino,4,0,1,4,5,0,5
3343,8011,Juventude,7,0,Flamengo,3,0,7,3,10,0,10
3344,8012,Palmeiras,4,0,America-MG,2,0,4,2,6,0,6
3345,8013,Atletico-GO,1,0,Athletico-PR,0,0,1,0,1,0,1
3346,8014,Botafogo-RJ,2,0,Santos,4,1,2,5,6,1,7
3347,8015,Atletico-MG,1,0,Cuiaba,4,0,1,4,5,0,5
3348,8016,Flamengo,0,0,Avai,1,0,0,1,1,0,1
3349,8017,Athletico-PR,1,0,Botafogo-RJ,1,0,1,1,2,0,2
3350,8018,Ceara,4,0,Juventude,4,0,4,4,8,0,8
3351,8019,America-MG,3,0,Atletico-GO,2,1,3,3,5,1,6
3352,8020,Santos,1,0,Fortaleza,3,0,1,3,4,0,4
3353,8021,Cuiaba,1,0,Coritiba,4,1,1,5,5,1,6
3354,8022,Bragantino,3,0,Fluminense,2,0,3,2,5,0,5
3355,8023,Corinthians,3,0,Atletico-MG,6,0,3,6,9,0,9
3356,8024,Internacional,2,0,Palmeiras,3,0,2,3,5,0,5
3357,8025,Goias,2,0,Sao Paulo,1,0,2,1,3,0,3
