,ID,Unnamed: 0,campeonato,clube_mandante,clube_visitante,data,qtd_cartao_amarelo_mandante,qtd_cartao_amarelo_visitante,qtd_cartao_vermelho_mandante,qtd_cartao_vermelho_visitante,total_cartoes_amarelos,total_cartoes_mandante,total_cartoes_partida,total_cartoes_vermelhos,total_cartoes_visitante
0,4607,0.0,12,Fluminense,Figueirense,19/4/2014,0,2,0,0,2,0,2,0,2
1,4608,1.0,12,Internacional,Vitoria,19/4/2014,2,3,0,0,5,2,5,0,3
2,4609,2.0,12,Chapecoense,Coritiba,19/4/2014,0,1,0,0,1,0,1,0,1
3,4610,3.0,12,Athletico-PR,Gremio,20/4/2014,1,2,0,0,3,1,3,0,2
4,4611,4.0,12,Sao Paulo,Botafogo-RJ,20/4/2014,1,2,0,0,3,1,3,0,2
5,4612,5.0,12,Bahia,Cruzeiro,20/4/2014,4,4,0,0,8,4,8,0,4
6,4614,6.0,12,Flamengo,Goias,20/4/2014,4,2,0,0,6,4,6,0,2
7,4615,7.0,12,Santos,Sport,20/4/2014,1,3,0,0,4,1,4,0,3
8,4616,8.0,12,Criciuma,Palmeiras,20/4/2014,3,5,0,0,8,3,8,0,5
9,4617,9.0,12,Coritiba,Santos,26/4/2014,3,4,0,0,7,3,7,0,4
10,4618,10.0,12,Palmeiras,Fluminense,26/4/2014,1,2,0,0,3,1,3,0,2
11,4619,11.0,12,Botafogo-RJ,Internacional,27/4/2014,2,4,1,0,6,3,7,1,4
12,4620,12.0,12,Vitoria,Athletico-PR,27/4/2014,1,1,0,0,2,1,2,0,1
13,4621,13.0,12,Corinthians,Flamengo,27/4/2014,2,1,0,1,3,2,4,1,2
14,4622,14.0,12,Cruzeiro,Sao Paulo,27/4/2014,2,1,0,0,3,2,3,0,1
15,4623,15.0,12,Figueirense,Bahia,27/4/2014,3,2,0,0,5,3,5,0,2
16,4624,16.0,12,Gremio,Atletico-MG,27/4/2014,3,3,1,0,6,4,7,1,3
17,4625,17.0,12,Goias,Criciuma,27/4/2014,0,1,0,0,1,0,1,0,1
18,4626,18.0,12,Sport,Chapecoense,27/4/2014,1,1,0,0,2,1,2,0,1
19,4627,19.0,12,Santos,Gremio,3/5/2014,1,1,0,0,2,1,2,0,1
20,4628,20.0,12,Athletico-PR,Cruzeiro,3/5/2014,3,3,1,0,6,4,7,1,3
21,4629,21.0,12,Sao Paulo,Coritiba,3/5/2014,3,3,0,0,6,3,6,0,3
22,4630,22.0,12,Fluminense,Vitoria,3/5/2014,1,1,0,0,2,1,2,0,1
23,4631,23.0,12,Criciuma,Figueirense,4/5/2014,1,5,0,1,6,1,7,1,6
24,4632,24.0,12,Internacional,Sport,4/5/2014,2,2,0,0,4,2,4,0,2
25,4633,25.0,12,Bahia,Botafogo-RJ,4/5/2014,4,4,0,0,8,4,8,0,4
26,4634,26.0,12,Flamengo,Palmeiras,4/5/2014,2,4,0,0,6,2,6,0,4
27,4635,27.0,12,Chapecoense,Corinthians,4/5/2014,3,3,0,0,6,3,6,0,3
28,4636,28.0,12,Atletico-MG,Goias,4/5/2014,2,1,0,0,3,2,3,0,1
29,4637,29.0,12,Internacional,Athletico-PR,10/5/2014,3,1,0,0,4,3,4,0,1
30,4638,30.0,12,Palmeiras,Goias,10/5/2014,5,4,0,0,9,5,9,0,4
31,4639,31.0,12,Botafogo-RJ,Criciuma,10/5/2014,1,5,0,0,6,1,6,0,5
32,4640,32.0,12,Chapecoense,Gremio,11/5/2014,2,4,0,0,6,2,6,0,4
33,4641,33.0,12,Fluminense,Flamengo,11/5/2014,2,4,0,0,6,2,6,0,4
34,4642,34.0,12,Atletico-MG,Cruzeiro,11/5/2014,5,2,0,2,7,5,9,2,4
35,4643,35.0,12,Sao Paulo,Corinthians,11/5/2014,3,2,0,0,5,3,5,0,2
36,4644,36.0,12,Figueirense,Santos,11/5/2014,2,1,1,1,3,3,5,2,2
37,4645,37.0,12,Coritiba,Sport,11/5/2014,3,1,0,0,4,3,4,0,1
38,4646,38.0,12,Bahia,Vitoria,11/5/2014,3,3,1,1,6,4,8,2,4
39,4647,39.0,12,Goias,Botafogo-RJ,14/5/2014,3,0,0,0,3,3,3,0,0
40,4648,40.0,12,Cruzeiro,Coritiba,17/5/2014,2,1,0,0,3,2,3,0,1
41,4649,41.0,12,Gremio,Fluminense,18/5/2014,3,2,0,1,5,3,6,1,3
42,4650,42.0,12,Corinthians,Figueirense,18/5/2014,4,3,0,0,7,4,7,0,3
43,4651,43.0,12,Flamengo,Sao Paulo,18/5/2014,1,1,0,0,2,1,2,0,1
44,4652,44.0,12,Athletico-PR,Chapecoense,18/5/2014,2,2,0,0,4,2,4,0,2
45,4654,45.0,12,Criciuma,Internacional,18/5/2014,2,3,1,0,5,3,6,1,3
46,4655,46.0,12,Santos,Atletico-MG,18/5/2014,3,3,0,0,6,3,6,0,3
47,4656,47.0,12,Sport,Bahia,4/6/2014,6,4,0,2,10,6,12,2,6
48,4657,48.0,12,Coritiba,Internacional,21/5/2014,3,6,0,0,9,3,9,0,6
49,4658,49.0,12,Flamengo,Bahia,21/5/2014,3,1,0,0,4,3,4,0,1
50,4660,50.0,12,Criciuma,Chapecoense,21/5/2014,1,0,0,0,1,1,1,0,0
51,4661,51.0,12,Corinthians,Athletico-PR,21/5/2014,1,5,0,0,6,1,6,0,5
52,4662,52.0,12,Fluminense,Sao Paulo,21/5/2014,1,4,0,0,5,1,5,0,4
53,4663,53.0,12,Gremio,Botafogo-RJ,21/5/2014,2,3,0,0,5,2,5,0,3
54,4664,54.0,12,Palmeiras,Figueirense,22/5/2014,2,3,0,0,5,2,5,0,3
55,4665,55.0,12,Goias,Santos,22/5/2014,3,2,0,0,5,3,5,0,2
56,4666,56.0,12,Vitoria,Atletico-MG,22/5/2014,2,2,0,0,4,2,4,0,2
57,4667,57.0,12,Bahia,Fluminense,24/5/2014,1,0,0,0,1,1,1,0,0
58,4668,58.0,12,Sao Paulo,Gremio,24/5/2014,4,2,0,0,6,4,6,0,2
59,4669,59.0,12,Santos,Flamengo,25/5/2014,2,3,1,0,5,3,6,1,3
60,4670,60.0,12,Figueirense,Goias,25/5/2014,1,2,0,0,3,1,3,0,2
61,4671,61.0,12,Sport,Corinthians,25/5/2014,3,1,2,0,4,5,6,2,1
62,4672,62.0,12,Athletico-PR,Coritiba,25/5/2014,3,5,0,0,8,3,8,0,5
63,4673,63.0,12,Internacional,Cruzeiro,25/5/2014,1,2,0,0,3,1,3,0,2
64,4674,64.0,12,Botafogo-RJ,Vitoria,25/5/2014,4,4,0,0,8,4,8,0,4
65,4675,65.0,12,Chapecoense,Palmeiras,25/5/2014,2,2,0,0,4,2,4,0,2
66,4676,66.0,12,Atletico-MG,Criciuma,25/5/2014,2,2,0,0,4,2,4,0,2
67,4677,67.0,12,Criciuma,Coritiba,28/5/2014,5,5,0,0,10,5,10,0,5
68,4678,68.0,12,Palmeiras,Botafogo-RJ,28/5/2014,1,3,1,0,4,2,5,1,3
69,4679,69.0,12,Sport,Gremio,28/5/2014,1,2,0,0,3,1,3,0,2
70,4680,70.0,12,Internacional,Chapecoense,28/5/2014,2,4,0,0,6,2,6,0,4
71,4682,71.0,12,Corinthians,Cruzeiro,28/5/2014,2,0,0,0,2,2,2,0,0
72,4683,72.0,12,Athletico-PR,Sao Paulo,28/5/2014,2,1,0,0,3,2,3,0,1
73,4684,73.0,12,Atletico-MG,Fluminense,28/5/2014,7,4,0,1,11,7,12,1,5
74,4685,74.0,12,Flamengo,Figueirense,29/5/2014,0,1,0,0,1,0,1,0,1
75,4686,75.0,12,Bahia,Santos,29/5/2014,4,2,0,0,6,4,6,0,2
76,4687,76.0,12,Coritiba,Goias,31/5/2014,4,2,0,0,6,4,6,0,2
77,4688,77.0,12,Sao Paulo,Atletico-MG,31/5/2014,3,2,0,0,5,3,5,0,2
78,4689,78.0,12,Vitoria,Sport,31/5/2014,4,3,0,0,7,4,7,0,3
79,4690,79.0,12,Gremio,Palmeiras,1/6/2014,3,5,0,0,8,3,8,0,5
80,4691,80.0,12,Chapecoense,Bahia,1/6/2014,4,3,0,0,7,4,7,0,3
81,4692,81.0,12,Cruzeiro,Flamengo,1/6/2014,0,1,0,0,1,0,1,0,1
82,4693,82.0,12,Fluminense,Internacional,1/6/2014,2,3,0,0,5,2,5,0,3
83,4694,83.0,12,Santos,Criciuma,1/6/2014,2,4,0,0,6,2,6,0,4
84,4695,84.0,12,Figueirense,Athletico-PR,1/6/2014,4,4,0,0,8,4,8,0,4
85,4696,85.0,12,Botafogo-RJ,Corinthians,11/10/2014,3,2,1,0,5,4,6,1,2
86,4697,86.0,12,Corinthians,Botafogo-RJ,1/6/2014,0,3,0,0,3,0,3,0,3
87,4698,87.0,12,Goias,Coritiba,11/10/2014,2,2,0,0,4,2,4,0,2
88,4699,88.0,12,Palmeiras,Gremio,11/10/2014,1,5,0,1,6,1,7,1,6
89,4700,89.0,12,Flamengo,Cruzeiro,12/10/2014,2,2,0,0,4,2,4,0,2
90,4701,90.0,12,Bahia,Chapecoense,12/10/2014,1,2,0,1,3,1,4,1,3
91,4702,91.0,12,Internacional,Fluminense,12/10/2014,3,3,0,0,6,3,6,0,3
92,4703,92.0,12,Atletico-MG,Sao Paulo,12/10/2014,0,1,0,0,1,0,1,0,1
93,4704,93.0,12,Athletico-PR,Figueirense,12/10/2014,2,3,0,0,5,2,5,0,3
94,4705,94.0,12,Sport,Vitoria,12/10/2014,2,4,0,0,6,2,6,0,4
95,4706,95.0,12,Criciuma,Santos,12/10/2014,4,1,0,0,5,4,5,0,1
96,4707,96.0,12,Gremio,Goias,16/7/2014,1,4,0,0,5,1,5,0,4
97,4708,97.0,12,Coritiba,Figueirense,16/7/2014,1,2,0,0,3,1,3,0,2
98,4709,98.0,12,Sport,Botafogo-RJ,16/7/2014,1,2,0,0,3,1,3,0,2
99,4710,99.0,12,Criciuma,Fluminense,16/7/2014,2,2,0,0,4,2,4,0,2
100,4711,100.0,12,Bahia,Sao Paulo,16/7/2014,4,4,0,0,8,4,8,0,4
101,4712,101.0,12,Flamengo,Athletico-PR,16/7/2014,1,3,0,0,4,1,4,0,3
102,4713,102.0,12,Corinthians,Internacional,17/7/2014,3,4,0,0,7,3,7,0,4
103,4714,103.0,12,Santos,Palmeiras,17/7/2014,1,3,0,0,4,1,4,0,3
104,4715,104.0,12,Cruzeiro,Vitoria,17/7/2014,0,3,0,0,3,0,3,0,3
105,4716,105.0,12,Chapecoense,Atletico-MG,6/8/2014,1,1,0,0,2,1,2,0,1
106,4717,106.0,12,Sao Paulo,Chapecoense,19/7/2014,3,3,0,0,6,3,6,0,3
107,4718,107.0,12,Figueirense,Gremio,19/7/2014,1,6,1,0,7,2,8,1,6
108,4719,108.0,12,Atletico-MG,Bahia,19/7/2014,3,4,0,0,7,3,7,0,4
109,4720,109.0,12,Botafogo-RJ,Coritiba,19/7/2014,2,1,0,0,3,2,3,0,1
110,4721,110.0,12,Internacional,Flamengo,20/7/2014,0,1,0,1,1,0,2,1,2
111,4722,111.0,12,Palmeiras,Cruzeiro,20/7/2014,3,5,0,0,8,3,8,0,5
112,4723,112.0,12,Vitoria,Corinthians,20/7/2014,1,1,0,0,2,1,2,0,1
113,4724,113.0,12,Athletico-PR,Criciuma,20/7/2014,1,1,0,0,2,1,2,0,1
114,4725,114.0,12,Fluminense,Santos,20/7/2014,2,1,0,0,3,2,3,0,1
115,4726,115.0,12,Goias,Sport,20/7/2014,1,3,0,0,4,1,4,0,3
116,4727,116.0,12,Santos,Chapecoense,26/7/2014,2,1,0,0,3,2,3,0,1
117,4728,117.0,12,Cruzeiro,Figueirense,26/7/2014,0,2,0,0,2,0,2,0,2
118,4729,118.0,12,Criciuma,Vitoria,26/7/2014,3,3,1,0,6,4,7,1,3
119,4730,119.0,12,Bahia,Internacional,26/7/2014,2,2,0,0,4,2,4,0,2
120,4731,120.0,12,Goias,Sao Paulo,27/7/2014,2,1,0,0,3,2,3,0,1
121,4732,121.0,12,Athletico-PR,Fluminense,27/7/2014,3,1,0,0,4,3,4,0,1
122,4733,122.0,12,Corinthians,Palmeiras,27/7/2014,1,2,0,0,3,1,3,0,2
123,4734,123.0,12,Sport,Atletico-MG,27/7/2014,0,3,0,0,3,0,3,0,3
124,4735,124.0,12,Flamengo,Botafogo-RJ,27/7/2014,3,4,1,0,7,4,8,1,4
125,4736,125.0,12,Gremio,Coritiba,27/7/2014,1,2,0,0,3,1,3,0,2
126,4737,126.0,12,Botafogo-RJ,Cruzeiro,2/8/2014,2,1,0,0,3,2,3,0,1
127,4738,127.0,12,Sao Paulo,Criciuma,2/8/2014,1,1,0,0,2,1,2,0,1
128,4740,128.0,12,Palmeiras,Bahia,3/8/2014,3,3,0,0,6,3,6,0,3
129,4741,129.0,12,Chapecoense,Flamengo,3/8/2014,4,1,0,0,5,4,5,0,1
130,4742,130.0,12,Coritiba,Corinthians,3/8/2014,3,2,0,1,5,3,6,1,3
131,4743,131.0,12,Figueirense,Sport,3/8/2014,1,1,0,0,2,1,2,0,1
132,4744,132.0,12,Internacional,Santos,3/8/2014,4,2,1,1,6,5,8,2,3
133,4745,133.0,12,Fluminense,Goias,3/8/2014,1,1,0,0,2,1,2,0,1
134,4746,134.0,12,Atletico-MG,Athletico-PR,3/8/2014,2,3,0,0,5,2,5,0,3
135,4747,135.0,12,Criciuma,Cruzeiro,9/8/2014,3,1,0,0,4,3,4,0,1
136,4748,136.0,12,Bahia,Goias,9/8/2014,4,2,0,0,6,4,6,0,2
137,4749,137.0,12,Fluminense,Coritiba,9/8/2014,3,1,0,0,4,3,4,0,1
138,4750,138.0,12,Flamengo,Sport,10/8/2014,2,1,0,0,3,2,3,0,1
139,4751,139.0,12,Santos,Corinthians,10/8/2014,3,3,1,0,6,4,7,1,3
140,4752,140.0,12,Athletico-PR,Botafogo-RJ,10/8/2014,0,3,0,0,3,0,3,0,3
141,4753,141.0,12,Internacional,Gremio,10/8/2014,3,5,0,0,8,3,8,0,5
142,4754,142.0,12,Atletico-MG,Palmeiras,10/8/2014,2,2,0,0,4,2,4,0,2
143,4755,143.0,12,Chapecoense,Figueirense,10/8/2014,2,2,0,0,4,2,4,0,2
144,4756,144.0,12,Sao Paulo,Vitoria,10/8/2014,5,2,0,0,7,5,7,0,2
145,4757,145.0,12,Goias,Internacional,16/8/2014,1,1,0,0,2,1,2,0,1
146,4758,146.0,12,Corinthians,Bahia,16/8/2014,1,4,0,0,5,1,5,0,4
147,4759,147.0,12,Coritiba,Flamengo,17/8/2014,2,4,1,0,6,3,7,1,4
148,4760,148.0,12,Palmeiras,Sao Paulo,17/8/2014,2,4,0,0,6,2,6,0,4
149,4761,149.0,12,Gremio,Criciuma,17/8/2014,1,2,0,0,3,1,3,0,2
150,4762,150.0,12,Cruzeiro,Santos,17/8/2014,3,1,0,0,4,3,4,0,1
151,4763,151.0,12,Vitoria,Chapecoense,17/8/2014,1,1,0,0,2,1,2,0,1
152,4764,152.0,12,Botafogo-RJ,Fluminense,17/8/2014,4,2,0,0,6,4,6,0,2
153,4765,153.0,12,Sport,Athletico-PR,17/8/2014,4,3,0,0,7,4,7,0,3
154,4766,154.0,12,Figueirense,Atletico-MG,17/8/2014,6,5,0,0,11,6,11,0,5
155,4767,155.0,12,Sport,Palmeiras,20/8/2014,0,1,0,0,1,0,1,0,1
156,4768,156.0,12,Figueirense,Botafogo-RJ,20/8/2014,1,2,0,0,3,1,3,0,2
157,4769,157.0,12,Santos,Athletico-PR,20/8/2014,0,2,0,0,2,0,2,0,2
158,4770,158.0,12,Coritiba,Vitoria,20/8/2014,3,1,0,0,4,3,4,0,1
159,4771,159.0,12,Bahia,Criciuma,20/8/2014,2,5,0,0,7,2,7,0,5
160,4772,160.0,12,Chapecoense,Fluminense,20/8/2014,2,3,0,1,5,2,6,1,4
161,4773,161.0,12,Flamengo,Atletico-MG,20/8/2014,2,2,0,0,4,2,4,0,2
162,4774,162.0,12,Internacional,Sao Paulo,20/8/2014,1,1,0,0,2,1,2,0,1
163,4775,163.0,12,Corinthians,Goias,21/8/2014,1,3,0,0,4,1,4,0,3
164,4776,164.0,12,Cruzeiro,Gremio,21/8/2014,5,3,0,0,8,5,8,0,3
165,4777,165.0,12,Atletico-MG,Internacional,23/8/2014,3,2,0,0,5,3,5,0,2
166,4778,166.0,12,Botafogo-RJ,Chapecoense,23/8/2014,2,1,0,0,3,2,3,0,1
167,4779,167.0,12,Palmeiras,Coritiba,23/8/2014,6,4,0,1,10,6,11,1,5
168,4780,168.0,12,Gremio,Corinthians,24/8/2014,2,3,0,1,5,2,6,1,4
169,4781,169.0,12,Criciuma,Flamengo,24/8/2014,2,0,1,0,2,3,3,1,0
170,4782,170.0,12,Vitoria,Figueirense,24/8/2014,2,2,0,0,4,2,4,0,2
171,4783,171.0,12,Sao Paulo,Santos,24/8/2014,5,3,0,0,8,5,8,0,3
172,4784,172.0,12,Fluminense,Sport,24/8/2014,1,0,0,0,1,1,1,0,0
173,4785,173.0,12,Goias,Cruzeiro,24/8/2014,4,3,0,0,7,4,7,0,3
174,4786,174.0,12,Athletico-PR,Bahia,24/8/2014,1,1,0,0,2,1,2,0,1
175,4787,175.0,12,Palmeiras,Internacional,30/8/2014,2,3,0,0,5,2,5,0,3
176,4788,176.0,12,Cruzeiro,Chapecoense,30/8/2014,4,3,0,0,7,4,7,0,3
177,4789,177.0,12,Corinthians,Fluminense,31/8/2014,3,2,0,0,5,3,5,0,2
178,4790,178.0,12,Coritiba,Atletico-MG,31/8/2014,2,4,0,0,6,2,6,0,4
179,4791,179.0,12,Sport,Criciuma,31/8/2014,3,4,0,0,7,3,7,0,4
180,4792,180.0,12,Figueirense,Sao Paulo,31/8/2014,1,2,0,1,3,1,4,1,3
181,4793,181.0,12,Botafogo-RJ,Santos,31/8/2014,2,2,0,0,4,2,4,0,2
182,4794,182.0,12,Gremio,Bahia,31/8/2014,4,3,0,0,7,4,7,0,3
183,4796,183.0,12,Vitoria,Flamengo,31/8/2014,2,3,0,0,5,2,5,0,3
184,4797,184.0,12,Santos,Vitoria,6/9/2014,1,6,0,0,7,1,7,0,6
185,4798,185.0,12,Flamengo,Gremio,6/9/2014,1,2,0,0,3,1,3,0,2
186,4799,186.0,12,Chapecoense,Goias,6/9/2014,2,1,0,0,3,2,3,0,1
187,4800,187.0,12,Sao Paulo,Sport,7/9/2014,0,2,0,0,2,0,2,0,2
188,4801,188.0,12,Criciuma,Corinthians,7/9/2014,5,3,0,0,8,5,8,0,3
189,4802,189.0,12,Atletico-MG,Botafogo-RJ,7/9/2014,3,3,0,1,6,3,7,1,4
190,4803,190.0,12,Fluminense,Cruzeiro,7/9/2014,1,4,0,0,5,1,5,0,4
191,4804,191.0,12,Bahia,Coritiba,7/9/2014,6,2,0,0,8,6,8,0,2
192,4805,192.0,12,Athletico-PR,Palmeiras,7/9/2014,3,0,0,1,3,3,4,1,1
193,4806,193.0,12,Internacional,Figueirense,7/9/2014,3,4,0,1,7,3,8,1,5
194,4807,194.0,12,Gremio,Athletico-PR,10/9/2014,2,3,0,0,5,2,5,0,3
195,4808,195.0,12,Palmeiras,Criciuma,10/9/2014,4,3,0,0,7,4,7,0,3
196,4809,196.0,12,Figueirense,Fluminense,10/9/2014,3,2,1,1,5,4,7,2,3
197,4810,197.0,12,Sport,Santos,10/9/2014,5,1,0,0,6,5,6,0,1
198,4811,198.0,12,Coritiba,Chapecoense,10/9/2014,3,2,0,0,5,3,5,0,2
199,4813,199.0,12,Botafogo-RJ,Sao Paulo,10/9/2014,1,2,1,0,3,2,4,1,2
200,4814,200.0,12,Vitoria,Internacional,10/9/2014,1,1,0,0,2,1,2,0,1
201,4815,201.0,12,Corinthians,Atletico-MG,11/9/2014,3,1,0,0,4,3,4,0,1
202,4816,202.0,12,Cruzeiro,Bahia,11/9/2014,1,4,0,2,5,1,7,2,6
203,4817,203.0,12,Fluminense,Palmeiras,13/9/2014,1,4,0,0,5,1,5,0,4
204,4818,204.0,12,Chapecoense,Sport,13/9/2014,1,2,0,0,3,1,3,0,2
205,4819,205.0,12,Santos,Coritiba,13/9/2014,4,3,0,0,7,4,7,0,3
206,4820,206.0,12,Bahia,Figueirense,14/9/2014,2,1,0,0,3,2,3,0,1
207,4821,207.0,12,Internacional,Botafogo-RJ,14/9/2014,2,3,0,0,5,2,5,0,3
208,4822,208.0,12,Flamengo,Corinthians,14/9/2014,2,1,0,0,3,2,3,0,1
209,4823,209.0,12,Sao Paulo,Cruzeiro,14/9/2014,3,2,0,0,5,3,5,0,2
210,4824,210.0,12,Athletico-PR,Vitoria,14/9/2014,1,2,0,0,3,1,3,0,2
211,4825,211.0,12,Atletico-MG,Gremio,14/9/2014,1,2,0,0,3,1,3,0,2
212,4826,212.0,12,Criciuma,Goias,14/9/2014,3,5,0,0,8,3,8,0,5
213,4827,213.0,12,Vitoria,Fluminense,17/9/2014,1,0,0,0,1,1,1,0,0
214,4828,214.0,12,Cruzeiro,Athletico-PR,17/9/2014,1,0,0,0,1,1,1,0,0
215,4829,215.0,12,Sport,Internacional,17/9/2014,4,1,0,0,5,4,5,0,1
216,4830,216.0,12,Figueirense,Criciuma,17/9/2014,2,4,0,0,6,2,6,0,4
217,4831,217.0,12,Botafogo-RJ,Bahia,17/9/2014,4,3,3,0,7,7,10,3,3
218,4832,218.0,12,Palmeiras,Flamengo,17/9/2014,1,4,1,0,5,2,6,1,4
219,4833,219.0,12,Coritiba,Sao Paulo,17/9/2014,5,1,0,0,6,5,6,0,1
220,4834,220.0,12,Corinthians,Chapecoense,18/9/2014,0,3,0,0,3,0,3,0,3
221,4835,221.0,12,Goias,Atletico-MG,18/9/2014,0,1,0,0,1,0,1,0,1
222,4836,222.0,12,Gremio,Santos,18/9/2014,2,0,0,0,2,2,2,0,0
223,4837,223.0,12,Athletico-PR,Internacional,20/9/2014,1,1,0,0,2,1,2,0,1
224,4838,224.0,12,Criciuma,Botafogo-RJ,20/9/2014,4,4,0,0,8,4,8,0,4
225,4839,225.0,12,Cruzeiro,Atletico-MG,21/9/2014,0,3,0,0,3,0,3,0,3
226,4840,226.0,12,Flamengo,Fluminense,21/9/2014,1,5,0,0,6,1,6,0,5
227,4841,227.0,12,Sport,Coritiba,21/9/2014,2,2,0,0,4,2,4,0,2
228,4842,228.0,12,Corinthians,Sao Paulo,21/9/2014,4,4,1,1,8,5,10,2,5
229,4843,229.0,12,Vitoria,Bahia,21/9/2014,3,4,0,0,7,3,7,0,4
230,4844,230.0,12,Santos,Figueirense,21/9/2014,1,2,0,0,3,1,3,0,2
231,4845,231.0,12,Goias,Palmeiras,21/9/2014,4,1,0,1,5,4,6,1,2
232,4846,232.0,12,Gremio,Chapecoense,21/9/2014,2,4,0,0,6,2,6,0,4
233,4847,233.0,12,Internacional,Criciuma,24/9/2014,2,3,0,0,5,2,5,0,3
234,4848,234.0,12,Coritiba,Cruzeiro,24/9/2014,4,2,0,0,6,4,6,0,2
235,4849,235.0,12,Bahia,Sport,24/9/2014,2,3,0,0,5,2,5,0,3
236,4850,236.0,12,Chapecoense,Athletico-PR,24/9/2014,1,2,0,0,3,1,3,0,2
237,4851,237.0,12,Sao Paulo,Flamengo,24/9/2014,1,3,1,0,4,2,5,1,3
238,4852,238.0,12,Figueirense,Corinthians,24/9/2014,2,1,0,0,3,2,3,0,1
239,4854,239.0,12,Palmeiras,Vitoria,25/9/2014,2,4,0,0,6,2,6,0,4
240,4855,240.0,12,Botafogo-RJ,Goias,25/9/2014,1,2,0,0,3,1,3,0,2
241,4856,241.0,12,Atletico-MG,Santos,25/9/2014,3,3,0,0,6,3,6,0,3
242,4857,242.0,12,Chapecoense,Criciuma,27/9/2014,1,3,1,1,4,2,6,2,4
243,4858,243.0,12,Sport,Cruzeiro,27/9/2014,2,1,0,0,3,2,3,0,1
244,4859,244.0,12,Sao Paulo,Fluminense,27/9/2014,4,1,0,0,5,4,5,0,1
245,4860,245.0,12,Bahia,Flamengo,28/9/2014,1,0,0,0,1,1,1,0,0
246,4861,246.0,12,Athletico-PR,Corinthians,28/9/2014,3,2,0,0,5,3,5,0,2
247,4862,247.0,12,Botafogo-RJ,Gremio,28/9/2014,3,4,0,0,7,3,7,0,4
248,4863,248.0,12,Atletico-MG,Vitoria,28/9/2014,2,2,0,0,4,2,4,0,2
249,4864,249.0,12,Figueirense,Palmeiras,28/9/2014,2,3,0,1,5,2,6,1,4
250,4865,250.0,12,Internacional,Coritiba,28/9/2014,1,1,0,0,2,1,2,0,1
251,4866,251.0,12,Santos,Goias,28/9/2014,1,2,0,0,3,1,3,0,2
252,4867,252.0,12,Palmeiras,Chapecoense,2/10/2014,0,4,0,0,4,0,4,0,4
253,4868,253.0,12,Flamengo,Santos,4/10/2014,3,2,0,0,5,3,5,0,2
254,4869,254.0,12,Fluminense,Bahia,4/10/2014,3,1,0,0,4,3,4,0,1
255,4870,255.0,12,Coritiba,Athletico-PR,4/10/2014,2,2,0,0,4,2,4,0,2
256,4871,256.0,12,Vitoria,Botafogo-RJ,4/10/2014,2,3,0,0,5,2,5,0,3
257,4872,257.0,12,Gremio,Sao Paulo,4/10/2014,5,3,0,0,8,5,8,0,3
258,4873,258.0,12,Corinthians,Sport,4/10/2014,0,1,0,0,1,0,1,0,1
259,4874,259.0,12,Cruzeiro,Internacional,4/10/2014,2,4,0,0,6,2,6,0,4
260,4875,260.0,12,Criciuma,Atletico-MG,4/10/2014,2,2,0,0,4,2,4,0,2
261,4876,261.0,12,Goias,Figueirense,4/10/2014,0,1,0,0,1,0,1,0,1
262,4877,262.0,12,Botafogo-RJ,Palmeiras,8/10/2014,3,3,0,0,6,3,6,0,3
263,4878,263.0,12,Coritiba,Criciuma,8/10/2014,1,1,0,0,2,1,2,0,1
264,4879,264.0,12,Sao Paulo,Athletico-PR,8/10/2014,3,2,0,0,5,3,5,0,2
265,4880,265.0,12,Vitoria,Goias,8/10/2014,1,1,0,0,2,1,2,0,1
266,4881,266.0,12,Cruzeiro,Corinthians,8/10/2014,1,2,0,0,3,1,3,0,2
267,4882,267.0,12,Gremio,Sport,8/10/2014,3,1,0,0,4,3,4,0,1
268,4883,268.0,12,Figueirense,Flamengo,8/10/2014,5,2,0,0,7,5,7,0,2
269,4884,269.0,12,Santos,Bahia,9/10/2014,1,1,0,0,2,1,2,0,1
270,4885,270.0,12,Fluminense,Atletico-MG,9/10/2014,1,2,0,0,3,1,3,0,2
271,4886,271.0,12,Chapecoense,Internacional,9/10/2014,0,1,0,1,1,0,2,1,2
272,4887,272.0,12,Goias,Gremio,18/10/2014,3,2,0,0,5,3,5,0,2
273,4888,273.0,12,Sao Paulo,Bahia,18/10/2014,5,2,0,0,7,5,7,0,2
274,4889,274.0,12,Fluminense,Criciuma,18/10/2014,5,5,0,1,10,5,11,1,6
275,4890,275.0,12,Atletico-MG,Chapecoense,18/10/2014,0,1,0,0,1,0,1,0,1
276,4891,276.0,12,Athletico-PR,Flamengo,19/10/2014,1,1,0,0,2,1,2,0,1
277,4892,277.0,12,Figueirense,Coritiba,19/10/2014,4,3,0,0,7,4,7,0,3
278,4893,278.0,12,Internacional,Corinthians,19/10/2014,5,5,0,0,10,5,10,0,5
279,4894,279.0,12,Palmeiras,Santos,19/10/2014,3,6,0,0,9,3,9,0,6
280,4895,280.0,12,Vitoria,Cruzeiro,19/10/2014,3,2,0,0,5,3,5,0,2
281,4896,281.0,12,Botafogo-RJ,Sport,19/10/2014,0,1,0,0,1,0,1,0,1
282,4897,282.0,12,Bahia,Atletico-MG,21/10/2014,2,3,1,1,5,3,7,2,4
283,4898,283.0,12,Corinthians,Vitoria,22/10/2014,1,1,0,0,2,1,2,0,1
284,4899,284.0,12,Flamengo,Internacional,22/10/2014,2,1,0,0,3,2,3,0,1
285,4900,285.0,12,Criciuma,Athletico-PR,22/10/2014,4,3,0,0,7,4,7,0,3
286,4901,286.0,12,Cruzeiro,Palmeiras,22/10/2014,1,4,0,0,5,1,5,0,4
287,4902,287.0,12,Gremio,Figueirense,22/10/2014,3,3,0,1,6,3,7,1,4
288,4903,288.0,12,Coritiba,Botafogo-RJ,22/10/2014,3,3,0,1,6,3,7,1,4
289,4904,289.0,12,Chapecoense,Sao Paulo,22/10/2014,2,3,0,1,5,2,6,1,4
290,4905,290.0,12,Santos,Fluminense,22/10/2014,2,1,0,0,3,2,3,0,1
291,4906,291.0,12,Sport,Goias,22/10/2014,1,4,0,0,5,1,5,0,4
292,4907,292.0,12,Figueirense,Cruzeiro,25/10/2014,1,1,0,0,2,1,2,0,1
293,4908,293.0,12,Palmeiras,Corinthians,25/10/2014,5,3,0,0,8,5,8,0,3
294,4909,294.0,12,Fluminense,Athletico-PR,25/10/2014,1,1,0,0,2,1,2,0,1
295,4910,295.0,12,Vitoria,Criciuma,25/10/2014,0,4,0,0,4,0,4,0,4
296,4911,296.0,12,Atletico-MG,Sport,25/10/2014,1,4,1,0,5,2,6,1,4
297,4912,297.0,12,Chapecoense,Santos,25/10/2014,1,4,0,0,5,1,5,0,4
298,4913,298.0,12,Coritiba,Gremio,25/10/2014,2,5,0,0,7,2,7,0,5
299,4914,299.0,12,Internacional,Bahia,25/10/2014,2,4,0,0,6,2,6,0,4
300,4915,300.0,12,Botafogo-RJ,Flamengo,25/10/2014,2,1,0,0,3,2,3,0,1
301,4916,301.0,12,Sao Paulo,Goias,27/10/2014,1,2,0,0,3,1,3,0,2
302,4917,302.0,12,Goias,Fluminense,1/11/2014,0,3,0,0,3,0,3,0,3
303,4918,303.0,12,Gremio,Vitoria,1/11/2014,0,1,0,0,1,0,1,0,1
304,4920,304.0,12,Santos,Internacional,2/11/2014,2,5,0,0,7,2,7,0,5
305,4921,305.0,12,Sport,Figueirense,2/11/2014,3,2,0,0,5,3,5,0,2
306,4922,306.0,12,Cruzeiro,Botafogo-RJ,2/11/2014,2,3,0,0,5,2,5,0,3
307,4923,307.0,12,Criciuma,Sao Paulo,2/11/2014,2,2,0,0,4,2,4,0,2
308,4924,308.0,12,Athletico-PR,Atletico-MG,2/11/2014,2,1,0,0,3,2,3,0,1
309,4925,309.0,12,Flamengo,Chapecoense,2/11/2014,2,1,0,0,3,2,3,0,1
310,4926,310.0,12,Bahia,Palmeiras,2/11/2014,4,3,0,0,7,4,7,0,3
311,4927,311.0,12,Coritiba,Fluminense,8/11/2014,2,5,0,0,7,2,7,0,5
312,4928,312.0,12,Palmeiras,Atletico-MG,8/11/2014,0,1,0,0,1,0,1,0,1
313,4929,313.0,12,Botafogo-RJ,Athletico-PR,8/11/2014,0,0,1,0,0,1,1,1,0
314,4930,314.0,12,Vitoria,Sao Paulo,9/11/2014,2,1,0,0,3,2,3,0,1
315,4931,315.0,12,Gremio,Internacional,9/11/2014,2,3,0,0,5,2,5,0,3
316,4932,316.0,12,Figueirense,Chapecoense,9/11/2014,4,0,0,0,4,4,4,0,0
317,4933,317.0,12,Sport,Flamengo,9/11/2014,3,3,0,0,6,3,6,0,3
318,4934,318.0,12,Corinthians,Santos,9/11/2014,2,2,0,0,4,2,4,0,2
319,4935,319.0,12,Cruzeiro,Criciuma,9/11/2014,5,4,0,0,9,5,9,0,4
320,4936,320.0,12,Goias,Bahia,9/11/2014,2,2,0,0,4,2,4,0,2
321,4937,321.0,12,Sao Paulo,Internacional,12/11/2014,4,3,0,1,7,4,8,1,4
322,4938,322.0,12,Botafogo-RJ,Figueirense,19/11/2014,0,4,0,0,4,0,4,0,4
323,4939,323.0,12,Athletico-PR,Santos,19/11/2014,2,1,0,0,3,2,3,0,1
324,4940,324.0,12,Goias,Corinthians,19/11/2014,2,0,0,0,2,2,2,0,0
325,4941,325.0,12,Vitoria,Coritiba,19/11/2014,3,2,0,0,5,3,5,0,2
326,4942,326.0,12,Criciuma,Bahia,19/11/2014,4,1,0,0,5,4,5,0,1
327,4943,327.0,12,Atletico-MG,Flamengo,19/11/2014,2,0,0,0,2,2,2,0,0
328,4944,328.0,12,Palmeiras,Sport,19/11/2014,2,1,0,0,3,2,3,0,1
329,4945,329.0,12,Fluminense,Chapecoense,20/11/2014,4,1,0,0,5,4,5,0,1
330,4946,330.0,12,Gremio,Cruzeiro,20/11/2014,4,3,0,0,7,4,7,0,3
331,4947,331.0,12,Criciuma,Gremio,15/11/2014,4,2,0,0,6,4,6,0,2
332,4948,332.0,12,Fluminense,Botafogo-RJ,15/11/2014,4,3,0,0,7,4,7,0,3
333,4949,333.0,12,Bahia,Corinthians,16/11/2014,2,2,0,0,4,2,4,0,2
334,4950,334.0,12,Athletico-PR,Sport,16/11/2014,2,1,0,0,3,2,3,0,1
335,4951,335.0,12,Flamengo,Coritiba,16/11/2014,1,3,0,0,4,1,4,0,3
336,4952,336.0,12,Santos,Cruzeiro,16/11/2014,2,1,0,0,3,2,3,0,1
337,4953,337.0,12,Internacional,Goias,16/11/2014,2,3,0,0,5,2,5,0,3
338,4954,338.0,12,Chapecoense,Vitoria,16/11/2014,0,3,0,0,3,0,3,0,3
339,4955,339.0,12,Sao Paulo,Palmeiras,16/11/2014,3,3,0,0,6,3,6,0,3
340,4956,340.0,12,Atletico-MG,Figueirense,16/11/2014,0,3,0,0,3,0,3,0,3
341,4957,341.0,12,Internacional,Atletico-MG,22/11/2014,4,0,0,0,4,4,4,0,0
342,4958,342.0,12,Bahia,Athletico-PR,22/11/2014,2,0,1,0,2,3,3,1,0
343,4959,343.0,12,Santos,Sao Paulo,23/11/2014,3,1,0,0,4,3,4,0,1
344,4960,344.0,12,Flamengo,Criciuma,23/11/2014,1,4,0,0,5,1,5,0,4
345,4961,345.0,12,Sport,Fluminense,23/11/2014,4,1,0,0,5,4,5,0,1
346,4962,346.0,12,Cruzeiro,Goias,23/11/2014,1,2,0,0,3,1,3,0,2
347,4963,347.0,12,Figueirense,Vitoria,23/11/2014,2,3,0,0,5,2,5,0,3
348,4964,348.0,12,Corinthians,Gremio,23/11/2014,1,2,0,0,3,1,3,0,2
349,4965,349.0,12,Chapecoense,Botafogo-RJ,23/11/2014,3,2,0,0,5,3,5,0,2
350,4966,350.0,12,Coritiba,Palmeiras,23/11/2014,3,4,0,0,7,3,7,0,4
351,4967,351.0,12,Criciuma,Sport,29/11/2014,4,0,0,0,4,4,4,0,0
352,4968,352.0,12,Internacional,Palmeiras,29/11/2014,2,1,1,2,3,3,6,3,3
353,4969,353.0,12,Flamengo,Vitoria,29/11/2014,3,4,0,1,7,3,8,1,5
354,4970,354.0,12,Sao Paulo,Figueirense,30/11/2014,2,4,0,1,6,2,7,1,5
355,4971,355.0,12,Santos,Botafogo-RJ,30/11/2014,1,1,0,0,2,1,2,0,1
356,4972,356.0,12,Fluminense,Corinthians,30/11/2014,2,4,1,0,6,3,7,1,4
357,4973,357.0,12,Chapecoense,Cruzeiro,30/11/2014,2,0,0,0,2,2,2,0,0
358,4974,358.0,12,Atletico-MG,Coritiba,30/11/2014,3,4,0,0,7,3,7,0,4
359,4975,359.0,12,Athletico-PR,Goias,30/11/2014,3,5,0,2,8,3,10,2,7
360,4976,360.0,12,Bahia,Gremio,30/11/2014,2,2,0,1,4,2,5,1,3
361,4977,361.0,12,Corinthians,Criciuma,6/12/2014,2,2,0,0,4,2,4,0,2
362,4978,362.0,12,Figueirense,Internacional,6/12/2014,2,3,3,2,5,5,10,5,5
363,4979,363.0,12,Coritiba,Bahia,7/12/2014,3,1,0,0,4,3,4,0,1
364,4980,364.0,12,Vitoria,Santos,7/12/2014,0,3,0,0,3,0,3,0,3
365,4981,365.0,12,Sport,Sao Paulo,7/12/2014,0,1,0,0,1,0,1,0,1
366,4982,366.0,12,Botafogo-RJ,Atletico-MG,7/12/2014,3,3,0,0,6,3,6,0,3
367,4983,367.0,12,Palmeiras,Athletico-PR,7/12/2014,1,1,0,0,2,1,2,0,1
368,4984,368.0,12,Gremio,Flamengo,7/12/2014,3,0,0,1,3,3,4,1,1
369,4985,369.0,12,Cruzeiro,Fluminense,7/12/2014,1,4,0,0,5,1,5,0,4
370,4986,370.0,12,Goias,Chapecoense,7/12/2014,2,1,0,0,3,2,3,0,1
371,4987,371.0,13,Chapecoense,Coritiba,9/5/2015,2,2,0,0,4,2,4,0,2
372,4988,372.0,13,Palmeiras,Atletico-MG,9/5/2015,2,4,0,0,6,2,6,0,4
373,4989,373.0,13,Fluminense,Joinville,9/5/2015,2,1,0,1,3,2,4,1,2
374,4990,374.0,13,Gremio,Ponte Preta,10/5/2015,3,5,0,1,8,3,9,1,6
375,4991,375.0,13,Athletico-PR,Internacional,10/5/2015,1,2,0,0,3,1,3,0,2
376,4992,376.0,13,Sao Paulo,Flamengo,10/5/2015,2,1,0,0,3,2,3,0,1
377,4993,377.0,13,Cruzeiro,Corinthians,10/5/2015,3,1,0,0,4,3,4,0,1
378,4994,378.0,13,Sport,Figueirense,10/5/2015,1,3,0,1,4,1,5,1,4
379,4995,379.0,13,Avai,Santos,10/5/2015,2,2,0,1,4,2,5,1,3
380,4996,380.0,13,Vasco,Goias,10/5/2015,3,5,0,0,8,3,8,0,5
381,4997,381.0,13,Goias,Athletico-PR,16/5/2015,2,1,0,1,3,2,4,1,2
382,4998,382.0,13,Coritiba,Gremio,16/5/2015,2,3,0,0,5,2,5,0,3
383,4999,383.0,13,Corinthians,Chapecoense,16/5/2015,2,4,0,0,6,2,6,0,4
384,5000,384.0,13,Figueirense,Vasco,17/5/2015,2,6,0,0,8,2,8,0,6
385,5001,385.0,13,Atletico-MG,Fluminense,17/5/2015,2,1,0,0,3,2,3,0,1
386,5002,386.0,13,Flamengo,Sport,17/5/2015,2,3,0,0,5,2,5,0,3
387,5003,387.0,13,Santos,Cruzeiro,17/5/2015,1,4,0,0,5,1,5,0,4
388,5004,388.0,13,Joinville,Palmeiras,17/5/2015,3,1,0,0,4,3,4,0,1
389,5005,389.0,13,Ponte Preta,Sao Paulo,17/5/2015,1,3,0,0,4,1,4,0,3
390,5006,390.0,13,Internacional,Avai,17/5/2015,3,7,0,0,10,3,10,0,7
391,5007,391.0,13,Sao Paulo,Joinville,23/5/2015,2,0,0,0,2,2,2,0,0
392,5008,392.0,13,Vasco,Internacional,23/5/2015,6,3,0,1,9,6,10,1,4
393,5009,393.0,13,Gremio,Figueirense,23/5/2015,6,5,0,0,11,6,11,0,5
394,5010,394.0,13,Palmeiras,Goias,24/5/2015,6,5,1,1,11,7,13,2,6
395,5011,395.0,13,Chapecoense,Santos,24/5/2015,5,6,0,0,11,5,11,0,6
396,5012,396.0,13,Athletico-PR,Atletico-MG,24/5/2015,4,0,1,0,4,5,5,1,0
397,5013,397.0,13,Fluminense,Corinthians,24/5/2015,2,2,0,0,4,2,4,0,2
398,5014,398.0,13,Avai,Flamengo,24/5/2015,5,6,0,0,11,5,11,0,6
399,5015,399.0,13,Cruzeiro,Ponte Preta,24/5/2015,2,2,0,0,4,2,4,0,2
400,5016,400.0,13,Sport,Coritiba,24/5/2015,1,4,0,0,5,1,5,0,4
401,5017,401.0,13,Ponte Preta,Chapecoense,30/5/2015,4,2,0,1,6,4,7,1,3
402,5018,402.0,13,Coritiba,Avai,30/5/2015,4,4,0,0,8,4,8,0,4
403,5019,403.0,13,Joinville,Athletico-PR,30/5/2015,0,4,0,0,4,0,4,0,4
404,5020,404.0,13,Santos,Sport,31/5/2015,1,2,0,0,3,1,3,0,2
405,5021,405.0,13,Goias,Gremio,31/5/2015,1,1,0,0,2,1,2,0,1
406,5022,406.0,13,Atletico-MG,Vasco,31/5/2015,0,3,0,0,3,0,3,0,3
407,5023,407.0,13,Corinthians,Palmeiras,31/5/2015,5,5,0,0,10,5,10,0,5
408,5024,408.0,13,Internacional,Sao Paulo,31/5/2015,3,1,0,1,4,3,5,1,2
409,5025,409.0,13,Flamengo,Fluminense,31/5/2015,6,3,1,1,9,7,11,2,4
410,5026,410.0,13,Figueirense,Cruzeiro,31/5/2015,3,6,0,1,9,3,10,1,7
411,5027,411.0,13,Athletico-PR,Figueirense,3/6/2015,1,4,0,0,5,1,5,0,4
412,5028,412.0,13,Vasco,Ponte Preta,3/6/2015,2,3,2,0,5,4,7,2,3
413,5029,413.0,13,Chapecoense,Joinville,3/6/2015,3,5,0,0,8,3,8,0,5
414,5030,414.0,13,Sao Paulo,Santos,3/6/2015,5,3,0,1,8,5,9,1,4
415,5031,415.0,13,Cruzeiro,Flamengo,3/6/2015,2,3,0,0,5,2,5,0,3
416,5032,416.0,13,Avai,Atletico-MG,3/6/2015,3,3,0,0,6,3,6,0,3
417,5033,417.0,13,Gremio,Corinthians,3/6/2015,2,3,0,0,5,2,5,0,3
418,5034,418.0,13,Fluminense,Coritiba,4/6/2015,1,4,0,0,5,1,5,0,4
419,5035,419.0,13,Sport,Goias,4/6/2015,2,4,0,0,6,2,6,0,4
420,5036,420.0,13,Palmeiras,Internacional,4/6/2015,1,4,0,0,5,1,5,0,4
421,5038,421.0,13,Flamengo,Chapecoense,6/6/2015,1,0,0,1,1,1,2,1,1
422,5039,422.0,13,Santos,Ponte Preta,6/6/2015,2,2,0,0,4,2,4,0,2
423,5040,423.0,13,Athletico-PR,Vasco,6/6/2015,4,3,0,0,7,4,7,0,3
424,5041,424.0,13,Joinville,Corinthians,6/6/2015,1,1,0,0,2,1,2,0,1
425,5042,425.0,13,Sao Paulo,Gremio,6/6/2015,3,2,0,0,5,3,5,0,2
426,5043,426.0,13,Internacional,Coritiba,7/6/2015,4,5,1,0,9,5,10,1,5
427,5044,427.0,13,Figueirense,Palmeiras,7/6/2015,3,3,0,0,6,3,6,0,3
428,5045,428.0,13,Goias,Avai,7/6/2015,2,4,0,0,6,2,6,0,4
429,5046,429.0,13,Fluminense,Sport,7/6/2015,3,2,0,0,5,3,5,0,2
430,5047,430.0,13,Atletico-MG,Santos,10/6/2015,1,4,0,0,5,1,5,0,4
431,5048,431.0,13,Coritiba,Flamengo,13/6/2015,2,4,0,1,6,2,7,1,5
432,5049,432.0,13,Chapecoense,Sao Paulo,13/6/2015,2,4,0,0,6,2,6,0,4
433,5050,433.0,13,Corinthians,Internacional,13/6/2015,0,2,0,0,2,0,2,0,2
434,5051,434.0,13,Sport,Joinville,13/6/2015,0,4,0,0,4,0,4,0,4
435,5052,435.0,13,Vasco,Cruzeiro,13/6/2015,2,4,0,0,6,2,6,0,4
436,5053,436.0,13,Ponte Preta,Goias,14/6/2015,3,3,0,0,6,3,6,0,3
437,5054,437.0,13,Avai,Figueirense,14/6/2015,4,3,0,0,7,4,7,0,3
438,5055,438.0,13,Palmeiras,Fluminense,14/6/2015,0,7,0,2,7,0,9,2,9
439,5056,439.0,13,Gremio,Athletico-PR,14/6/2015,1,4,0,0,5,1,5,0,4
440,5057,440.0,13,Figueirense,Internacional,18/6/2015,4,2,0,0,6,4,6,0,2
441,5058,441.0,13,Sport,Vasco,20/6/2015,2,3,0,0,5,2,5,0,3
442,5059,442.0,13,Flamengo,Atletico-MG,20/6/2015,0,1,0,1,1,0,2,1,2
443,5060,443.0,13,Santos,Corinthians,20/6/2015,5,4,1,1,9,6,11,2,5
444,5061,444.0,13,Gremio,Palmeiras,20/6/2015,4,3,0,0,7,4,7,0,3
445,5062,445.0,13,Cruzeiro,Chapecoense,21/6/2015,4,3,0,0,7,4,7,0,3
446,5063,446.0,13,Joinville,Goias,21/6/2015,4,5,1,1,9,5,11,2,6
447,5064,447.0,13,Athletico-PR,Coritiba,21/6/2015,2,5,0,2,7,2,9,2,7
448,5065,448.0,13,Sao Paulo,Avai,21/6/2015,1,5,0,0,6,1,6,0,5
449,5066,449.0,13,Fluminense,Ponte Preta,24/6/2015,2,3,0,0,5,2,5,0,3
450,5067,450.0,13,Avai,Gremio,27/6/2015,3,3,0,0,6,3,6,0,3
451,5068,451.0,13,Chapecoense,Sport,27/6/2015,1,6,0,0,7,1,7,0,6
452,5069,452.0,13,Corinthians,Figueirense,27/6/2015,0,2,0,0,2,0,2,0,2
453,5070,453.0,13,Atletico-MG,Joinville,28/6/2015,2,1,0,0,3,2,3,0,1
454,5071,454.0,13,Palmeiras,Sao Paulo,28/6/2015,1,3,0,0,4,1,4,0,3
455,5072,455.0,13,Goias,Fluminense,28/6/2015,2,2,0,1,4,2,5,1,3
456,5073,456.0,13,Ponte Preta,Athletico-PR,28/6/2015,1,2,0,0,3,1,3,0,2
457,5074,457.0,13,Coritiba,Cruzeiro,28/6/2015,5,5,0,0,10,5,10,0,5
458,5075,458.0,13,Vasco,Flamengo,28/6/2015,4,0,0,0,4,4,4,0,0
459,5076,459.0,13,Internacional,Santos,28/6/2015,3,3,0,1,6,3,7,1,4
460,5077,460.0,13,Sport,Internacional,1/7/2015,2,2,0,1,4,2,5,1,3
461,5078,461.0,13,Vasco,Avai,1/7/2015,3,2,1,1,5,4,7,2,3
462,5079,462.0,13,Palmeiras,Chapecoense,1/7/2015,0,3,0,0,3,0,3,0,3
463,5080,463.0,13,Atletico-MG,Coritiba,1/7/2015,3,5,0,0,8,3,8,0,5
464,5081,464.0,13,Joinville,Flamengo,1/7/2015,3,2,0,0,5,3,5,0,2
465,5082,465.0,13,Gremio,Cruzeiro,1/7/2015,5,6,0,0,11,5,11,0,6
466,5083,466.0,13,Athletico-PR,Sao Paulo,1/7/2015,2,0,0,0,2,2,2,0,0
467,5084,467.0,13,Corinthians,Ponte Preta,2/7/2015,1,2,0,0,3,1,3,0,2
468,5085,468.0,13,Figueirense,Goias,2/7/2015,2,2,1,0,4,3,5,1,2
469,5086,469.0,13,Fluminense,Santos,2/7/2015,2,3,0,0,5,2,5,0,3
470,5087,470.0,13,Coritiba,Joinville,4/7/2015,1,2,0,0,3,1,3,0,2
471,5088,471.0,13,Chapecoense,Vasco,4/7/2015,1,2,0,2,3,1,5,2,4
472,5089,472.0,13,Cruzeiro,Athletico-PR,4/7/2015,0,2,0,1,2,0,3,1,3
473,5090,473.0,13,Avai,Sport,5/7/2015,6,2,1,0,8,7,9,1,2
474,5091,474.0,13,Goias,Corinthians,5/7/2015,2,2,0,0,4,2,4,0,2
475,5092,475.0,13,Sao Paulo,Fluminense,5/7/2015,1,2,0,0,3,1,3,0,2
476,5093,476.0,13,Santos,Gremio,5/7/2015,4,1,1,0,5,5,6,1,1
477,5094,477.0,13,Ponte Preta,Palmeiras,5/7/2015,3,3,0,0,6,3,6,0,3
478,5095,478.0,13,Flamengo,Figueirense,5/7/2015,3,2,0,0,5,3,5,0,2
479,5096,479.0,13,Internacional,Atletico-MG,5/7/2015,1,3,1,0,4,2,5,1,3
480,5097,480.0,13,Chapecoense,Gremio,8/7/2015,1,2,0,0,3,1,3,0,2
481,5098,481.0,13,Goias,Santos,8/7/2015,0,3,0,0,3,0,3,0,3
482,5099,482.0,13,Coritiba,Ponte Preta,8/7/2015,4,6,0,0,10,4,10,0,6
483,5100,483.0,13,Figueirense,Joinville,8/7/2015,1,2,0,0,3,1,3,0,2
484,5101,484.0,13,Palmeiras,Avai,8/7/2015,2,6,0,0,8,2,8,0,6
485,5102,485.0,13,Atletico-MG,Sport,8/7/2015,2,2,0,0,4,2,4,0,2
486,5103,486.0,13,Internacional,Flamengo,8/7/2015,3,2,0,0,5,3,5,0,2
487,5104,487.0,13,Vasco,Sao Paulo,8/7/2015,3,0,0,0,3,3,3,0,0
488,5105,488.0,13,Corinthians,Athletico-PR,9/7/2015,1,2,0,0,3,1,3,0,2
489,5106,489.0,13,Fluminense,Cruzeiro,9/7/2015,2,2,0,0,4,2,4,0,2
490,5107,490.0,13,Santos,Figueirense,11/7/2015,1,5,0,0,6,1,6,0,5
491,5108,491.0,13,Gremio,Vasco,11/7/2015,1,3,0,0,4,1,4,0,3
492,5109,492.0,13,Ponte Preta,Atletico-MG,11/7/2015,1,3,0,0,4,1,4,0,3
493,5110,493.0,13,Sao Paulo,Coritiba,12/7/2015,1,3,0,0,4,1,4,0,3
494,5111,494.0,13,Joinville,Internacional,12/7/2015,4,3,0,0,7,4,7,0,3
495,5112,495.0,13,Flamengo,Corinthians,12/7/2015,0,2,0,0,2,0,2,0,2
496,5113,496.0,13,Athletico-PR,Fluminense,12/7/2015,1,2,0,0,3,1,3,0,2
497,5114,497.0,13,Cruzeiro,Goias,12/7/2015,2,1,0,0,3,2,3,0,1
498,5115,498.0,13,Sport,Palmeiras,12/7/2015,2,1,0,0,3,2,3,0,1
499,5116,499.0,13,Avai,Chapecoense,12/7/2015,4,2,0,0,6,4,6,0,2
500,5117,500.0,13,Internacional,Goias,18/7/2015,1,1,0,0,2,1,2,0,1
501,5118,501.0,13,Flamengo,Gremio,18/7/2015,1,5,0,0,6,1,6,0,5
502,5119,502.0,13,Corinthians,Atletico-MG,18/7/2015,1,1,0,0,2,1,2,0,1
503,5120,503.0,13,Athletico-PR,Chapecoense,19/7/2015,2,3,0,0,5,2,5,0,3
504,5121,504.0,13,Figueirense,Coritiba,19/7/2015,1,2,0,0,3,1,3,0,2
505,5122,505.0,13,Sport,Sao Paulo,19/7/2015,1,2,0,2,3,1,5,2,4
506,5123,506.0,13,Fluminense,Vasco,19/7/2015,2,6,0,0,8,2,8,0,6
507,5124,507.0,13,Palmeiras,Santos,19/7/2015,3,3,0,0,6,3,6,0,3
508,5125,508.0,13,Cruzeiro,Avai,19/7/2015,1,3,0,0,4,1,4,0,3
509,5126,509.0,13,Joinville,Ponte Preta,19/7/2015,2,5,0,0,7,2,7,0,5
510,5127,510.0,13,Avai,Athletico-PR,25/7/2015,3,3,0,0,6,3,6,0,3
511,5129,511.0,13,Atletico-MG,Figueirense,25/7/2015,2,4,0,0,6,2,6,0,4
512,5130,512.0,13,Chapecoense,Fluminense,26/7/2015,2,3,0,1,5,2,6,1,4
513,5131,513.0,13,Santos,Joinville,26/7/2015,2,2,0,0,4,2,4,0,2
514,5132,514.0,13,Ponte Preta,Internacional,26/7/2015,2,2,0,0,4,2,4,0,2
515,5133,515.0,13,Coritiba,Corinthians,26/7/2015,3,3,0,0,6,3,6,0,3
516,5134,516.0,13,Sao Paulo,Cruzeiro,26/7/2015,0,1,0,0,1,0,1,0,1
517,5135,517.0,13,Goias,Flamengo,26/7/2015,2,1,0,0,3,2,3,0,1
518,5136,518.0,13,Vasco,Palmeiras,26/7/2015,3,1,0,0,4,3,4,0,1
519,5137,519.0,13,Corinthians,Vasco,29/7/2015,0,3,0,0,3,0,3,0,3
520,5138,520.0,13,Atletico-MG,Sao Paulo,29/7/2015,0,1,0,0,1,0,1,0,1
521,5139,521.0,13,Fluminense,Gremio,1/8/2015,3,2,0,1,5,3,6,1,3
522,5140,522.0,13,Coritiba,Goias,2/8/2015,4,4,0,0,8,4,8,0,4
523,5141,523.0,13,Palmeiras,Athletico-PR,2/8/2015,1,2,0,0,3,1,3,0,2
524,5142,524.0,13,Joinville,Avai,2/8/2015,2,1,0,0,3,2,3,0,1
525,5143,525.0,13,Internacional,Chapecoense,2/8/2015,3,2,0,0,5,3,5,0,2
526,5144,526.0,13,Figueirense,Ponte Preta,2/8/2015,2,3,0,0,5,2,5,0,3
527,5145,527.0,13,Flamengo,Santos,2/8/2015,4,2,0,0,6,4,6,0,2
528,5146,528.0,13,Sport,Cruzeiro,2/8/2015,1,2,0,0,3,1,3,0,2
529,5147,529.0,13,Avai,Fluminense,8/8/2015,2,2,0,0,4,2,4,0,2
530,5148,530.0,13,Santos,Coritiba,8/8/2015,1,4,0,0,5,1,5,0,4
531,5150,531.0,13,Vasco,Joinville,9/8/2015,2,4,0,0,6,2,6,0,4
532,5151,532.0,13,Sao Paulo,Corinthians,9/8/2015,4,2,0,1,6,4,7,1,3
533,5152,533.0,13,Cruzeiro,Palmeiras,9/8/2015,4,3,0,0,7,4,7,0,3
534,5153,534.0,13,Ponte Preta,Flamengo,9/8/2015,2,4,0,0,6,2,6,0,4
535,5154,535.0,13,Goias,Atletico-MG,9/8/2015,2,2,0,0,4,2,4,0,2
536,5155,536.0,13,Gremio,Internacional,9/8/2015,2,4,0,0,6,2,6,0,4
537,5156,537.0,13,Chapecoense,Figueirense,9/8/2015,1,1,0,0,2,1,2,0,1
538,5157,538.0,13,Coritiba,Palmeiras,12/8/2015,3,1,0,0,4,3,4,0,1
539,5158,539.0,13,Flamengo,Athletico-PR,12/8/2015,2,4,0,1,6,2,7,1,5
540,5159,540.0,13,Santos,Vasco,12/8/2015,3,5,0,1,8,3,9,1,6
541,5160,541.0,13,Goias,Chapecoense,12/8/2015,1,3,0,0,4,1,4,0,3
542,5161,542.0,13,Figueirense,Sao Paulo,12/8/2015,3,4,0,1,7,3,8,1,5
543,5162,543.0,13,Internacional,Fluminense,12/8/2015,6,4,0,2,10,6,12,2,6
544,5163,544.0,13,Corinthians,Sport,12/8/2015,2,1,0,0,3,2,3,0,1
545,5164,545.0,13,Ponte Preta,Avai,13/8/2015,1,1,0,0,2,1,2,0,1
546,5165,546.0,13,Joinville,Cruzeiro,13/8/2015,1,2,0,0,3,1,3,0,2
547,5166,547.0,13,Atletico-MG,Gremio,13/8/2015,2,3,0,0,5,2,5,0,3
548,5167,548.0,13,Vasco,Coritiba,15/8/2015,3,1,0,0,4,3,4,0,1
549,5168,549.0,13,Athletico-PR,Santos,15/8/2015,2,1,1,0,3,3,4,1,1
550,5169,550.0,13,Sao Paulo,Goias,15/8/2015,1,0,0,0,1,1,1,0,0
551,5170,551.0,13,Palmeiras,Flamengo,16/8/2015,2,2,0,0,4,2,4,0,2
552,5171,552.0,13,Avai,Corinthians,16/8/2015,0,1,0,0,1,0,1,0,1
553,5172,553.0,13,Fluminense,Figueirense,16/8/2015,1,2,0,1,3,1,4,1,3
554,5173,554.0,13,Cruzeiro,Internacional,16/8/2015,2,2,0,0,4,2,4,0,2
555,5175,555.0,13,Gremio,Joinville,16/8/2015,1,0,0,0,1,1,1,0,0
556,5176,556.0,13,Chapecoense,Atletico-MG,16/8/2015,4,3,0,1,7,4,8,1,4
557,5177,557.0,13,Goias,Vasco,22/8/2015,3,3,0,2,6,3,8,2,5
558,5178,558.0,13,Santos,Avai,22/8/2015,1,3,0,0,4,1,4,0,3
559,5179,559.0,13,Figueirense,Sport,22/8/2015,1,3,0,0,4,1,4,0,3
560,5180,560.0,13,Coritiba,Chapecoense,23/8/2015,3,3,0,0,6,3,6,0,3
561,5181,561.0,13,Ponte Preta,Gremio,23/8/2015,1,1,0,0,2,1,2,0,1
562,5182,562.0,13,Joinville,Fluminense,23/8/2015,3,2,0,0,5,3,5,0,2
563,5183,563.0,13,Internacional,Athletico-PR,23/8/2015,1,3,0,0,4,1,4,0,3
564,5184,564.0,13,Corinthians,Cruzeiro,23/8/2015,2,1,0,0,3,2,3,0,1
565,5185,565.0,13,Flamengo,Sao Paulo,23/8/2015,4,2,0,0,6,4,6,0,2
566,5186,566.0,13,Atletico-MG,Palmeiras,23/8/2015,1,3,0,0,4,1,4,0,3
567,5187,567.0,13,Vasco,Figueirense,29/8/2015,2,4,0,0,6,2,6,0,4
568,5188,568.0,13,Sao Paulo,Ponte Preta,29/8/2015,4,0,0,0,4,4,4,0,0
569,5189,569.0,13,Gremio,Coritiba,30/8/2015,5,5,0,0,10,5,10,0,5
570,5190,570.0,13,Avai,Internacional,30/8/2015,2,2,0,0,4,2,4,0,2
571,5191,571.0,13,Palmeiras,Joinville,30/8/2015,0,3,0,0,3,0,3,0,3
572,5192,572.0,13,Fluminense,Atletico-MG,30/8/2015,3,4,0,0,7,3,7,0,4
573,5193,573.0,13,Sport,Flamengo,30/8/2015,1,5,1,0,6,2,7,1,5
574,5194,574.0,13,Chapecoense,Corinthians,30/8/2015,2,3,0,0,5,2,5,0,3
575,5195,575.0,13,Cruzeiro,Santos,30/8/2015,3,2,1,0,5,4,6,1,2
576,5196,576.0,13,Athletico-PR,Goias,30/8/2015,1,3,0,0,4,1,4,0,3
577,5197,577.0,13,Joinville,Sao Paulo,2/9/2015,4,5,0,0,9,4,9,0,5
578,5198,578.0,13,Ponte Preta,Cruzeiro,2/9/2015,2,5,1,0,7,3,8,1,5
579,5199,579.0,13,Internacional,Vasco,2/9/2015,3,1,0,0,4,3,4,0,1
580,5200,580.0,13,Flamengo,Avai,2/9/2015,1,4,0,0,5,1,5,0,4
581,5201,581.0,13,Atletico-MG,Athletico-PR,2/9/2015,5,4,1,0,9,6,10,1,4
582,5202,582.0,13,Coritiba,Sport,2/9/2015,2,2,0,0,4,2,4,0,2
583,5203,583.0,13,Corinthians,Fluminense,2/9/2015,0,3,0,0,3,0,3,0,3
584,5204,584.0,13,Goias,Palmeiras,2/9/2015,3,3,0,0,6,3,6,0,3
585,5205,585.0,13,Santos,Chapecoense,3/9/2015,0,1,0,0,1,0,1,0,1
586,5206,586.0,13,Figueirense,Gremio,3/9/2015,4,4,0,0,8,4,8,0,4
587,5208,587.0,13,Vasco,Atletico-MG,5/9/2015,3,2,1,0,5,4,6,1,2
588,5209,588.0,13,Athletico-PR,Joinville,5/9/2015,4,3,1,3,7,5,11,4,6
589,5210,589.0,13,Cruzeiro,Figueirense,6/9/2015,0,4,0,0,4,0,4,0,4
590,5211,590.0,13,Chapecoense,Ponte Preta,6/9/2015,1,2,0,0,3,1,3,0,2
591,5212,591.0,13,Gremio,Goias,6/9/2015,3,4,0,1,7,3,8,1,5
592,5213,592.0,13,Palmeiras,Corinthians,6/9/2015,6,3,0,0,9,6,9,0,3
593,5214,593.0,13,Avai,Coritiba,6/9/2015,2,4,0,0,6,2,6,0,4
594,5215,594.0,13,Fluminense,Flamengo,6/9/2015,6,6,0,1,12,6,13,1,7
595,5216,595.0,13,Sport,Santos,6/9/2015,1,0,0,0,1,1,1,0,0
596,5217,596.0,13,Ponte Preta,Vasco,9/9/2015,3,1,1,0,4,4,5,1,1
597,5218,597.0,13,Atletico-MG,Avai,9/9/2015,3,3,0,0,6,3,6,0,3
598,5219,598.0,13,Internacional,Palmeiras,9/9/2015,5,3,1,1,8,6,10,2,4
599,5220,599.0,13,Figueirense,Athletico-PR,9/9/2015,2,2,0,0,4,2,4,0,2
600,5221,600.0,13,Coritiba,Fluminense,9/9/2015,1,4,0,0,5,1,5,0,4
601,5222,601.0,13,Santos,Sao Paulo,9/9/2015,1,1,0,0,2,1,2,0,1
602,5223,602.0,13,Corinthians,Gremio,9/9/2015,0,3,0,0,3,0,3,0,3
603,5224,603.0,13,Goias,Sport,10/9/2015,3,1,0,0,4,3,4,0,1
604,5225,604.0,13,Joinville,Chapecoense,10/9/2015,4,2,0,0,6,4,6,0,2
605,5226,605.0,13,Flamengo,Cruzeiro,10/9/2015,3,3,0,0,6,3,6,0,3
606,5227,606.0,13,Coritiba,Internacional,12/9/2015,4,7,0,0,11,4,11,0,7
607,5228,607.0,13,Palmeiras,Figueirense,12/9/2015,4,4,0,1,8,4,9,1,5
608,5229,608.0,13,Ponte Preta,Santos,13/9/2015,5,2,0,0,7,5,7,0,2
609,5230,609.0,13,Corinthians,Joinville,13/9/2015,0,1,0,0,1,0,1,0,1
610,5231,610.0,13,Cruzeiro,Atletico-MG,13/9/2015,3,5,1,0,8,4,9,1,5
611,5232,611.0,13,Gremio,Sao Paulo,13/9/2015,3,3,0,0,6,3,6,0,3
612,5233,612.0,13,Chapecoense,Flamengo,13/9/2015,2,1,0,0,3,2,3,0,1
613,5234,613.0,13,Vasco,Athletico-PR,13/9/2015,2,2,0,0,4,2,4,0,2
614,5235,614.0,13,Avai,Goias,13/9/2015,2,2,0,0,4,2,4,0,2
615,5236,615.0,13,Sport,Fluminense,13/9/2015,2,3,0,0,5,2,5,0,3
616,5237,616.0,13,Joinville,Sport,16/9/2015,4,3,0,0,7,4,7,0,3
617,5238,617.0,13,Fluminense,Palmeiras,16/9/2015,1,3,0,0,4,1,4,0,3
618,5239,618.0,13,Goias,Ponte Preta,16/9/2015,2,5,0,0,7,2,7,0,5
619,5240,619.0,13,Figueirense,Avai,16/9/2015,2,4,0,0,6,2,6,0,4
620,5241,620.0,13,Athletico-PR,Gremio,16/9/2015,1,2,0,0,3,1,3,0,2
621,5242,621.0,13,Santos,Atletico-MG,16/9/2015,1,1,0,0,2,1,2,0,1
622,5243,622.0,13,Internacional,Corinthians,16/9/2015,2,1,0,0,3,2,3,0,1
623,5244,623.0,13,Cruzeiro,Vasco,16/9/2015,4,3,0,1,7,4,8,1,4
624,5245,624.0,13,Sao Paulo,Chapecoense,17/9/2015,2,2,0,0,4,2,4,0,2
625,5246,625.0,13,Flamengo,Coritiba,17/9/2015,2,3,0,0,5,2,5,0,3
626,5247,626.0,13,Palmeiras,Gremio,19/9/2015,2,4,0,0,6,2,6,0,4
627,5248,627.0,13,Internacional,Figueirense,19/9/2015,1,5,0,0,6,1,6,0,5
628,5249,628.0,13,Ponte Preta,Fluminense,19/9/2015,3,4,0,0,7,3,7,0,4
629,5250,629.0,13,Goias,Joinville,20/9/2015,0,1,0,0,1,0,1,0,1
630,5251,630.0,13,Corinthians,Santos,20/9/2015,2,5,0,2,7,2,9,2,7
631,5252,631.0,13,Vasco,Sport,20/9/2015,2,2,0,0,4,2,4,0,2
632,5253,632.0,13,Atletico-MG,Flamengo,20/9/2015,2,2,0,0,4,2,4,0,2
633,5254,633.0,13,Avai,Sao Paulo,20/9/2015,3,4,0,0,7,3,7,0,4
634,5255,634.0,13,Chapecoense,Cruzeiro,20/9/2015,2,1,0,1,3,2,4,1,2
635,5256,635.0,13,Coritiba,Athletico-PR,20/9/2015,7,3,1,0,10,8,11,1,3
636,5257,636.0,13,Fluminense,Goias,26/9/2015,4,3,0,0,7,4,7,0,3
637,5258,637.0,13,Gremio,Avai,26/9/2015,1,3,0,0,4,1,4,0,3
638,5259,638.0,13,Athletico-PR,Ponte Preta,27/9/2015,2,4,0,0,6,2,6,0,4
639,5260,639.0,13,Santos,Internacional,27/9/2015,1,4,0,0,5,1,5,0,4
640,5261,640.0,13,Flamengo,Vasco,27/9/2015,5,6,0,0,11,5,11,0,6
641,5262,641.0,13,Joinville,Atletico-MG,27/9/2015,2,2,0,0,4,2,4,0,2
642,5263,642.0,13,Figueirense,Corinthians,27/9/2015,3,3,0,0,6,3,6,0,3
643,5264,643.0,13,Sao Paulo,Palmeiras,27/9/2015,1,2,0,0,3,1,3,0,2
644,5265,644.0,13,Sport,Chapecoense,27/9/2015,3,0,0,0,3,3,3,0,0
645,5266,645.0,13,Cruzeiro,Coritiba,27/9/2015,0,1,1,1,1,1,3,2,2
646,5267,646.0,13,Internacional,Sport,3/10/2015,2,2,0,1,4,2,5,1,3
647,5268,647.0,13,Coritiba,Atletico-MG,3/10/2015,1,2,0,0,3,1,3,0,2
648,5269,648.0,13,Sao Paulo,Athletico-PR,3/10/2015,1,3,0,0,4,1,4,0,3
649,5270,649.0,13,Avai,Vasco,4/10/2015,4,6,1,2,10,5,13,3,8
650,5271,650.0,13,Flamengo,Joinville,4/10/2015,2,3,0,0,5,2,5,0,3
651,5272,651.0,13,Santos,Fluminense,4/10/2015,3,2,0,0,5,3,5,0,2
652,5273,652.0,13,Cruzeiro,Gremio,4/10/2015,3,3,0,0,6,3,6,0,3
653,5274,653.0,13,Goias,Figueirense,4/10/2015,1,5,0,1,6,1,7,1,6
654,5275,654.0,13,Ponte Preta,Corinthians,4/10/2015,2,4,1,0,6,3,7,1,4
655,5276,655.0,13,Chapecoense,Palmeiras,4/10/2015,0,5,0,0,5,0,5,0,5
656,5277,656.0,13,Atletico-MG,Internacional,14/10/2015,2,3,0,0,5,2,5,0,3
657,5278,657.0,13,Sport,Avai,14/10/2015,2,5,0,0,7,2,7,0,5
658,5279,658.0,13,Joinville,Coritiba,14/10/2015,6,1,0,0,7,6,7,0,1
659,5280,659.0,13,Figueirense,Flamengo,14/10/2015,1,1,0,0,2,1,2,0,1
660,5281,660.0,13,Palmeiras,Ponte Preta,14/10/2015,2,3,0,0,5,2,5,0,3
661,5282,661.0,13,Fluminense,Sao Paulo,14/10/2015,0,4,0,0,4,0,4,0,4
662,5283,662.0,13,Athletico-PR,Cruzeiro,14/10/2015,5,2,0,0,7,5,7,0,2
663,5284,663.0,13,Vasco,Chapecoense,15/10/2015,4,5,0,0,9,4,9,0,5
664,5285,664.0,13,Corinthians,Goias,15/10/2015,1,5,0,0,6,1,6,0,5
665,5286,665.0,13,Gremio,Santos,15/10/2015,3,3,0,1,6,3,7,1,4
666,5287,666.0,13,Avai,Palmeiras,17/10/2015,3,4,0,0,7,3,7,0,4
667,5288,667.0,13,Joinville,Figueirense,17/10/2015,2,3,1,0,5,3,6,1,3
668,5289,668.0,13,Ponte Preta,Coritiba,18/10/2015,3,3,0,0,6,3,6,0,3
669,5290,669.0,13,Cruzeiro,Fluminense,18/10/2015,2,1,0,0,3,2,3,0,1
670,5291,670.0,13,Athletico-PR,Corinthians,18/10/2015,2,1,0,0,3,2,3,0,1
671,5292,671.0,13,Flamengo,Internacional,18/10/2015,0,2,0,0,2,0,2,0,2
672,5293,672.0,13,Sao Paulo,Vasco,18/10/2015,2,1,1,0,3,3,4,1,1
673,5294,673.0,13,Gremio,Chapecoense,18/10/2015,3,2,0,1,5,3,6,1,3
674,5295,674.0,13,Santos,Goias,18/10/2015,0,1,0,0,1,0,1,0,1
675,5296,675.0,13,Sport,Atletico-MG,18/10/2015,0,1,0,1,1,0,2,1,2
676,5297,676.0,13,Fluminense,Athletico-PR,24/10/2015,1,3,0,0,4,1,4,0,3
677,5298,677.0,13,Internacional,Joinville,24/10/2015,1,2,0,0,3,1,3,0,2
678,5299,678.0,13,Figueirense,Santos,24/10/2015,5,2,0,0,7,5,7,0,2
679,5300,679.0,13,Palmeiras,Sport,24/10/2015,2,1,0,0,3,2,3,0,1
680,5301,680.0,13,Corinthians,Flamengo,25/10/2015,3,2,0,1,5,3,6,1,3
681,5302,681.0,13,Coritiba,Sao Paulo,25/10/2015,4,3,1,0,7,5,8,1,3
682,5303,682.0,13,Chapecoense,Avai,25/10/2015,1,2,0,0,3,1,3,0,2
683,5304,683.0,13,Vasco,Gremio,25/10/2015,1,2,0,0,3,1,3,0,2
684,5305,684.0,13,Goias,Cruzeiro,25/10/2015,4,4,0,0,8,4,8,0,4
685,5306,685.0,13,Atletico-MG,Ponte Preta,25/10/2015,2,1,0,0,3,2,3,0,1
686,5307,686.0,13,Sao Paulo,Sport,31/10/2015,1,2,0,0,3,1,3,0,2
687,5308,687.0,13,Avai,Cruzeiro,31/10/2015,3,3,0,0,6,3,6,0,3
688,5309,688.0,13,Ponte Preta,Joinville,31/10/2015,3,5,0,0,8,3,8,0,5
689,5310,689.0,13,Coritiba,Figueirense,31/10/2015,2,5,0,0,7,2,7,0,5
690,5311,690.0,13,Chapecoense,Athletico-PR,1/11/2015,3,4,0,1,7,3,8,1,5
691,5312,691.0,13,Santos,Palmeiras,1/11/2015,3,3,0,1,6,3,7,1,4
692,5313,692.0,13,Gremio,Flamengo,1/11/2015,0,1,0,1,1,0,2,1,2
693,5314,693.0,13,Atletico-MG,Corinthians,1/11/2015,1,0,0,0,1,1,1,0,0
694,5315,694.0,13,Vasco,Fluminense,1/11/2015,2,5,0,1,7,2,8,1,6
695,5316,695.0,13,Goias,Internacional,1/11/2015,3,3,0,0,6,3,6,0,3
696,5317,696.0,13,Internacional,Ponte Preta,7/11/2015,2,4,0,0,6,2,6,0,4
697,5318,697.0,13,Corinthians,Coritiba,7/11/2015,0,3,0,0,3,0,3,0,3
698,5319,698.0,13,Athletico-PR,Avai,7/11/2015,1,2,0,0,3,1,3,0,2
699,5320,699.0,13,Fluminense,Chapecoense,7/11/2015,3,3,0,0,6,3,6,0,3
700,5321,700.0,13,Palmeiras,Vasco,8/11/2015,1,4,0,0,5,1,5,0,4
701,5322,701.0,13,Flamengo,Goias,8/11/2015,1,0,0,0,1,1,1,0,0
702,5323,702.0,13,Cruzeiro,Sao Paulo,8/11/2015,1,2,0,0,3,1,3,0,2
703,5324,703.0,13,Figueirense,Atletico-MG,8/11/2015,2,4,0,0,6,2,6,0,4
704,5325,704.0,13,Joinville,Santos,8/11/2015,3,2,1,0,5,4,6,1,2
705,5326,705.0,13,Sport,Gremio,8/11/2015,2,3,0,1,5,2,6,1,4
706,5327,706.0,13,Cruzeiro,Sport,15/11/2015,2,4,0,0,6,2,6,0,4
707,5328,707.0,13,Goias,Coritiba,18/11/2015,1,1,0,0,2,1,2,0,1
708,5329,708.0,13,Ponte Preta,Figueirense,18/11/2015,4,4,0,0,8,4,8,0,4
709,5330,709.0,13,Avai,Joinville,18/11/2015,4,1,0,0,5,4,5,0,1
710,5331,710.0,13,Athletico-PR,Palmeiras,18/11/2015,2,4,0,2,6,2,8,2,6
711,5332,711.0,13,Gremio,Fluminense,19/11/2015,3,4,0,1,7,3,8,1,5
712,5333,712.0,13,Chapecoense,Internacional,19/11/2015,4,3,0,1,7,4,8,1,4
713,5335,713.0,13,Santos,Flamengo,19/11/2015,2,2,0,1,4,2,5,1,3
714,5336,714.0,13,Vasco,Corinthians,19/11/2015,2,3,1,0,5,3,6,1,3
715,5337,715.0,13,Palmeiras,Cruzeiro,21/11/2015,2,1,0,0,3,2,3,0,1
716,5338,716.0,13,Joinville,Vasco,22/11/2015,5,4,1,0,9,6,10,1,4
717,5339,717.0,13,Atletico-MG,Goias,22/11/2015,3,3,0,0,6,3,6,0,3
718,5340,718.0,13,Internacional,Gremio,22/11/2015,4,2,0,0,6,4,6,0,2
719,5341,719.0,13,Figueirense,Chapecoense,22/11/2015,1,3,0,0,4,1,4,0,3
720,5342,720.0,13,Corinthians,Sao Paulo,22/11/2015,2,2,0,0,4,2,4,0,2
721,5343,721.0,13,Flamengo,Ponte Preta,22/11/2015,3,3,0,0,6,3,6,0,3
722,5344,722.0,13,Fluminense,Avai,22/11/2015,2,3,0,0,5,2,5,0,3
723,5345,723.0,13,Coritiba,Santos,22/11/2015,3,3,0,1,6,3,7,1,4
724,5346,724.0,13,Sport,Athletico-PR,22/11/2015,3,2,0,0,5,3,5,0,2
725,5347,725.0,13,Sao Paulo,Figueirense,28/11/2015,1,4,0,0,5,1,5,0,4
726,5348,726.0,13,Fluminense,Internacional,28/11/2015,3,4,1,0,7,4,8,1,4
727,5349,727.0,13,Avai,Ponte Preta,28/11/2015,1,2,0,1,3,1,4,1,3
728,5350,728.0,13,Sport,Corinthians,29/11/2015,6,3,0,0,9,6,9,0,3
729,5351,729.0,13,Cruzeiro,Joinville,29/11/2015,2,3,0,0,5,2,5,0,3
730,5352,730.0,13,Gremio,Atletico-MG,29/11/2015,3,5,0,0,8,3,8,0,5
731,5353,731.0,13,Chapecoense,Goias,29/11/2015,5,3,0,0,8,5,8,0,3
732,5354,732.0,13,Vasco,Santos,29/11/2015,3,2,0,0,5,3,5,0,2
733,5355,733.0,13,Palmeiras,Coritiba,29/11/2015,3,3,0,0,6,3,6,0,3
734,5356,734.0,13,Athletico-PR,Flamengo,29/11/2015,1,3,0,0,4,1,4,0,3
735,5357,735.0,13,Internacional,Cruzeiro,6/12/2015,2,1,0,0,3,2,3,0,1
736,5358,736.0,13,Flamengo,Palmeiras,6/12/2015,0,1,0,0,1,0,1,0,1
737,5359,737.0,13,Figueirense,Fluminense,6/12/2015,4,4,0,0,8,4,8,0,4
738,5360,738.0,13,Santos,Athletico-PR,6/12/2015,0,1,0,0,1,0,1,0,1
739,5361,739.0,13,Ponte Preta,Sport,6/12/2015,4,2,0,0,6,4,6,0,2
740,5362,740.0,13,Goias,Sao Paulo,6/12/2015,4,1,0,0,5,4,5,0,1
741,5363,741.0,13,Corinthians,Avai,6/12/2015,2,2,0,0,4,2,4,0,2
742,5365,742.0,13,Joinville,Gremio,6/12/2015,3,1,0,0,4,3,4,0,1
743,5366,743.0,13,Coritiba,Vasco,6/12/2015,1,0,0,1,1,1,2,1,1
744,5367,744.0,14,Palmeiras,Athletico-PR,14/5/2016,1,4,0,1,5,1,6,1,5
745,5368,745.0,14,Flamengo,Sport,14/5/2016,2,1,0,1,3,2,4,1,2
746,5369,746.0,14,Atletico-MG,Santos,14/5/2016,2,2,0,0,4,2,4,0,2
747,5370,747.0,14,Coritiba,Cruzeiro,14/5/2016,1,3,0,2,4,1,6,2,5
748,5371,748.0,14,Santa Cruz,Vitoria,15/5/2016,3,0,0,0,3,3,3,0,0
749,5372,749.0,14,Botafogo-RJ,Sao Paulo,15/5/2016,1,5,0,0,6,1,6,0,5
750,5373,750.0,14,Figueirense,Ponte Preta,15/5/2016,2,5,0,0,7,2,7,0,5
751,5374,751.0,14,Corinthians,Gremio,15/5/2016,1,4,0,0,5,1,5,0,4
752,5376,752.0,14,Internacional,Chapecoense,15/5/2016,3,4,0,1,7,3,8,1,5
753,5377,753.0,14,Ponte Preta,Palmeiras,21/5/2016,3,4,0,0,7,3,7,0,4
754,5378,754.0,14,Fluminense,Santa Cruz,21/5/2016,3,5,0,0,8,3,8,0,5
755,5379,755.0,14,Cruzeiro,Figueirense,21/5/2016,3,1,0,0,4,3,4,0,1
756,5380,756.0,14,Santos,Coritiba,22/5/2016,5,2,0,0,7,5,7,0,2
757,5381,757.0,14,Athletico-PR,Atletico-MG,22/5/2016,3,1,0,0,4,3,4,0,1
758,5382,758.0,14,Vitoria,Corinthians,22/5/2016,5,4,1,0,9,6,10,1,4
759,5383,759.0,14,Chapecoense,America-MG,22/5/2016,0,4,0,0,4,0,4,0,4
760,5384,760.0,14,Sao Paulo,Internacional,22/5/2016,4,6,0,1,10,4,11,1,7
761,5385,761.0,14,Gremio,Flamengo,22/5/2016,3,2,0,0,5,3,5,0,2
762,5386,762.0,14,Sport,Botafogo-RJ,22/5/2016,3,2,0,0,5,3,5,0,2
763,5387,763.0,14,Figueirense,Santos,25/5/2016,2,3,0,1,5,2,6,1,4
764,5388,764.0,14,Botafogo-RJ,Athletico-PR,25/5/2016,2,2,0,0,4,2,4,0,2
765,5389,765.0,14,Flamengo,Chapecoense,25/5/2016,4,1,1,0,5,5,6,1,1
766,5390,766.0,14,America-MG,Vitoria,25/5/2016,4,2,0,1,6,4,7,1,3
767,5391,767.0,14,Santa Cruz,Cruzeiro,25/5/2016,2,3,0,0,5,2,5,0,3
768,5392,768.0,14,Palmeiras,Fluminense,25/5/2016,1,0,0,0,1,1,1,0,0
769,5393,769.0,14,Coritiba,Sao Paulo,25/5/2016,2,2,0,0,4,2,4,0,2
770,5394,770.0,14,Corinthians,Ponte Preta,26/5/2016,3,3,0,0,6,3,6,0,3
771,5395,771.0,14,Internacional,Sport,26/5/2016,3,1,0,0,4,3,4,0,1
772,5396,772.0,14,Atletico-MG,Gremio,26/5/2016,1,5,0,0,6,1,6,0,5
773,5397,773.0,14,Cruzeiro,America-MG,28/5/2016,1,1,0,0,2,1,2,0,1
774,5398,774.0,14,Athletico-PR,Figueirense,28/5/2016,2,1,0,0,3,2,3,0,1
775,5399,775.0,14,Chapecoense,Santa Cruz,28/5/2016,1,4,0,0,5,1,5,0,4
776,5400,776.0,14,Ponte Preta,Flamengo,29/5/2016,2,2,0,1,4,2,5,1,3
777,5401,777.0,14,Sport,Corinthians,29/5/2016,2,1,0,0,3,2,3,0,1
778,5402,778.0,14,Fluminense,Botafogo-RJ,29/5/2016,1,1,0,0,2,1,2,0,1
779,5403,779.0,14,Vitoria,Atletico-MG,29/5/2016,4,6,0,0,10,4,10,0,6
780,5404,780.0,14,Sao Paulo,Palmeiras,29/5/2016,2,5,0,0,7,2,7,0,5
781,5405,781.0,14,Gremio,Coritiba,29/5/2016,0,3,0,0,3,0,3,0,3
782,5406,782.0,14,Santos,Internacional,29/5/2016,1,1,0,0,2,1,2,0,1
783,5407,783.0,14,Internacional,Athletico-PR,1/6/2016,5,2,0,0,7,5,7,0,2
784,5408,784.0,14,Corinthians,Santos,1/6/2016,0,2,0,0,2,0,2,0,2
785,5409,785.0,14,Santa Cruz,Sport,1/6/2016,6,2,1,0,8,7,9,1,2
786,5410,786.0,14,Coritiba,Chapecoense,1/6/2016,4,5,0,0,9,4,9,0,5
787,5411,787.0,14,Atletico-MG,Fluminense,1/6/2016,2,5,0,0,7,2,7,0,5
788,5412,788.0,14,Figueirense,Sao Paulo,1/6/2016,2,1,0,0,3,2,3,0,1
789,5413,789.0,14,Botafogo-RJ,Cruzeiro,1/6/2016,1,3,0,0,4,1,4,0,3
790,5414,790.0,14,America-MG,Ponte Preta,2/6/2016,1,3,0,0,4,1,4,0,3
791,5415,791.0,14,Palmeiras,Gremio,2/6/2016,5,4,0,0,9,5,9,0,4
792,5416,792.0,14,Flamengo,Vitoria,2/6/2016,2,3,0,0,5,2,5,0,3
793,5417,793.0,14,Athletico-PR,Santa Cruz,4/6/2016,0,2,0,0,2,0,2,0,2
794,5418,794.0,14,Chapecoense,Fluminense,4/6/2016,3,0,0,0,3,3,3,0,0
795,5419,795.0,14,Corinthians,Coritiba,4/6/2016,2,5,0,0,7,2,7,0,5
796,5420,796.0,14,America-MG,Figueirense,5/6/2016,2,3,0,0,5,2,5,0,3
797,5421,797.0,14,Santos,Botafogo-RJ,5/6/2016,1,1,0,0,2,1,2,0,1
798,5422,798.0,14,Vitoria,Internacional,5/6/2016,1,6,0,0,7,1,7,0,6
799,5423,799.0,14,Sport,Atletico-MG,5/6/2016,1,3,0,0,4,1,4,0,3
800,5424,800.0,14,Flamengo,Palmeiras,5/6/2016,1,2,1,0,3,2,4,1,2
801,5425,801.0,14,Gremio,Ponte Preta,5/6/2016,2,4,1,1,6,3,8,2,5
802,5426,802.0,14,Cruzeiro,Sao Paulo,5/6/2016,2,0,0,0,2,2,2,0,0
803,5427,803.0,14,Internacional,America-MG,11/6/2016,2,3,0,0,5,2,5,0,3
804,5428,804.0,14,Ponte Preta,Chapecoense,11/6/2016,3,4,0,0,7,3,7,0,4
805,5429,805.0,14,Fluminense,Gremio,11/6/2016,4,2,0,1,6,4,7,1,3
806,5430,806.0,14,Sao Paulo,Athletico-PR,11/6/2016,1,2,0,0,3,1,3,0,2
807,5431,807.0,14,Coritiba,Sport,12/6/2016,5,4,1,1,9,6,11,2,5
808,5432,808.0,14,Botafogo-RJ,Vitoria,12/6/2016,3,1,0,0,4,3,4,0,1
809,5433,809.0,14,Atletico-MG,Cruzeiro,12/6/2016,4,6,1,3,10,5,14,4,9
810,5434,810.0,14,Palmeiras,Corinthians,12/6/2016,4,4,0,0,8,4,8,0,4
811,5435,811.0,14,Figueirense,Flamengo,12/6/2016,2,2,0,0,4,2,4,0,2
812,5436,812.0,14,Santa Cruz,Santos,12/6/2016,1,2,0,0,3,1,3,0,2
813,5437,813.0,14,Sao Paulo,Vitoria,15/6/2016,5,2,0,0,7,5,7,0,2
814,5438,814.0,14,Chapecoense,Gremio,15/6/2016,2,2,0,0,4,2,4,0,2
815,5439,815.0,14,Ponte Preta,Athletico-PR,15/6/2016,0,2,0,0,2,0,2,0,2
816,5440,816.0,14,Santos,Sport,15/6/2016,1,3,0,0,4,1,4,0,3
817,5441,817.0,14,Santa Cruz,Figueirense,15/6/2016,3,3,0,1,6,3,7,1,4
818,5442,818.0,14,Botafogo-RJ,America-MG,15/6/2016,2,2,0,0,4,2,4,0,2
819,5443,819.0,14,Coritiba,Palmeiras,15/6/2016,4,3,0,0,7,4,7,0,3
820,5445,820.0,14,Internacional,Atletico-MG,16/6/2016,2,1,0,0,3,2,3,0,1
821,5446,821.0,14,Fluminense,Corinthians,16/6/2016,2,1,0,1,3,2,4,1,2
822,5447,822.0,14,Palmeiras,Santa Cruz,18/6/2016,1,4,0,1,5,1,6,1,5
823,5448,823.0,14,Athletico-PR,Santos,18/6/2016,2,1,0,0,3,2,3,0,1
824,5449,824.0,14,America-MG,Coritiba,18/6/2016,0,3,0,0,3,0,3,0,3
825,5450,825.0,14,Vitoria,Chapecoense,19/6/2016,1,4,0,0,5,1,5,0,4
826,5451,826.0,14,Atletico-MG,Ponte Preta,19/6/2016,0,1,0,0,1,0,1,0,1
827,5452,827.0,14,Corinthians,Botafogo-RJ,19/6/2016,2,2,0,0,4,2,4,0,2
828,5453,828.0,14,Flamengo,Sao Paulo,19/6/2016,1,3,0,1,4,1,5,1,4
829,5454,829.0,14,Figueirense,Internacional,19/6/2016,3,0,0,0,3,3,3,0,0
830,5455,830.0,14,Sport,Fluminense,19/6/2016,2,0,0,0,2,2,2,0,0
831,5456,831.0,14,Gremio,Cruzeiro,19/6/2016,0,2,0,0,2,0,2,0,2
832,5457,832.0,14,Palmeiras,America-MG,21/6/2016,0,1,0,0,1,0,1,0,1
833,5458,833.0,14,Ponte Preta,Cruzeiro,22/6/2016,4,4,0,0,8,4,8,0,4
834,5459,834.0,14,Botafogo-RJ,Figueirense,22/6/2016,0,1,0,0,1,0,1,0,1
835,5460,835.0,14,Santa Cruz,Flamengo,22/6/2016,1,0,0,0,1,1,1,0,0
836,5461,836.0,14,Fluminense,Santos,22/6/2016,1,1,0,0,2,1,2,0,1
837,5462,837.0,14,Atletico-MG,Corinthians,22/6/2016,3,1,0,0,4,3,4,0,1
838,5463,838.0,14,Chapecoense,Athletico-PR,23/6/2016,2,2,0,0,4,2,4,0,2
839,5464,839.0,14,Gremio,Vitoria,23/6/2016,4,4,1,0,8,5,9,1,4
840,5465,840.0,14,Sao Paulo,Sport,23/6/2016,0,2,0,0,2,0,2,0,2
841,5466,841.0,14,Coritiba,Internacional,23/6/2016,2,5,1,0,7,3,8,1,5
842,5467,842.0,14,Cruzeiro,Palmeiras,25/6/2016,4,2,0,0,6,4,6,0,2
843,5468,843.0,14,Corinthians,Santa Cruz,25/6/2016,3,1,0,0,4,3,4,0,1
844,5469,844.0,14,America-MG,Atletico-MG,26/6/2016,3,3,0,0,6,3,6,0,3
845,5470,845.0,14,Flamengo,Fluminense,26/6/2016,0,1,0,0,1,0,1,0,1
846,5471,846.0,14,Vitoria,Ponte Preta,26/6/2016,3,2,0,0,5,3,5,0,2
847,5472,847.0,14,Athletico-PR,Gremio,26/6/2016,1,0,0,1,1,1,2,1,1
848,5473,848.0,14,Internacional,Botafogo-RJ,26/6/2016,4,3,1,0,7,5,8,1,3
849,5474,849.0,14,Santos,Sao Paulo,26/6/2016,2,3,0,1,5,2,6,1,4
850,5475,850.0,14,Sport,Chapecoense,26/6/2016,3,2,0,0,5,3,5,0,2
851,5476,851.0,14,Figueirense,Coritiba,26/6/2016,3,4,0,0,7,3,7,0,4
852,5477,852.0,14,Flamengo,Internacional,29/6/2016,1,1,0,0,2,1,2,0,1
853,5478,853.0,14,Vitoria,Sport,29/6/2016,4,4,0,2,8,4,10,2,6
854,5479,854.0,14,Gremio,Santos,29/6/2016,3,3,0,0,6,3,6,0,3
855,5480,855.0,14,Coritiba,Athletico-PR,29/6/2016,3,2,0,0,5,3,5,0,2
856,5481,856.0,14,Chapecoense,Cruzeiro,29/6/2016,4,6,0,0,10,4,10,0,6
857,5482,857.0,14,Sao Paulo,Fluminense,29/6/2016,4,3,0,0,7,4,7,0,3
858,5483,858.0,14,America-MG,Corinthians,29/6/2016,2,1,0,0,3,2,3,0,1
859,5484,859.0,14,Santa Cruz,Ponte Preta,30/6/2016,2,1,0,0,3,2,3,0,1
860,5485,860.0,14,Palmeiras,Figueirense,30/6/2016,1,1,0,0,2,1,2,0,1
861,5487,861.0,14,Fluminense,Coritiba,2/7/2016,1,2,0,0,3,1,3,0,2
862,5488,862.0,14,Athletico-PR,America-MG,2/7/2016,2,2,0,0,4,2,4,0,2
863,5489,863.0,14,Cruzeiro,Vitoria,3/7/2016,3,3,0,1,6,3,7,1,4
864,5490,864.0,14,Internacional,Gremio,3/7/2016,4,5,0,0,9,4,9,0,5
865,5491,865.0,14,Santos,Chapecoense,3/7/2016,1,1,0,0,2,1,2,0,1
866,5492,866.0,14,Ponte Preta,Sao Paulo,3/7/2016,3,2,0,1,5,3,6,1,3
867,5493,867.0,14,Corinthians,Flamengo,3/7/2016,2,3,0,0,5,2,5,0,3
868,5494,868.0,14,Botafogo-RJ,Santa Cruz,3/7/2016,1,3,0,0,4,1,4,0,3
869,5495,869.0,14,Figueirense,Atletico-MG,3/7/2016,2,4,1,1,6,3,8,2,5
870,5496,870.0,14,Sport,Palmeiras,4/7/2016,4,5,0,0,9,4,9,0,5
871,5497,871.0,14,Chapecoense,Corinthians,9/7/2016,1,1,1,0,2,2,3,1,1
872,5498,872.0,14,Coritiba,Botafogo-RJ,9/7/2016,1,3,0,0,4,1,4,0,3
873,5499,873.0,14,Ponte Preta,Sport,9/7/2016,2,2,0,0,4,2,4,0,2
874,5500,874.0,14,Gremio,Figueirense,10/7/2016,1,1,0,0,2,1,2,0,1
875,5501,875.0,14,Flamengo,Atletico-MG,10/7/2016,1,4,0,0,5,1,5,0,4
876,5502,876.0,14,Santa Cruz,Internacional,10/7/2016,0,2,0,0,2,0,2,0,2
877,5503,877.0,14,Sao Paulo,America-MG,10/7/2016,1,4,0,0,5,1,5,0,4
878,5504,878.0,14,Vitoria,Fluminense,10/7/2016,3,4,0,0,7,3,7,0,4
879,5505,879.0,14,Cruzeiro,Athletico-PR,11/7/2016,1,4,0,0,5,1,5,0,4
880,5506,880.0,14,Palmeiras,Santos,12/7/2016,3,2,0,0,5,3,5,0,2
881,5507,881.0,14,Botafogo-RJ,Flamengo,16/7/2016,2,4,0,0,6,2,6,0,4
882,5508,882.0,14,Santos,Ponte Preta,16/7/2016,3,2,0,0,5,3,5,0,2
883,5509,883.0,14,America-MG,Santa Cruz,17/7/2016,2,2,0,0,4,2,4,0,2
884,5510,884.0,14,Internacional,Palmeiras,17/7/2016,4,2,0,0,6,4,6,0,2
885,5511,885.0,14,Figueirense,Chapecoense,17/7/2016,1,4,0,0,5,1,5,0,4
886,5512,886.0,14,Fluminense,Cruzeiro,17/7/2016,0,6,0,0,6,0,6,0,6
887,5513,887.0,14,Athletico-PR,Vitoria,17/7/2016,3,3,0,0,6,3,6,0,3
888,5514,888.0,14,Corinthians,Sao Paulo,17/7/2016,3,3,0,0,6,3,6,0,3
889,5515,889.0,14,Sport,Gremio,17/7/2016,0,3,0,0,3,0,3,0,3
890,5516,890.0,14,Atletico-MG,Coritiba,18/7/2016,2,2,0,0,4,2,4,0,2
891,5517,891.0,14,Corinthians,Figueirense,23/7/2016,2,6,0,0,8,2,8,0,6
892,5518,892.0,14,Santa Cruz,Coritiba,23/7/2016,2,1,0,0,3,2,3,0,1
893,5519,893.0,14,Palmeiras,Atletico-MG,24/7/2016,1,2,0,0,3,1,3,0,2
894,5520,894.0,14,Ponte Preta,Internacional,24/7/2016,3,3,0,1,6,3,7,1,4
895,5521,895.0,14,Gremio,Sao Paulo,24/7/2016,0,3,0,1,3,0,4,1,4
896,5522,896.0,14,Athletico-PR,Fluminense,24/7/2016,3,5,0,0,8,3,8,0,5
897,5523,897.0,14,Cruzeiro,Sport,24/7/2016,1,4,0,0,5,1,5,0,4
898,5524,898.0,14,Chapecoense,Botafogo-RJ,24/7/2016,1,2,0,0,3,1,3,0,2
899,5525,899.0,14,Vitoria,Santos,24/7/2016,3,2,0,0,5,3,5,0,2
900,5526,900.0,14,Flamengo,America-MG,25/7/2016,1,0,0,0,1,1,1,0,0
901,5527,901.0,14,Figueirense,Vitoria,30/7/2016,3,4,1,1,7,4,9,2,5
902,5528,902.0,14,Sport,Athletico-PR,30/7/2016,2,1,0,0,3,2,3,0,1
903,5529,903.0,14,Atletico-MG,Santa Cruz,30/7/2016,1,3,0,0,4,1,4,0,3
904,5530,904.0,14,Sao Paulo,Chapecoense,31/7/2016,4,1,0,0,5,4,5,0,1
905,5531,905.0,14,Fluminense,Ponte Preta,31/7/2016,4,6,0,0,10,4,10,0,6
906,5532,906.0,14,Coritiba,Flamengo,31/7/2016,1,2,0,0,3,1,3,0,2
907,5533,907.0,14,Internacional,Corinthians,31/7/2016,2,2,0,0,4,2,4,0,2
908,5534,908.0,14,Santos,Cruzeiro,31/7/2016,1,1,0,0,2,1,2,0,1
909,5535,909.0,14,Botafogo-RJ,Palmeiras,31/7/2016,4,3,0,0,7,4,7,0,3
910,5536,910.0,14,America-MG,Gremio,31/7/2016,2,2,0,1,4,2,5,1,3
911,5537,911.0,14,Vitoria,Coritiba,3/8/2016,2,1,0,0,3,2,3,0,1
912,5538,912.0,14,Sport,America-MG,3/8/2016,1,3,0,0,4,1,4,0,3
913,5539,913.0,14,Santos,Flamengo,3/8/2016,2,2,0,0,4,2,4,0,2
914,5540,914.0,14,Athletico-PR,Corinthians,3/8/2016,3,0,0,0,3,3,3,0,0
915,5541,915.0,14,Ponte Preta,Botafogo-RJ,4/8/2016,2,2,0,0,4,2,4,0,2
916,5542,916.0,14,Gremio,Santa Cruz,4/8/2016,1,3,0,0,4,1,4,0,3
917,5543,917.0,14,Sao Paulo,Atletico-MG,4/8/2016,2,2,0,0,4,2,4,0,2
918,5544,918.0,14,Cruzeiro,Internacional,4/8/2016,1,1,0,0,2,1,2,0,1
919,5545,919.0,14,Chapecoense,Palmeiras,4/8/2016,1,0,0,0,1,1,1,0,0
920,5546,920.0,14,Fluminense,Figueirense,3/9/2016,3,3,0,0,6,3,6,0,3
921,5547,921.0,14,Flamengo,Athletico-PR,6/8/2016,2,4,0,0,6,2,6,0,4
922,5548,922.0,14,America-MG,Santos,7/8/2016,2,1,0,1,3,2,4,1,2
923,5549,923.0,14,Coritiba,Ponte Preta,7/8/2016,4,3,0,0,7,4,7,0,3
924,5550,924.0,14,Palmeiras,Vitoria,7/8/2016,2,4,0,0,6,2,6,0,4
925,5551,925.0,14,Santa Cruz,Sao Paulo,7/8/2016,1,3,0,0,4,1,4,0,3
926,5552,926.0,14,Internacional,Fluminense,7/8/2016,4,4,0,0,8,4,8,0,4
927,5553,927.0,14,Figueirense,Sport,7/8/2016,5,3,0,0,8,5,8,0,3
928,5554,928.0,14,Atletico-MG,Chapecoense,8/8/2016,0,1,0,0,1,0,1,0,1
929,5555,929.0,14,Corinthians,Cruzeiro,8/8/2016,4,3,0,0,7,4,7,0,3
930,5556,930.0,14,Botafogo-RJ,Gremio,4/9/2016,3,4,0,0,7,3,7,0,4
931,5557,931.0,14,Sport,Flamengo,13/8/2016,2,3,0,0,5,2,5,0,3
932,5558,932.0,14,Ponte Preta,Figueirense,13/8/2016,2,2,0,0,4,2,4,0,2
933,5559,933.0,14,Fluminense,America-MG,14/8/2016,2,5,0,0,7,2,7,0,5
934,5560,934.0,14,Gremio,Corinthians,14/8/2016,4,1,0,0,5,4,5,0,1
935,5561,935.0,14,Cruzeiro,Coritiba,14/8/2016,2,4,0,0,6,2,6,0,4
936,5562,936.0,14,Santos,Atletico-MG,14/8/2016,4,4,0,0,8,4,8,0,4
937,5563,937.0,14,Vitoria,Santa Cruz,14/8/2016,1,2,0,0,3,1,3,0,2
938,5564,938.0,14,Sao Paulo,Botafogo-RJ,14/8/2016,2,2,0,0,4,2,4,0,2
939,5565,939.0,14,Athletico-PR,Palmeiras,14/8/2016,3,3,0,0,6,3,6,0,3
940,5566,940.0,14,Chapecoense,Internacional,15/8/2016,1,2,0,0,3,1,3,0,2
941,5567,941.0,14,America-MG,Chapecoense,19/8/2016,1,1,0,0,2,1,2,0,1
942,5568,942.0,14,Botafogo-RJ,Sport,20/8/2016,1,2,0,0,3,1,3,0,2
943,5569,943.0,14,Flamengo,Gremio,21/8/2016,2,1,0,0,3,2,3,0,1
944,5570,944.0,14,Atletico-MG,Athletico-PR,21/8/2016,0,2,0,0,2,0,2,0,2
945,5571,945.0,14,Internacional,Sao Paulo,21/8/2016,1,2,0,0,3,1,3,0,2
946,5572,946.0,14,Santa Cruz,Fluminense,21/8/2016,0,2,0,0,2,0,2,0,2
947,5573,947.0,14,Palmeiras,Ponte Preta,21/8/2016,3,6,0,0,9,3,9,0,6
948,5574,948.0,14,Coritiba,Santos,21/8/2016,1,3,0,0,4,1,4,0,3
949,5575,949.0,14,Figueirense,Cruzeiro,21/8/2016,4,5,1,0,9,5,10,1,5
950,5576,950.0,14,Corinthians,Vitoria,22/8/2016,2,4,0,0,6,2,6,0,4
951,5577,951.0,14,Ponte Preta,Corinthians,27/8/2016,2,1,0,1,3,2,4,1,2
952,5578,952.0,14,Cruzeiro,Santa Cruz,28/8/2016,3,3,0,0,6,3,6,0,3
953,5579,953.0,14,Santos,Figueirense,28/8/2016,3,2,0,0,5,3,5,0,2
954,5580,954.0,14,Gremio,Atletico-MG,28/8/2016,4,4,0,0,8,4,8,0,4
955,5581,955.0,14,Fluminense,Palmeiras,28/8/2016,7,5,0,0,12,7,12,0,5
956,5582,956.0,14,Chapecoense,Flamengo,28/8/2016,4,0,0,0,4,4,4,0,0
957,5583,957.0,14,Sao Paulo,Coritiba,28/8/2016,2,1,0,0,3,2,3,0,1
958,5584,958.0,14,Sport,Internacional,28/8/2016,4,5,0,0,9,4,9,0,5
959,5585,959.0,14,Vitoria,America-MG,28/8/2016,3,5,0,0,8,3,8,0,5
960,5586,960.0,14,Athletico-PR,Botafogo-RJ,29/8/2016,3,2,0,0,5,3,5,0,2
961,5587,961.0,14,Santa Cruz,Chapecoense,7/9/2016,3,3,1,0,6,4,7,1,3
962,5588,962.0,14,Figueirense,Athletico-PR,7/9/2016,1,2,0,0,3,1,3,0,2
963,5589,963.0,14,Botafogo-RJ,Fluminense,7/9/2016,5,2,0,0,7,5,7,0,2
964,5590,964.0,14,Atletico-MG,Vitoria,7/9/2016,2,5,0,0,7,2,7,0,5
965,5591,965.0,14,Palmeiras,Sao Paulo,7/9/2016,3,3,0,0,6,3,6,0,3
966,5592,966.0,14,Flamengo,Ponte Preta,7/9/2016,1,3,0,0,4,1,4,0,3
967,5593,967.0,14,Coritiba,Gremio,7/9/2016,3,0,0,0,3,3,3,0,0
968,5594,968.0,14,Corinthians,Sport,8/9/2016,2,2,0,0,4,2,4,0,2
969,5595,969.0,14,America-MG,Cruzeiro,8/9/2016,1,2,0,0,3,1,3,0,2
970,5596,970.0,14,Internacional,Santos,8/9/2016,4,4,0,1,8,4,9,1,5
971,5597,971.0,14,Vitoria,Flamengo,10/9/2016,2,1,1,0,3,3,4,1,1
972,5598,972.0,14,Chapecoense,Coritiba,11/9/2016,2,3,0,0,5,2,5,0,3
973,5599,973.0,14,Sao Paulo,Figueirense,11/9/2016,2,2,0,0,4,2,4,0,2
974,5600,974.0,14,Cruzeiro,Botafogo-RJ,11/9/2016,4,2,0,0,6,4,6,0,2
975,5601,975.0,14,Sport,Santa Cruz,11/9/2016,2,1,1,1,3,3,5,2,2
976,5602,976.0,14,Athletico-PR,Internacional,11/9/2016,0,2,0,0,2,0,2,0,2
977,5603,977.0,14,Santos,Corinthians,11/9/2016,2,1,0,0,3,2,3,0,1
978,5604,978.0,14,Ponte Preta,America-MG,11/9/2016,2,1,0,0,3,2,3,0,1
979,5605,979.0,14,Gremio,Palmeiras,11/9/2016,4,3,0,0,7,4,7,0,3
980,5606,980.0,14,Fluminense,Atletico-MG,12/9/2016,1,4,0,0,5,1,5,0,4
981,5607,981.0,14,Botafogo-RJ,Santos,14/9/2016,2,1,0,0,3,2,3,0,1
982,5608,982.0,14,Figueirense,America-MG,14/9/2016,0,2,0,1,2,0,3,1,3
983,5609,983.0,14,Ponte Preta,Gremio,14/9/2016,2,1,0,0,3,2,3,0,1
984,5610,984.0,14,Santa Cruz,Athletico-PR,14/9/2016,3,4,0,0,7,3,7,0,4
985,5611,985.0,14,Coritiba,Corinthians,14/9/2016,3,1,1,0,4,4,5,1,1
986,5612,986.0,14,Palmeiras,Flamengo,14/9/2016,2,1,0,1,3,2,4,1,2
987,5613,987.0,14,Atletico-MG,Sport,15/9/2016,0,1,0,1,1,0,2,1,2
988,5614,988.0,14,Fluminense,Chapecoense,15/9/2016,3,4,0,0,7,3,7,0,4
989,5615,989.0,14,Sao Paulo,Cruzeiro,15/9/2016,0,0,0,1,0,0,1,1,1
990,5616,990.0,14,Internacional,Vitoria,15/9/2016,3,5,0,0,8,3,8,0,5
991,5617,991.0,14,Corinthians,Palmeiras,17/9/2016,2,4,1,0,6,3,7,1,4
992,5618,992.0,14,Flamengo,Figueirense,18/9/2016,2,3,0,1,5,2,6,1,4
993,5619,993.0,14,Cruzeiro,Atletico-MG,18/9/2016,1,2,1,0,3,2,4,1,2
994,5620,994.0,14,Sport,Coritiba,18/9/2016,0,1,0,0,1,0,1,0,1
995,5621,995.0,14,Gremio,Fluminense,18/9/2016,4,3,0,0,7,4,7,0,3
996,5622,996.0,14,Chapecoense,Ponte Preta,18/9/2016,2,0,0,0,2,2,2,0,0
997,5623,997.0,14,Athletico-PR,Sao Paulo,18/9/2016,1,1,0,0,2,1,2,0,1
998,5624,998.0,14,Santos,Santa Cruz,18/9/2016,1,1,0,0,2,1,2,0,1
999,5625,999.0,14,Vitoria,Botafogo-RJ,18/9/2016,2,5,0,0,7,2,7,0,5
1000,5626,1000.0,14,America-MG,Internacional,19/9/2016,1,2,0,0,3,1,3,0,2
1001,5627,1001.0,14,Palmeiras,Coritiba,24/9/2016,2,3,0,0,5,2,5,0,3
1002,5628,1002.0,14,Sport,Santos,24/9/2016,3,2,0,1,5,3,6,1,3
1003,5629,1003.0,14,America-MG,Botafogo-RJ,24/9/2016,2,3,0,0,5,2,5,0,3
1004,5630,1004.0,14,Athletico-PR,Ponte Preta,25/9/2016,2,5,0,1,7,2,8,1,6
1005,5631,1005.0,14,Figueirense,Santa Cruz,25/9/2016,1,5,0,0,6,1,6,0,5
1006,5632,1006.0,14,Vitoria,Sao Paulo,25/9/2016,4,3,0,0,7,4,7,0,3
1007,5633,1007.0,14,Corinthians,Fluminense,25/9/2016,4,3,0,0,7,4,7,0,3
1008,5634,1008.0,14,Flamengo,Cruzeiro,25/9/2016,1,2,0,0,3,1,3,0,2
1009,5635,1009.0,14,Gremio,Chapecoense,25/9/2016,2,2,0,0,4,2,4,0,2
1010,5636,1010.0,14,Atletico-MG,Internacional,25/9/2016,2,2,0,0,4,2,4,0,2
1011,5637,1011.0,14,Fluminense,Sport,1/10/2016,1,3,0,0,4,1,4,0,3
1012,5638,1012.0,14,Sao Paulo,Flamengo,1/10/2016,4,3,0,0,7,4,7,0,3
1013,5639,1013.0,14,Chapecoense,Vitoria,1/10/2016,1,2,0,0,3,1,3,0,2
1014,5640,1014.0,14,Santos,Athletico-PR,1/10/2016,2,1,0,0,3,2,3,0,1
1015,5641,1015.0,14,Botafogo-RJ,Corinthians,1/10/2016,4,4,0,0,8,4,8,0,4
1016,5642,1016.0,14,Ponte Preta,Atletico-MG,1/10/2016,2,2,0,0,4,2,4,0,2
1017,5643,1017.0,14,Cruzeiro,Gremio,1/10/2016,3,3,0,0,6,3,6,0,3
1018,5644,1018.0,14,Internacional,Figueirense,1/10/2016,2,2,0,0,4,2,4,0,2
1019,5645,1019.0,14,Santa Cruz,Palmeiras,3/10/2016,6,3,0,0,9,6,9,0,3
1020,5646,1020.0,14,Coritiba,America-MG,3/10/2016,2,2,0,0,4,2,4,0,2
1021,5647,1021.0,14,Athletico-PR,Chapecoense,5/10/2016,2,3,0,0,5,2,5,0,3
1022,5648,1022.0,14,Vitoria,Gremio,5/10/2016,3,3,0,0,6,3,6,0,3
1023,5649,1023.0,14,Corinthians,Atletico-MG,5/10/2016,0,2,0,1,2,0,3,1,3
1024,5651,1024.0,14,Sport,Sao Paulo,5/10/2016,0,2,0,0,2,0,2,0,2
1025,5652,1025.0,14,Internacional,Coritiba,6/10/2016,2,4,0,0,6,2,6,0,4
1026,5653,1026.0,14,Cruzeiro,Ponte Preta,8/10/2016,2,2,0,0,4,2,4,0,2
1027,5654,1027.0,14,Flamengo,Santa Cruz,9/10/2016,1,1,0,1,2,1,3,1,2
1028,5655,1028.0,14,America-MG,Palmeiras,9/10/2016,2,1,1,0,3,3,4,1,1
1029,5656,1029.0,14,Figueirense,Botafogo-RJ,9/10/2016,2,2,0,0,4,2,4,0,2
1030,5657,1030.0,14,Chapecoense,Sport,12/10/2016,1,2,0,1,3,1,4,1,3
1031,5658,1031.0,14,Coritiba,Figueirense,12/10/2016,4,3,0,0,7,4,7,0,3
1032,5659,1032.0,14,Santa Cruz,Corinthians,12/10/2016,2,2,0,0,4,2,4,0,2
1033,5660,1033.0,14,Botafogo-RJ,Internacional,12/10/2016,3,2,0,0,5,3,5,0,2
1034,5661,1034.0,14,Palmeiras,Cruzeiro,13/10/2016,1,4,0,0,5,1,5,0,4
1035,5662,1035.0,14,Ponte Preta,Vitoria,13/10/2016,4,2,0,0,6,4,6,0,2
1036,5664,1036.0,14,Fluminense,Flamengo,13/10/2016,3,3,0,0,6,3,6,0,3
1037,5665,1037.0,14,Sao Paulo,Santos,13/10/2016,2,3,0,0,5,2,5,0,3
1038,5666,1038.0,14,Gremio,Athletico-PR,13/10/2016,2,3,0,0,5,2,5,0,3
1039,5667,1039.0,14,Botafogo-RJ,Atletico-MG,16/10/2016,2,4,0,0,6,2,6,0,4
1040,5668,1040.0,14,Cruzeiro,Chapecoense,16/10/2016,1,2,0,0,3,1,3,0,2
1041,5669,1041.0,14,Athletico-PR,Coritiba,16/10/2016,0,3,0,0,3,0,3,0,3
1042,5670,1042.0,14,Internacional,Flamengo,16/10/2016,3,1,0,0,4,3,4,0,1
1043,5671,1043.0,14,Figueirense,Palmeiras,16/10/2016,4,3,0,0,7,4,7,0,3
1044,5672,1044.0,14,Corinthians,America-MG,16/10/2016,2,1,0,0,3,2,3,0,1
1045,5673,1045.0,14,Ponte Preta,Santa Cruz,16/10/2016,0,2,0,0,2,0,2,0,2
1046,5674,1046.0,14,Santos,Gremio,16/10/2016,1,7,0,0,8,1,8,0,7
1047,5675,1047.0,14,Sport,Vitoria,16/10/2016,1,4,0,1,5,1,6,1,5
1048,5676,1048.0,14,Fluminense,Sao Paulo,17/10/2016,1,4,0,0,5,1,5,0,4
1049,5677,1049.0,14,Santa Cruz,Botafogo-RJ,19/10/2016,0,2,0,0,2,0,2,0,2
1050,5678,1050.0,14,Sao Paulo,Ponte Preta,22/10/2016,0,1,0,0,1,0,1,0,1
1051,5679,1051.0,14,Flamengo,Corinthians,23/10/2016,2,4,0,1,6,2,7,1,5
1052,5680,1052.0,14,Vitoria,Cruzeiro,23/10/2016,2,3,0,1,5,2,6,1,4
1053,5681,1053.0,14,Palmeiras,Sport,23/10/2016,3,2,0,0,5,3,5,0,2
1054,5682,1054.0,14,Gremio,Internacional,23/10/2016,0,2,1,1,2,1,4,2,3
1055,5683,1055.0,14,Coritiba,Fluminense,23/10/2016,0,4,1,0,4,1,5,1,4
1056,5684,1056.0,14,Atletico-MG,Figueirense,23/10/2016,2,4,0,2,6,2,8,2,6
1057,5685,1057.0,14,Chapecoense,Santos,23/10/2016,2,3,0,0,5,2,5,0,3
1058,5687,1058.0,14,Sport,Ponte Preta,27/10/2016,2,3,0,0,5,2,5,0,3
1059,5688,1059.0,14,Fluminense,Vitoria,28/10/2016,3,2,0,0,5,3,5,0,2
1060,5689,1060.0,14,Atletico-MG,Flamengo,29/10/2016,0,1,0,0,1,0,1,0,1
1061,5690,1061.0,14,Athletico-PR,Cruzeiro,29/10/2016,1,1,0,0,2,1,2,0,1
1062,5691,1062.0,14,Corinthians,Chapecoense,29/10/2016,1,2,0,0,3,1,3,0,2
1063,5692,1063.0,14,Botafogo-RJ,Coritiba,29/10/2016,5,3,0,0,8,5,8,0,3
1064,5693,1064.0,14,Internacional,Santa Cruz,29/10/2016,3,2,1,0,5,4,6,1,2
1065,5694,1065.0,14,Figueirense,Gremio,29/10/2016,2,2,0,0,4,2,4,0,2
1066,5695,1066.0,14,Santos,Palmeiras,29/10/2016,4,3,0,0,7,4,7,0,3
1067,5696,1067.0,14,America-MG,Sao Paulo,31/10/2016,0,1,0,0,1,0,1,0,1
1068,5697,1068.0,14,Flamengo,Botafogo-RJ,5/11/2016,3,3,0,0,6,3,6,0,3
1069,5698,1069.0,14,Sao Paulo,Corinthians,5/11/2016,3,4,0,0,7,3,7,0,4
1070,5699,1070.0,14,Ponte Preta,Santos,6/11/2016,1,1,0,0,2,1,2,0,1
1071,5700,1071.0,14,Santa Cruz,America-MG,6/11/2016,1,1,0,0,2,1,2,0,1
1072,5701,1072.0,14,Cruzeiro,Fluminense,6/11/2016,2,1,0,0,3,2,3,0,1
1073,5703,1073.0,14,Vitoria,Athletico-PR,6/11/2016,2,2,0,0,4,2,4,0,2
1074,5704,1074.0,14,Coritiba,Atletico-MG,6/11/2016,1,3,0,0,4,1,4,0,3
1075,5705,1075.0,14,Chapecoense,Figueirense,6/11/2016,1,3,0,1,4,1,5,1,4
1076,5706,1076.0,14,Gremio,Sport,7/11/2016,4,3,0,0,7,4,7,0,3
1077,5707,1077.0,14,Fluminense,Athletico-PR,15/11/2016,3,3,0,0,6,3,6,0,3
1078,5708,1078.0,14,Botafogo-RJ,Chapecoense,16/11/2016,3,1,0,0,4,3,4,0,1
1079,5709,1079.0,14,Coritiba,Santa Cruz,16/11/2016,3,2,0,0,5,3,5,0,2
1080,5710,1080.0,14,Sport,Cruzeiro,16/11/2016,2,2,0,0,4,2,4,0,2
1081,5711,1081.0,14,America-MG,Flamengo,16/11/2016,1,0,0,0,1,1,1,0,0
1082,5712,1082.0,14,Figueirense,Corinthians,16/11/2016,3,2,0,1,5,3,6,1,3
1083,5713,1083.0,14,Santos,Vitoria,17/11/2016,3,1,0,0,4,3,4,0,1
1084,5714,1084.0,14,Sao Paulo,Gremio,17/11/2016,3,2,0,0,5,3,5,0,2
1085,5715,1085.0,14,Internacional,Ponte Preta,17/11/2016,1,3,0,0,4,1,4,0,3
1086,5716,1086.0,14,Atletico-MG,Palmeiras,17/11/2016,2,4,0,0,6,2,6,0,4
1087,5717,1087.0,14,Vitoria,Figueirense,20/11/2016,4,2,0,0,6,4,6,0,2
1088,5718,1088.0,14,Cruzeiro,Santos,20/11/2016,3,3,1,0,6,4,7,1,3
1089,5719,1089.0,14,Palmeiras,Botafogo-RJ,20/11/2016,0,4,0,1,4,0,5,1,5
1090,5720,1090.0,14,Athletico-PR,Sport,20/11/2016,0,2,0,0,2,0,2,0,2
1091,5721,1091.0,14,Gremio,America-MG,20/11/2016,0,2,0,0,2,0,2,0,2
1092,5722,1092.0,14,Ponte Preta,Fluminense,20/11/2016,3,3,0,1,6,3,7,1,4
1093,5723,1093.0,14,Flamengo,Coritiba,20/11/2016,1,2,0,0,3,1,3,0,2
1094,5724,1094.0,14,Chapecoense,Sao Paulo,20/11/2016,1,1,0,0,2,1,2,0,1
1095,5725,1095.0,14,Santa Cruz,Atletico-MG,20/11/2016,3,0,1,1,3,4,5,2,1
1096,5726,1096.0,14,Corinthians,Internacional,21/11/2016,2,2,0,0,4,2,4,0,2
1097,5727,1097.0,14,America-MG,Sport,26/11/2016,1,3,1,0,4,2,5,1,3
1098,5728,1098.0,14,Botafogo-RJ,Ponte Preta,26/11/2016,5,4,0,1,9,5,10,1,5
1099,5729,1099.0,14,Corinthians,Athletico-PR,26/11/2016,3,2,0,0,5,3,5,0,2
1100,5730,1100.0,14,Atletico-MG,Sao Paulo,27/11/2016,1,6,0,0,7,1,7,0,6
1101,5731,1101.0,14,Palmeiras,Chapecoense,27/11/2016,1,2,0,0,3,1,3,0,2
1102,5732,1102.0,14,Flamengo,Santos,27/11/2016,1,0,0,0,1,1,1,0,0
1103,5733,1103.0,14,Internacional,Cruzeiro,27/11/2016,3,4,0,0,7,3,7,0,4
1104,5734,1104.0,14,Figueirense,Fluminense,27/11/2016,3,3,0,0,6,3,6,0,3
1105,5735,1105.0,14,Santa Cruz,Gremio,27/11/2016,3,4,0,0,7,3,7,0,4
1106,5736,1106.0,14,Coritiba,Vitoria,28/11/2016,5,6,0,0,11,5,11,0,6
1107,5737,1107.0,14,Santos,America-MG,11/12/2016,0,1,0,0,1,0,1,0,1
1108,5738,1108.0,14,Fluminense,Internacional,11/12/2016,1,1,0,0,2,1,2,0,1
1109,5739,1109.0,14,Gremio,Botafogo-RJ,11/12/2016,2,4,0,1,6,2,7,1,5
1110,5740,1110.0,14,Sao Paulo,Santa Cruz,11/12/2016,2,1,1,0,3,3,4,1,1
1111,5741,1111.0,14,Cruzeiro,Corinthians,11/12/2016,2,4,0,0,6,2,6,0,4
1112,5742,1112.0,14,Sport,Figueirense,11/12/2016,5,2,0,0,7,5,7,0,2
1113,5743,1113.0,14,Athletico-PR,Flamengo,11/12/2016,2,6,0,1,8,2,9,1,7
1114,5744,1114.0,14,Vitoria,Palmeiras,11/12/2016,1,6,0,0,7,1,7,0,6
1115,5745,1115.0,14,Ponte Preta,Coritiba,11/12/2016,0,1,0,0,1,0,1,0,1
1116,5746,1116.0,15,Flamengo,Atletico-MG,13/5/2017,2,3,0,0,5,2,5,0,3
1117,5747,1117.0,15,Corinthians,Chapecoense,13/5/2017,2,2,0,0,4,2,4,0,2
1118,5748,1118.0,15,Fluminense,Santos,14/5/2017,1,5,0,0,6,1,6,0,5
1119,5749,1119.0,15,Cruzeiro,Sao Paulo,14/5/2017,0,1,0,0,1,0,1,0,1
1120,5750,1120.0,15,Bahia,Athletico-PR,14/5/2017,0,1,0,1,1,0,2,1,2
1121,5751,1121.0,15,Ponte Preta,Sport,14/5/2017,0,2,0,0,2,0,2,0,2
1122,5752,1122.0,15,Avai,Vitoria,14/5/2017,0,2,0,0,2,0,2,0,2
1123,5753,1123.0,15,Palmeiras,Vasco,14/5/2017,0,2,0,0,2,0,2,0,2
1124,5754,1124.0,15,Gremio,Botafogo-RJ,14/5/2017,2,5,0,0,7,2,7,0,5
1125,5755,1125.0,15,Coritiba,Atletico-GO,15/5/2017,1,2,0,0,3,1,3,0,2
1126,5756,1126.0,15,Santos,Coritiba,20/5/2017,6,4,0,0,10,6,10,0,4
1127,5757,1127.0,15,Atletico-GO,Flamengo,20/5/2017,2,1,0,0,3,2,3,0,1
1128,5758,1128.0,15,Chapecoense,Palmeiras,20/5/2017,1,1,0,0,2,1,2,0,1
1129,5759,1129.0,15,Vasco,Bahia,21/5/2017,4,2,0,1,6,4,7,1,3
1130,5760,1130.0,15,Athletico-PR,Gremio,21/5/2017,2,4,0,1,6,2,7,1,5
1131,5761,1131.0,15,Vitoria,Corinthians,21/5/2017,0,1,0,0,1,0,1,0,1
1132,5762,1132.0,15,Atletico-MG,Fluminense,21/5/2017,0,6,0,0,6,0,6,0,6
1133,5763,1133.0,15,Botafogo-RJ,Ponte Preta,21/5/2017,1,0,0,0,1,1,1,0,0
1134,5764,1134.0,15,Sport,Cruzeiro,21/5/2017,3,3,0,0,6,3,6,0,3
1135,5765,1135.0,15,Sao Paulo,Avai,22/5/2017,1,2,0,0,3,1,3,0,2
1136,5766,1136.0,15,Vasco,Fluminense,27/5/2017,2,3,0,0,5,2,5,0,3
1137,5767,1137.0,15,Sao Paulo,Palmeiras,27/5/2017,3,1,0,0,4,3,4,0,1
1138,5768,1138.0,15,Vitoria,Coritiba,27/5/2017,3,3,0,0,6,3,6,0,3
1139,5769,1139.0,15,Atletico-MG,Ponte Preta,28/5/2017,2,2,0,0,4,2,4,0,2
1140,5770,1140.0,15,Athletico-PR,Flamengo,28/5/2017,1,0,0,0,1,1,1,0,0
1141,5771,1141.0,15,Santos,Cruzeiro,28/5/2017,2,3,0,0,5,2,5,0,3
1142,5772,1142.0,15,Atletico-GO,Corinthians,28/5/2017,2,0,0,0,2,2,2,0,0
1143,5773,1143.0,15,Sport,Gremio,28/5/2017,4,1,1,0,5,5,6,1,1
1144,5774,1144.0,15,Botafogo-RJ,Bahia,28/5/2017,1,1,0,0,2,1,2,0,1
1145,5775,1145.0,15,Chapecoense,Avai,29/5/2017,2,1,1,1,3,3,5,2,2
1146,5776,1146.0,15,Coritiba,Athletico-PR,3/6/2017,3,2,0,0,5,3,5,0,2
1147,5777,1147.0,15,Fluminense,Vitoria,3/6/2017,0,5,0,0,5,0,5,0,5
1148,5778,1148.0,15,Corinthians,Santos,3/6/2017,0,1,0,1,1,0,2,1,2
1149,5779,1149.0,15,Flamengo,Botafogo-RJ,4/6/2017,2,2,0,0,4,2,4,0,2
1150,5780,1150.0,15,Avai,Sport,4/6/2017,4,4,0,0,8,4,8,0,4
1151,5781,1151.0,15,Palmeiras,Atletico-MG,4/6/2017,2,4,0,0,6,2,6,0,4
1152,5782,1152.0,15,Ponte Preta,Sao Paulo,4/6/2017,2,5,0,0,7,2,7,0,5
1153,5783,1153.0,15,Gremio,Vasco,4/6/2017,2,3,0,0,5,2,5,0,3
1154,5784,1154.0,15,Cruzeiro,Chapecoense,4/6/2017,1,3,0,0,4,1,4,0,3
1155,5785,1155.0,15,Bahia,Atletico-GO,5/6/2017,0,2,0,0,2,0,2,0,2
1156,5786,1156.0,15,Fluminense,Athletico-PR,6/6/2017,3,3,0,0,6,3,6,0,3
1157,5787,1157.0,15,Atletico-MG,Avai,7/6/2017,3,1,0,0,4,3,4,0,1
1158,5788,1158.0,15,Coritiba,Palmeiras,7/6/2017,4,3,0,0,7,4,7,0,3
1159,5789,1159.0,15,Santos,Botafogo-RJ,7/6/2017,4,2,0,0,6,4,6,0,2
1160,5790,1160.0,15,Vasco,Corinthians,7/6/2017,0,3,0,0,3,0,3,0,3
1161,5791,1161.0,15,Sport,Flamengo,7/6/2017,2,2,0,0,4,2,4,0,2
1162,5792,1162.0,15,Atletico-GO,Ponte Preta,8/6/2017,1,2,0,1,3,1,4,1,3
1163,5793,1163.0,15,Sao Paulo,Vitoria,8/6/2017,1,1,0,0,2,1,2,0,1
1164,5794,1164.0,15,Chapecoense,Gremio,8/6/2017,4,3,0,0,7,4,7,0,3
1165,5795,1165.0,15,Bahia,Cruzeiro,8/6/2017,4,2,0,1,6,4,7,1,3
1166,5796,1166.0,15,Palmeiras,Fluminense,10/6/2017,4,2,0,0,6,4,6,0,2
1167,5797,1167.0,15,Vasco,Sport,10/6/2017,0,1,0,0,1,0,1,0,1
1168,5798,1168.0,15,Botafogo-RJ,Coritiba,11/6/2017,4,3,0,0,7,4,7,0,3
1169,5799,1169.0,15,Ponte Preta,Chapecoense,11/6/2017,2,4,0,0,6,2,6,0,4
1170,5800,1170.0,15,Avai,Flamengo,11/6/2017,2,1,1,0,3,3,4,1,1
1171,5801,1171.0,15,Vitoria,Atletico-MG,11/6/2017,3,2,0,0,5,3,5,0,2
1172,5802,1172.0,15,Corinthians,Sao Paulo,11/6/2017,1,1,0,0,2,1,2,0,1
1173,5803,1173.0,15,Cruzeiro,Atletico-GO,11/6/2017,3,4,0,0,7,3,7,0,4
1174,5804,1174.0,15,Athletico-PR,Santos,11/6/2017,1,1,0,1,2,1,3,1,2
1175,5805,1175.0,15,Gremio,Bahia,12/6/2017,0,1,0,0,1,0,1,0,1
1176,5806,1176.0,15,Atletico-MG,Athletico-PR,14/6/2017,2,5,0,1,7,2,8,1,6
1177,5807,1177.0,15,Atletico-GO,Avai,14/6/2017,3,6,0,0,9,3,9,0,6
1178,5808,1178.0,15,Vitoria,Botafogo-RJ,14/6/2017,1,1,1,0,2,2,3,1,1
1179,5809,1179.0,15,Sport,Sao Paulo,14/6/2017,1,1,0,0,2,1,2,0,1
1180,5810,1180.0,15,Flamengo,Ponte Preta,14/6/2017,2,2,0,0,4,2,4,0,2
1181,5811,1181.0,15,Santos,Palmeiras,14/6/2017,1,3,0,0,4,1,4,0,3
1182,5812,1182.0,15,Chapecoense,Vasco,14/6/2017,3,2,0,0,5,3,5,0,2
1183,5813,1183.0,15,Corinthians,Cruzeiro,14/6/2017,0,1,0,0,1,0,1,0,1
1184,5814,1184.0,15,Coritiba,Bahia,15/6/2017,1,4,1,1,5,2,7,2,5
1185,5815,1185.0,15,Fluminense,Gremio,15/6/2017,4,3,0,0,7,4,7,0,3
1186,5816,1186.0,15,Atletico-GO,Athletico-PR,17/6/2017,1,5,0,0,6,1,6,0,5
1187,5817,1187.0,15,Vasco,Avai,17/6/2017,4,1,0,0,5,4,5,0,1
1188,5818,1188.0,15,Santos,Ponte Preta,17/6/2017,3,4,0,0,7,3,7,0,4
1189,5819,1189.0,15,Coritiba,Corinthians,18/6/2017,2,3,0,0,5,2,5,0,3
1190,5820,1190.0,15,Bahia,Palmeiras,18/6/2017,2,5,0,0,7,2,7,0,5
1191,5821,1191.0,15,Fluminense,Flamengo,18/6/2017,1,6,0,0,7,1,7,0,6
1192,5822,1192.0,15,Chapecoense,Botafogo-RJ,18/6/2017,0,2,0,0,2,0,2,0,2
1193,5823,1193.0,15,Sao Paulo,Atletico-MG,18/6/2017,2,2,0,0,4,2,4,0,2
1194,5825,1194.0,15,Cruzeiro,Gremio,19/6/2017,5,2,0,0,7,5,7,0,2
1195,5826,1195.0,15,Vitoria,Santos,21/6/2017,2,1,0,0,3,2,3,0,1
1196,5827,1196.0,15,Palmeiras,Atletico-GO,21/6/2017,2,2,0,0,4,2,4,0,2
1197,5828,1197.0,15,Botafogo-RJ,Vasco,21/6/2017,5,1,0,0,6,5,6,0,1
1198,5829,1198.0,15,Avai,Fluminense,21/6/2017,1,1,0,0,2,1,2,0,1
1199,5830,1199.0,15,Athletico-PR,Sao Paulo,21/6/2017,3,3,0,0,6,3,6,0,3
1200,5831,1200.0,15,Atletico-MG,Sport,21/6/2017,2,1,0,0,3,2,3,0,1
1201,5832,1201.0,15,Corinthians,Bahia,22/6/2017,3,3,1,1,6,4,8,2,4
1202,5833,1202.0,15,Ponte Preta,Cruzeiro,22/6/2017,2,2,0,0,4,2,4,0,2
1203,5834,1203.0,15,Gremio,Coritiba,22/6/2017,2,0,0,0,2,2,2,0,0
1204,5835,1204.0,15,Flamengo,Chapecoense,22/6/2017,3,1,0,0,4,3,4,0,1
1205,5836,1205.0,15,Santos,Sport,24/6/2017,0,1,0,0,1,0,1,0,1
1206,5837,1206.0,15,Vasco,Atletico-GO,25/6/2017,2,0,0,0,2,2,2,0,0
1207,5838,1207.0,15,Gremio,Corinthians,25/6/2017,4,5,0,0,9,4,9,0,5
1208,5839,1208.0,15,Sao Paulo,Fluminense,25/6/2017,1,1,0,0,2,1,2,0,1
1209,5840,1209.0,15,Athletico-PR,Vitoria,25/6/2017,0,3,0,0,3,0,3,0,3
1210,5841,1210.0,15,Cruzeiro,Coritiba,25/6/2017,0,2,0,0,2,0,2,0,2
1211,5842,1211.0,15,Ponte Preta,Palmeiras,25/6/2017,6,3,2,1,9,8,12,3,4
1212,5843,1212.0,15,Bahia,Flamengo,25/6/2017,2,3,1,0,5,3,6,1,3
1213,5844,1213.0,15,Chapecoense,Atletico-MG,25/6/2017,5,5,0,0,10,5,10,0,5
1214,5845,1214.0,15,Botafogo-RJ,Avai,26/6/2017,1,2,0,0,3,1,3,0,2
1215,5846,1215.0,15,Palmeiras,Gremio,1/7/2017,3,1,0,0,4,3,4,0,1
1216,5847,1216.0,15,Atletico-GO,Santos,1/7/2017,3,1,1,0,4,4,5,1,1
1217,5848,1217.0,15,Sport,Athletico-PR,2/7/2017,1,3,0,0,4,1,4,0,3
1218,5849,1218.0,15,Vitoria,Bahia,2/7/2017,5,3,0,0,8,5,8,0,3
1219,5850,1219.0,15,Atletico-MG,Cruzeiro,2/7/2017,4,4,0,0,8,4,8,0,4
1220,5851,1220.0,15,Flamengo,Sao Paulo,2/7/2017,1,1,0,0,2,1,2,0,1
1221,5852,1221.0,15,Corinthians,Botafogo-RJ,2/7/2017,3,2,0,0,5,3,5,0,2
1222,5853,1222.0,15,Avai,Ponte Preta,2/7/2017,2,2,0,0,4,2,4,0,2
1223,5854,1223.0,15,Coritiba,Vasco,2/7/2017,3,5,0,0,8,3,8,0,5
1224,5855,1224.0,15,Fluminense,Chapecoense,3/7/2017,3,5,0,1,8,3,9,1,6
1225,5856,1225.0,15,Atletico-GO,Vitoria,8/7/2017,1,4,0,0,5,1,5,0,4
1226,5857,1226.0,15,Vasco,Flamengo,8/7/2017,4,1,0,0,5,4,5,0,1
1227,5858,1227.0,15,Corinthians,Ponte Preta,8/7/2017,2,2,0,0,4,2,4,0,2
1228,5859,1228.0,15,Chapecoense,Athletico-PR,9/7/2017,1,3,0,0,4,1,4,0,3
1229,5860,1229.0,15,Bahia,Fluminense,9/7/2017,4,2,0,0,6,4,6,0,2
1230,5861,1230.0,15,Gremio,Avai,9/7/2017,1,5,0,1,6,1,7,1,6
1231,5862,1231.0,15,Cruzeiro,Palmeiras,9/7/2017,1,4,0,0,5,1,5,0,4
1232,5863,1232.0,15,Santos,Sao Paulo,9/7/2017,4,3,0,0,7,4,7,0,3
1233,5864,1233.0,15,Botafogo-RJ,Atletico-MG,9/7/2017,1,3,0,0,4,1,4,0,3
1234,5865,1234.0,15,Coritiba,Sport,10/7/2017,2,2,1,0,4,3,5,1,2
1235,5866,1235.0,15,Ponte Preta,Bahia,12/7/2017,1,3,0,0,4,1,4,0,3
1236,5867,1236.0,15,Atletico-MG,Santos,12/7/2017,1,2,0,0,3,1,3,0,2
1237,5868,1237.0,15,Fluminense,Botafogo-RJ,12/7/2017,3,4,0,0,7,3,7,0,4
1238,5869,1238.0,15,Palmeiras,Corinthians,12/7/2017,3,4,0,0,7,3,7,0,4
1239,5870,1239.0,15,Athletico-PR,Cruzeiro,12/7/2017,3,1,0,0,4,3,4,0,1
1240,5871,1240.0,15,Vitoria,Vasco,12/7/2017,4,3,0,0,7,4,7,0,3
1241,5872,1241.0,15,Sao Paulo,Atletico-GO,13/7/2017,0,3,0,0,3,0,3,0,3
1242,5873,1242.0,15,Sport,Chapecoense,13/7/2017,2,8,0,0,10,2,10,0,8
1243,5874,1243.0,15,Flamengo,Gremio,13/7/2017,2,2,0,0,4,2,4,0,2
1244,5875,1244.0,15,Avai,Coritiba,13/7/2017,2,2,0,0,4,2,4,0,2
1245,5877,1245.0,15,Palmeiras,Vitoria,16/7/2017,2,3,0,0,5,2,5,0,3
1246,5878,1246.0,15,Vasco,Santos,16/7/2017,4,3,0,1,7,4,8,1,4
1247,5879,1247.0,15,Atletico-GO,Atletico-MG,16/7/2017,2,3,0,0,5,2,5,0,3
1248,5880,1248.0,15,Chapecoense,Sao Paulo,16/7/2017,4,2,0,0,6,4,6,0,2
1249,5881,1249.0,15,Cruzeiro,Flamengo,16/7/2017,3,1,0,0,4,3,4,0,1
1250,5882,1250.0,15,Gremio,Ponte Preta,16/7/2017,1,2,0,0,3,1,3,0,2
1251,5883,1251.0,15,Bahia,Avai,16/7/2017,2,0,0,0,2,2,2,0,0
1252,5884,1252.0,15,Coritiba,Fluminense,16/7/2017,4,4,0,0,8,4,8,0,4
1253,5885,1253.0,15,Botafogo-RJ,Sport,17/7/2017,4,3,0,0,7,4,7,0,3
1254,5886,1254.0,15,Vitoria,Gremio,19/7/2017,3,3,0,0,6,3,6,0,3
1255,5887,1255.0,15,Santos,Chapecoense,19/7/2017,5,2,0,0,7,5,7,0,2
1256,5888,1256.0,15,Avai,Corinthians,19/7/2017,2,3,0,0,5,2,5,0,3
1257,5889,1257.0,15,Ponte Preta,Coritiba,19/7/2017,1,0,0,0,1,1,1,0,0
1258,5890,1258.0,15,Atletico-MG,Bahia,19/7/2017,4,6,0,0,10,4,10,0,6
1259,5891,1259.0,15,Sao Paulo,Vasco,19/7/2017,3,3,0,0,6,3,6,0,3
1260,5892,1260.0,15,Flamengo,Palmeiras,19/7/2017,2,9,0,0,11,2,11,0,9
1261,5893,1261.0,15,Fluminense,Cruzeiro,20/7/2017,3,3,0,0,6,3,6,0,3
1262,5894,1262.0,15,Sport,Atletico-GO,20/7/2017,2,1,0,0,3,2,3,0,1
1263,5895,1263.0,15,Athletico-PR,Botafogo-RJ,20/7/2017,3,5,0,1,8,3,9,1,6
1264,5896,1264.0,15,Vitoria,Chapecoense,22/7/2017,2,5,0,0,7,2,7,0,5
1265,5897,1265.0,15,Flamengo,Coritiba,22/7/2017,1,6,0,0,7,1,7,0,6
1266,5898,1266.0,15,Santos,Bahia,23/7/2017,1,1,0,0,2,1,2,0,1
1267,5899,1267.0,15,Avai,Cruzeiro,23/7/2017,2,0,0,0,2,2,2,0,0
1268,5900,1268.0,15,Sport,Palmeiras,23/7/2017,3,4,0,0,7,3,7,0,4
1269,5901,1269.0,15,Fluminense,Corinthians,23/7/2017,2,2,0,0,4,2,4,0,2
1270,5902,1270.0,15,Athletico-PR,Ponte Preta,23/7/2017,2,2,0,0,4,2,4,0,2
1271,5903,1271.0,15,Atletico-GO,Botafogo-RJ,23/7/2017,1,4,0,0,5,1,5,0,4
1272,5904,1272.0,15,Atletico-MG,Vasco,23/7/2017,5,3,0,0,8,5,8,0,3
1273,5905,1273.0,15,Sao Paulo,Gremio,24/7/2017,1,3,0,0,4,1,4,0,3
1274,5906,1274.0,15,Botafogo-RJ,Sao Paulo,29/7/2017,0,1,0,0,1,0,1,0,1
1275,5907,1275.0,15,Palmeiras,Avai,29/7/2017,1,2,0,1,3,1,4,1,3
1276,5908,1276.0,15,Chapecoense,Atletico-GO,30/7/2017,1,1,0,0,2,1,2,0,1
1277,5909,1277.0,15,Coritiba,Atletico-MG,30/7/2017,4,4,0,0,8,4,8,0,4
1278,5910,1278.0,15,Bahia,Sport,30/7/2017,2,6,0,0,8,2,8,0,6
1279,5911,1279.0,15,Corinthians,Flamengo,30/7/2017,0,1,0,0,1,0,1,0,1
1280,5912,1280.0,15,Gremio,Santos,30/7/2017,4,5,1,0,9,5,10,1,5
1281,5913,1281.0,15,Cruzeiro,Vitoria,30/7/2017,4,4,0,0,8,4,8,0,4
1282,5914,1282.0,15,Vasco,Athletico-PR,31/7/2017,3,3,0,0,6,3,6,0,3
1283,5915,1283.0,15,Ponte Preta,Fluminense,9/8/2017,1,1,0,0,2,1,2,0,1
1284,5916,1284.0,15,Sport,Fluminense,2/8/2017,5,4,0,1,9,5,10,1,5
1285,5917,1285.0,15,Chapecoense,Bahia,2/8/2017,5,3,0,0,8,5,8,0,3
1286,5918,1286.0,15,Atletico-MG,Corinthians,2/8/2017,3,1,0,0,4,3,4,0,1
1287,5919,1287.0,15,Vitoria,Ponte Preta,2/8/2017,3,1,0,0,4,3,4,0,1
1288,5920,1288.0,15,Santos,Flamengo,2/8/2017,3,3,1,1,6,4,8,2,4
1289,5921,1289.0,15,Atletico-GO,Gremio,2/8/2017,4,2,0,0,6,4,6,0,2
1290,5922,1290.0,15,Botafogo-RJ,Palmeiras,2/8/2017,5,2,0,0,7,5,7,0,2
1291,5923,1291.0,15,Athletico-PR,Avai,3/8/2017,1,2,0,0,3,1,3,0,2
1292,5924,1292.0,15,Sao Paulo,Coritiba,3/8/2017,4,5,0,0,9,4,9,0,5
1293,5925,1293.0,15,Vasco,Cruzeiro,3/8/2017,4,1,0,0,5,4,5,0,1
1294,5926,1294.0,15,Corinthians,Sport,5/8/2017,1,2,0,0,3,1,3,0,2
1295,5927,1295.0,15,Fluminense,Atletico-GO,5/8/2017,1,3,0,0,4,1,4,0,3
1296,5928,1296.0,15,Flamengo,Vitoria,6/8/2017,4,2,0,0,6,4,6,0,2
1297,5929,1297.0,15,Cruzeiro,Botafogo-RJ,6/8/2017,3,3,0,0,6,3,6,0,3
1298,5930,1298.0,15,Gremio,Atletico-MG,6/8/2017,3,1,0,0,4,3,4,0,1
1299,5932,1299.0,15,Palmeiras,Athletico-PR,6/8/2017,1,3,0,0,4,1,4,0,3
1300,5933,1300.0,15,Bahia,Sao Paulo,6/8/2017,4,2,0,0,6,4,6,0,2
1301,5934,1301.0,15,Avai,Santos,6/8/2017,3,1,0,0,4,3,4,0,1
1302,5935,1302.0,15,Ponte Preta,Vasco,6/8/2017,1,4,0,0,5,1,5,0,4
1303,5936,1303.0,15,Atletico-GO,Coritiba,12/8/2017,2,3,0,0,5,2,5,0,3
1304,5937,1304.0,15,Vitoria,Avai,12/8/2017,1,3,0,0,4,1,4,0,3
1305,5938,1305.0,15,Sao Paulo,Cruzeiro,13/8/2017,5,4,1,2,9,6,12,3,6
1306,5939,1306.0,15,Sport,Ponte Preta,13/8/2017,1,1,0,0,2,1,2,0,1
1307,5940,1307.0,15,Atletico-MG,Flamengo,13/8/2017,4,2,0,1,6,4,7,1,3
1308,5941,1308.0,15,Vasco,Palmeiras,13/8/2017,1,2,0,0,3,1,3,0,2
1309,5942,1309.0,15,Athletico-PR,Bahia,13/8/2017,2,4,0,0,6,2,6,0,4
1310,5943,1310.0,15,Botafogo-RJ,Gremio,13/8/2017,3,1,0,0,4,3,4,0,1
1311,5944,1311.0,15,Santos,Fluminense,14/8/2017,2,2,0,0,4,2,4,0,2
1312,5945,1312.0,15,Chapecoense,Corinthians,23/8/2017,1,4,0,0,5,1,5,0,4
1313,5946,1313.0,15,Corinthians,Vitoria,19/8/2017,1,2,0,0,3,1,3,0,2
1314,5947,1314.0,15,Flamengo,Atletico-GO,19/8/2017,2,3,0,0,5,2,5,0,3
1315,5948,1315.0,15,Gremio,Athletico-PR,20/8/2017,2,2,0,0,4,2,4,0,2
1316,5949,1316.0,15,Avai,Sao Paulo,20/8/2017,1,3,0,0,4,1,4,0,3
1317,5950,1317.0,15,Bahia,Vasco,20/8/2017,0,4,0,0,4,0,4,0,4
1318,5951,1318.0,15,Cruzeiro,Sport,20/8/2017,1,0,0,0,1,1,1,0,0
1319,5952,1319.0,15,Ponte Preta,Botafogo-RJ,20/8/2017,4,4,0,0,8,4,8,0,4
1320,5953,1320.0,15,Coritiba,Santos,20/8/2017,3,1,0,0,4,3,4,0,1
1321,5954,1321.0,15,Palmeiras,Chapecoense,20/8/2017,1,4,0,0,5,1,5,0,4
1322,5955,1322.0,15,Fluminense,Atletico-MG,21/8/2017,1,2,0,0,3,1,3,0,2
1323,5956,1323.0,15,Fluminense,Vasco,26/8/2017,2,4,0,0,6,2,6,0,4
1324,5957,1324.0,15,Corinthians,Atletico-GO,26/8/2017,1,5,0,0,6,1,6,0,5
1325,5958,1325.0,15,Ponte Preta,Atletico-MG,27/8/2017,4,4,0,0,8,4,8,0,4
1326,5959,1326.0,15,Palmeiras,Sao Paulo,27/8/2017,1,2,0,0,3,1,3,0,2
1327,5960,1327.0,15,Bahia,Botafogo-RJ,27/8/2017,2,0,0,0,2,2,2,0,0
1328,5961,1328.0,15,Flamengo,Athletico-PR,27/8/2017,0,2,0,0,2,0,2,0,2
1329,5962,1329.0,15,Cruzeiro,Santos,27/8/2017,0,2,0,0,2,0,2,0,2
1330,5963,1330.0,15,Avai,Chapecoense,27/8/2017,4,5,0,0,9,4,9,0,5
1331,5964,1331.0,15,Coritiba,Vitoria,28/8/2017,2,2,2,1,4,4,7,3,3
1332,5965,1332.0,15,Gremio,Sport,2/9/2017,1,5,0,0,6,1,6,0,5
1333,5966,1333.0,15,Atletico-MG,Palmeiras,9/9/2017,3,3,0,2,6,3,8,2,5
1334,5967,1334.0,15,Vasco,Gremio,9/9/2017,3,0,0,0,3,3,3,0,0
1335,5968,1335.0,15,Sao Paulo,Ponte Preta,9/9/2017,2,1,1,0,3,3,4,1,1
1336,5969,1336.0,15,Athletico-PR,Coritiba,10/9/2017,1,3,0,1,4,1,5,1,4
1337,5970,1337.0,15,Santos,Corinthians,10/9/2017,3,5,0,0,8,3,8,0,5
1338,5971,1338.0,15,Sport,Avai,10/9/2017,4,5,0,0,9,4,9,0,5
1339,5972,1339.0,15,Vitoria,Fluminense,10/9/2017,1,3,0,1,4,1,5,1,4
1340,5973,1340.0,15,Chapecoense,Cruzeiro,10/9/2017,2,1,0,0,3,2,3,0,1
1341,5975,1341.0,15,Atletico-GO,Bahia,11/9/2017,1,2,0,0,3,1,3,0,2
1342,5976,1342.0,15,Botafogo-RJ,Santos,16/9/2017,2,2,0,0,4,2,4,0,2
1343,5977,1343.0,15,Ponte Preta,Atletico-GO,16/9/2017,2,2,0,0,4,2,4,0,2
1344,5978,1344.0,15,Avai,Atletico-MG,17/9/2017,2,3,0,1,5,2,6,1,4
1345,5979,1345.0,15,Gremio,Chapecoense,17/9/2017,1,5,0,0,6,1,6,0,5
1346,5980,1346.0,15,Corinthians,Vasco,17/9/2017,1,2,0,0,3,1,3,0,2
1347,5981,1347.0,15,Athletico-PR,Fluminense,17/9/2017,3,3,0,0,6,3,6,0,3
1348,5982,1348.0,15,Vitoria,Sao Paulo,17/9/2017,3,2,0,0,5,3,5,0,2
1349,5983,1349.0,15,Flamengo,Sport,17/9/2017,0,3,0,1,3,0,4,1,4
1350,5984,1350.0,15,Cruzeiro,Bahia,17/9/2017,5,1,1,0,6,6,7,1,1
1351,5985,1351.0,15,Palmeiras,Coritiba,18/9/2017,3,3,0,0,6,3,6,0,3
1352,5986,1352.0,15,Flamengo,Avai,23/9/2017,2,0,0,0,2,2,2,0,0
1353,5987,1353.0,15,Santos,Athletico-PR,23/9/2017,1,1,0,0,2,1,2,0,1
1354,5988,1354.0,15,Sao Paulo,Corinthians,24/9/2017,2,4,0,0,6,2,6,0,4
1355,5989,1355.0,15,Chapecoense,Ponte Preta,24/9/2017,4,3,0,0,7,4,7,0,3
1356,5990,1356.0,15,Coritiba,Botafogo-RJ,24/9/2017,2,3,0,0,5,2,5,0,3
1357,5991,1357.0,15,Atletico-GO,Cruzeiro,24/9/2017,4,2,0,0,6,4,6,0,2
1358,5992,1358.0,15,Fluminense,Palmeiras,24/9/2017,2,2,0,0,4,2,4,0,2
1359,5993,1359.0,15,Atletico-MG,Vitoria,24/9/2017,1,2,0,0,3,1,3,0,2
1360,5994,1360.0,15,Bahia,Gremio,24/9/2017,4,5,0,0,9,4,9,0,5
1361,5995,1361.0,15,Sport,Vasco,25/9/2017,1,4,1,0,5,2,6,1,4
1362,5996,1362.0,15,Vasco,Chapecoense,30/9/2017,3,0,0,0,3,3,3,0,0
1363,5997,1363.0,15,Bahia,Coritiba,30/9/2017,4,5,0,0,9,4,9,0,5
1364,5998,1364.0,15,Palmeiras,Santos,30/9/2017,3,5,0,0,8,3,8,0,5
1365,5999,1365.0,15,Cruzeiro,Corinthians,1/10/2017,3,4,0,0,7,3,7,0,4
1366,6000,1366.0,15,Botafogo-RJ,Vitoria,1/10/2017,2,2,1,0,4,3,5,1,2
1367,6001,1367.0,15,Sao Paulo,Sport,1/10/2017,0,2,0,0,2,0,2,0,2
1368,6002,1368.0,15,Gremio,Fluminense,1/10/2017,1,2,0,0,3,1,3,0,2
1369,6003,1369.0,15,Avai,Atletico-GO,1/10/2017,2,2,0,0,4,2,4,0,2
1370,6004,1370.0,15,Athletico-PR,Atletico-MG,1/10/2017,1,4,0,0,5,1,5,0,4
1371,6005,1371.0,15,Ponte Preta,Flamengo,2/10/2017,5,3,1,0,8,6,9,1,3
1372,6006,1372.0,15,Cruzeiro,Ponte Preta,7/10/2017,5,1,0,1,6,5,7,1,2
1373,6007,1373.0,15,Vasco,Botafogo-RJ,14/10/2017,5,3,0,0,8,5,8,0,3
1374,6008,1374.0,15,Sao Paulo,Athletico-PR,14/10/2017,1,2,0,1,3,1,4,1,3
1375,6009,1375.0,15,Chapecoense,Flamengo,15/10/2017,2,2,0,0,4,2,4,0,2
1376,6010,1376.0,15,Atletico-GO,Palmeiras,15/10/2017,2,1,1,0,3,3,4,1,1
1377,6011,1377.0,15,Fluminense,Avai,15/10/2017,2,2,0,0,4,2,4,0,2
1378,6012,1378.0,15,Sport,Atletico-MG,15/10/2017,2,2,0,0,4,2,4,0,2
1379,6013,1379.0,15,Coritiba,Gremio,15/10/2017,4,3,0,0,7,4,7,0,3
1380,6014,1380.0,15,Bahia,Corinthians,15/10/2017,0,2,0,0,2,0,2,0,2
1381,6015,1381.0,15,Santos,Vitoria,16/10/2017,2,4,0,0,6,2,6,0,4
1382,6016,1382.0,15,Athletico-PR,Atletico-GO,11/10/2017,3,2,0,0,5,3,5,0,2
1383,6017,1383.0,15,Botafogo-RJ,Chapecoense,11/10/2017,1,3,0,0,4,1,4,0,3
1384,6018,1384.0,15,Corinthians,Coritiba,11/10/2017,1,3,0,0,4,1,4,0,3
1385,6020,1385.0,15,Avai,Vasco,11/10/2017,5,3,1,1,8,6,10,2,4
1386,6021,1386.0,15,Atletico-MG,Sao Paulo,11/10/2017,1,3,0,0,4,1,4,0,3
1387,6022,1387.0,15,Vitoria,Sport,12/10/2017,2,3,1,0,5,3,6,1,3
1388,6023,1388.0,15,Flamengo,Fluminense,12/10/2017,2,4,0,0,6,2,6,0,4
1389,6024,1389.0,15,Ponte Preta,Santos,12/10/2017,3,2,1,0,5,4,6,1,2
1390,6025,1390.0,15,Palmeiras,Bahia,12/10/2017,1,2,0,0,3,1,3,0,2
1391,6026,1391.0,15,Atletico-GO,Vasco,18/10/2017,2,2,1,0,4,3,5,1,2
1392,6027,1392.0,15,Coritiba,Cruzeiro,18/10/2017,1,1,0,0,2,1,2,0,1
1393,6028,1393.0,15,Atletico-MG,Chapecoense,18/10/2017,2,3,1,0,5,3,6,1,3
1394,6029,1394.0,15,Avai,Botafogo-RJ,18/10/2017,2,4,0,0,6,2,6,0,4
1395,6030,1395.0,15,Fluminense,Sao Paulo,18/10/2017,2,0,0,0,2,2,2,0,0
1396,6031,1396.0,15,Corinthians,Gremio,18/10/2017,1,1,0,0,2,1,2,0,1
1397,6032,1397.0,15,Vitoria,Athletico-PR,19/10/2017,0,3,0,0,3,0,3,0,3
1398,6033,1398.0,15,Palmeiras,Ponte Preta,19/10/2017,0,4,0,0,4,0,4,0,4
1399,6034,1399.0,15,Flamengo,Bahia,19/10/2017,5,4,0,0,9,5,9,0,4
1400,6035,1400.0,15,Sport,Santos,19/10/2017,1,5,0,0,6,1,6,0,5
1401,6036,1401.0,15,Vasco,Coritiba,21/10/2017,1,2,1,0,3,2,4,1,2
1402,6037,1402.0,15,Santos,Atletico-GO,22/10/2017,1,1,0,0,2,1,2,0,1
1403,6038,1403.0,15,Bahia,Vitoria,22/10/2017,2,3,0,0,5,2,5,0,3
1404,6039,1404.0,15,Gremio,Palmeiras,22/10/2017,2,1,0,0,3,2,3,0,1
1405,6040,1405.0,15,Sao Paulo,Flamengo,22/10/2017,1,1,0,0,2,1,2,0,1
1406,6041,1406.0,15,Athletico-PR,Sport,22/10/2017,0,2,0,0,2,0,2,0,2
1407,6042,1407.0,15,Cruzeiro,Atletico-MG,22/10/2017,2,4,0,0,6,2,6,0,4
1408,6043,1408.0,15,Chapecoense,Fluminense,22/10/2017,1,1,0,0,2,1,2,0,1
1409,6044,1409.0,15,Ponte Preta,Avai,22/10/2017,5,2,0,0,7,5,7,0,2
1410,6045,1410.0,15,Botafogo-RJ,Corinthians,23/10/2017,3,2,0,0,5,3,5,0,2
1411,6046,1411.0,15,Sao Paulo,Santos,28/10/2017,1,6,0,0,7,1,7,0,6
1412,6047,1412.0,15,Flamengo,Vasco,28/10/2017,1,1,0,0,2,1,2,0,1
1413,6048,1413.0,15,Athletico-PR,Chapecoense,28/10/2017,1,4,0,0,5,1,5,0,4
1414,6049,1414.0,15,Ponte Preta,Corinthians,29/10/2017,4,1,0,0,5,4,5,0,1
1415,6050,1415.0,15,Fluminense,Bahia,29/10/2017,1,3,0,1,4,1,5,1,4
1416,6051,1416.0,15,Atletico-MG,Botafogo-RJ,29/10/2017,1,2,0,0,3,1,3,0,2
1417,6052,1417.0,15,Vitoria,Atletico-GO,29/10/2017,1,3,0,0,4,1,4,0,3
1418,6053,1418.0,15,Sport,Coritiba,29/10/2017,3,6,0,0,9,3,9,0,6
1419,6054,1419.0,15,Avai,Gremio,29/10/2017,1,2,0,0,3,1,3,0,2
1420,6055,1420.0,15,Palmeiras,Cruzeiro,30/10/2017,0,2,0,0,2,0,2,0,2
1421,6056,1421.0,15,Santos,Atletico-MG,4/11/2017,1,3,0,0,4,1,4,0,3
1422,6057,1422.0,15,Botafogo-RJ,Fluminense,4/11/2017,3,4,0,0,7,3,7,0,4
1423,6058,1423.0,15,Atletico-GO,Sao Paulo,4/11/2017,2,0,0,0,2,2,2,0,0
1424,6059,1424.0,15,Coritiba,Avai,4/11/2017,1,2,0,0,3,1,3,0,2
1425,6060,1425.0,15,Corinthians,Palmeiras,5/11/2017,6,5,0,1,11,6,12,1,6
1426,6061,1426.0,15,Cruzeiro,Athletico-PR,5/11/2017,1,2,0,0,3,1,3,0,2
1427,6063,1427.0,15,Bahia,Ponte Preta,5/11/2017,1,2,0,0,3,1,3,0,2
1428,6064,1428.0,15,Vasco,Vitoria,5/11/2017,3,4,0,0,7,3,7,0,4
1429,6065,1429.0,15,Chapecoense,Sport,5/11/2017,3,3,0,1,6,3,7,1,4
1430,6066,1430.0,15,Ponte Preta,Gremio,8/11/2017,4,3,1,0,7,5,8,1,3
1431,6067,1431.0,15,Avai,Bahia,8/11/2017,2,2,0,0,4,2,4,0,2
1432,6068,1432.0,15,Sport,Botafogo-RJ,8/11/2017,2,4,0,0,6,2,6,0,4
1433,6069,1433.0,15,Athletico-PR,Corinthians,8/11/2017,2,1,0,0,3,2,3,0,1
1434,6070,1434.0,15,Santos,Vasco,8/11/2017,2,5,0,0,7,2,7,0,5
1435,6071,1435.0,15,Flamengo,Cruzeiro,8/11/2017,2,3,0,0,5,2,5,0,3
1436,6072,1436.0,15,Vitoria,Palmeiras,8/11/2017,4,1,1,0,5,5,6,1,1
1437,6073,1437.0,15,Sao Paulo,Chapecoense,9/11/2017,1,2,0,0,3,1,3,0,2
1438,6074,1438.0,15,Atletico-MG,Atletico-GO,9/11/2017,6,5,0,0,11,6,11,0,5
1439,6075,1439.0,15,Fluminense,Coritiba,9/11/2017,3,4,0,0,7,3,7,0,4
1440,6076,1440.0,15,Botafogo-RJ,Athletico-PR,11/11/2017,0,1,0,0,1,0,1,0,1
1441,6077,1441.0,15,Corinthians,Avai,11/11/2017,3,3,0,0,6,3,6,0,3
1442,6078,1442.0,15,Vasco,Sao Paulo,12/11/2017,2,2,0,1,4,2,5,1,3
1443,6079,1443.0,15,Palmeiras,Flamengo,12/11/2017,0,1,0,0,1,0,1,0,1
1444,6080,1444.0,15,Atletico-GO,Sport,12/11/2017,0,3,0,0,3,0,3,0,3
1445,6081,1445.0,15,Gremio,Vitoria,12/11/2017,0,2,0,1,2,0,3,1,3
1446,6082,1446.0,15,Bahia,Atletico-MG,12/11/2017,1,4,0,0,5,1,5,0,4
1447,6083,1447.0,15,Cruzeiro,Fluminense,12/11/2017,4,3,0,1,7,4,8,1,4
1448,6084,1448.0,15,Coritiba,Ponte Preta,12/11/2017,2,2,0,0,4,2,4,0,2
1449,6085,1449.0,15,Chapecoense,Santos,13/11/2017,0,3,0,0,3,0,3,0,3
1450,6086,1450.0,15,Ponte Preta,Athletico-PR,15/11/2017,1,3,0,0,4,1,4,0,3
1451,6087,1451.0,15,Cruzeiro,Avai,15/11/2017,4,2,0,0,6,4,6,0,2
1452,6088,1452.0,15,Gremio,Sao Paulo,15/11/2017,1,3,0,0,4,1,4,0,3
1453,6089,1453.0,15,Vasco,Atletico-MG,15/11/2017,1,0,0,0,1,1,1,0,0
1454,6090,1454.0,15,Corinthians,Fluminense,15/11/2017,1,6,0,0,7,1,7,0,6
1455,6091,1455.0,15,Botafogo-RJ,Atletico-GO,16/11/2017,1,3,0,0,4,1,4,0,3
1456,6092,1456.0,15,Chapecoense,Vitoria,16/11/2017,1,4,0,0,5,1,5,0,4
1457,6093,1457.0,15,Palmeiras,Sport,16/11/2017,0,2,0,0,2,0,2,0,2
1458,6094,1458.0,15,Coritiba,Flamengo,16/11/2017,3,5,0,0,8,3,8,0,5
1459,6095,1459.0,15,Bahia,Santos,16/11/2017,3,2,0,0,5,3,5,0,2
1460,6096,1460.0,15,Sport,Bahia,19/11/2017,4,3,0,0,7,4,7,0,3
1461,6097,1461.0,15,Flamengo,Corinthians,19/11/2017,4,4,0,0,8,4,8,0,4
1462,6098,1462.0,15,Vitoria,Cruzeiro,19/11/2017,3,2,0,0,5,3,5,0,2
1463,6099,1463.0,15,Atletico-GO,Chapecoense,19/11/2017,4,4,0,0,8,4,8,0,4
1464,6100,1464.0,15,Sao Paulo,Botafogo-RJ,19/11/2017,2,3,0,0,5,2,5,0,3
1465,6101,1465.0,15,Athletico-PR,Vasco,19/11/2017,1,2,0,0,3,1,3,0,2
1466,6102,1466.0,15,Atletico-MG,Coritiba,19/11/2017,2,5,0,0,7,2,7,0,5
1467,6103,1467.0,15,Santos,Gremio,19/11/2017,2,2,0,0,4,2,4,0,2
1468,6104,1468.0,15,Fluminense,Ponte Preta,20/11/2017,2,2,0,1,4,2,5,1,3
1469,6105,1469.0,15,Avai,Palmeiras,20/11/2017,2,2,0,0,4,2,4,0,2
1470,6106,1470.0,15,Fluminense,Sport,25/11/2017,4,2,0,0,6,4,6,0,2
1471,6107,1471.0,15,Avai,Athletico-PR,26/11/2017,3,1,0,0,4,3,4,0,1
1472,6108,1472.0,15,Corinthians,Atletico-MG,26/11/2017,4,1,0,0,5,4,5,0,1
1473,6109,1473.0,15,Ponte Preta,Vitoria,26/11/2017,3,6,1,0,9,4,10,1,6
1474,6110,1474.0,15,Coritiba,Sao Paulo,26/11/2017,4,1,0,0,5,4,5,0,1
1475,6111,1475.0,15,Cruzeiro,Vasco,26/11/2017,3,2,0,0,5,3,5,0,2
1476,6112,1476.0,15,Gremio,Atletico-GO,26/11/2017,2,3,0,0,5,2,5,0,3
1477,6113,1477.0,15,Flamengo,Santos,26/11/2017,3,4,0,0,7,3,7,0,4
1478,6114,1478.0,15,Bahia,Chapecoense,26/11/2017,5,3,1,0,8,6,9,1,3
1479,6115,1479.0,15,Palmeiras,Botafogo-RJ,27/11/2017,3,4,0,0,7,3,7,0,4
1480,6116,1480.0,15,Atletico-MG,Gremio,3/12/2017,7,1,1,0,8,8,9,1,1
1481,6117,1481.0,15,Botafogo-RJ,Cruzeiro,3/12/2017,1,5,0,1,6,1,7,1,6
1482,6118,1482.0,15,Santos,Avai,3/12/2017,2,1,0,0,3,2,3,0,1
1483,6119,1483.0,15,Sport,Corinthians,3/12/2017,3,2,0,0,5,3,5,0,2
1484,6120,1484.0,15,Vitoria,Flamengo,3/12/2017,3,3,2,0,6,5,8,2,3
1485,6121,1485.0,15,Atletico-GO,Fluminense,3/12/2017,1,4,0,0,5,1,5,0,4
1486,6122,1486.0,15,Sao Paulo,Bahia,3/12/2017,4,4,1,1,8,5,10,2,5
1487,6123,1487.0,15,Chapecoense,Coritiba,3/12/2017,3,2,0,0,5,3,5,0,2
1488,6124,1488.0,15,Vasco,Ponte Preta,3/12/2017,5,5,0,0,10,5,10,0,5
1489,6125,1489.0,15,Athletico-PR,Palmeiras,3/12/2017,3,5,0,0,8,3,8,0,5
1490,6126,1490.0,16,Cruzeiro,Gremio,14/4/2018,3,1,0,1,4,3,5,1,2
1491,6127,1491.0,16,Vitoria,Flamengo,14/4/2018,3,2,0,1,5,3,6,1,3
1492,6128,1492.0,16,Santos,Ceara,14/4/2018,0,1,0,0,1,0,1,0,1
1493,6129,1493.0,16,America-MG,Sport,15/4/2018,1,3,0,0,4,1,4,0,3
1494,6130,1494.0,16,Vasco,Atletico-MG,15/4/2018,4,3,0,0,7,4,7,0,3
1495,6131,1495.0,16,Internacional,Bahia,15/4/2018,2,0,0,0,2,2,2,0,0
1496,6133,1496.0,16,Athletico-PR,Chapecoense,15/4/2018,1,3,0,0,4,1,4,0,3
1497,6134,1497.0,16,Sao Paulo,Parana,16/4/2018,4,2,0,0,6,4,6,0,2
1498,6135,1498.0,16,Botafogo-RJ,Palmeiras,16/4/2018,1,4,0,0,5,1,5,0,4
1499,6136,1499.0,16,Bahia,Santos,21/4/2018,4,3,0,0,7,4,7,0,3
1500,6137,1500.0,16,Flamengo,America-MG,21/4/2018,1,1,0,0,2,1,2,0,1
1501,6138,1501.0,16,Parana,Corinthians,22/4/2018,1,1,0,0,2,1,2,0,1
1502,6139,1502.0,16,Ceara,Sao Paulo,22/4/2018,1,1,0,0,2,1,2,0,1
1503,6140,1503.0,16,Atletico-MG,Vitoria,22/4/2018,2,4,0,0,6,2,6,0,4
1504,6141,1504.0,16,Fluminense,Cruzeiro,22/4/2018,3,2,1,0,5,4,6,1,2
1505,6142,1505.0,16,Chapecoense,Vasco,22/4/2018,1,2,0,0,3,1,3,0,2
1506,6143,1506.0,16,Palmeiras,Internacional,22/4/2018,2,2,0,0,4,2,4,0,2
1507,6144,1507.0,16,Gremio,Athletico-PR,22/4/2018,3,3,0,1,6,3,7,1,4
1508,6145,1508.0,16,Sport,Botafogo-RJ,23/4/2018,1,3,0,0,4,1,4,0,3
1509,6146,1509.0,16,Botafogo-RJ,Gremio,28/4/2018,1,1,0,0,2,1,2,0,1
1510,6147,1510.0,16,Bahia,Athletico-PR,29/4/2018,2,2,0,0,4,2,4,0,2
1511,6148,1511.0,16,Ceara,Flamengo,29/4/2018,1,2,0,0,3,1,3,0,2
1512,6149,1512.0,16,Palmeiras,Chapecoense,29/4/2018,4,6,0,0,10,4,10,0,6
1513,6150,1513.0,16,Parana,Sport,29/4/2018,1,1,0,0,2,1,2,0,1
1514,6151,1514.0,16,Atletico-MG,Corinthians,29/4/2018,4,3,0,0,7,4,7,0,3
1515,6152,1515.0,16,Fluminense,Sao Paulo,29/4/2018,3,2,0,0,5,3,5,0,2
1516,6153,1516.0,16,Internacional,Cruzeiro,29/4/2018,4,3,0,0,7,4,7,0,3
1517,6154,1517.0,16,America-MG,Vitoria,30/4/2018,2,2,1,0,4,3,5,1,2
1518,6155,1518.0,16,Santos,Vasco,27/9/2018,1,3,0,1,4,1,5,1,4
1519,6156,1519.0,16,Vasco,America-MG,5/5/2018,4,4,0,0,8,4,8,0,4
1520,6157,1520.0,16,Sao Paulo,Atletico-MG,5/5/2018,4,4,0,0,8,4,8,0,4
1521,6158,1521.0,16,Corinthians,Ceara,6/5/2018,2,4,0,0,6,2,6,0,4
1522,6159,1522.0,16,Flamengo,Internacional,6/5/2018,5,4,0,1,9,5,10,1,5
1523,6160,1523.0,16,Cruzeiro,Botafogo-RJ,6/5/2018,1,4,0,0,5,1,5,0,4
1524,6161,1524.0,16,Athletico-PR,Palmeiras,6/5/2018,1,2,0,0,3,1,3,0,2
1525,6162,1525.0,16,Vitoria,Fluminense,6/5/2018,2,1,0,0,3,2,3,0,1
1526,6163,1526.0,16,Gremio,Santos,6/5/2018,1,3,0,0,4,1,4,0,3
1527,6164,1527.0,16,Sport,Bahia,6/5/2018,1,2,0,1,3,1,4,1,3
1528,6165,1528.0,16,Chapecoense,Parana,7/5/2018,1,2,0,1,3,1,4,1,3
1529,6166,1529.0,16,Gremio,Internacional,12/5/2018,3,4,0,0,7,3,7,0,4
1530,6167,1530.0,16,Cruzeiro,Sport,13/5/2018,2,3,0,0,5,2,5,0,3
1531,6168,1531.0,16,Athletico-PR,Atletico-MG,13/5/2018,2,2,0,0,4,2,4,0,2
1532,6169,1532.0,16,Vasco,Vitoria,13/5/2018,2,3,0,0,5,2,5,0,3
1533,6170,1533.0,16,Corinthians,Palmeiras,13/5/2018,2,3,0,0,5,2,5,0,3
1534,6171,1534.0,16,Bahia,Sao Paulo,13/5/2018,5,3,0,0,8,5,8,0,3
1535,6172,1535.0,16,Chapecoense,Flamengo,13/5/2018,2,3,0,0,5,2,5,0,3
1536,6173,1536.0,16,Santos,Parana,13/5/2018,1,2,0,0,3,1,3,0,2
1537,6174,1537.0,16,Botafogo-RJ,Fluminense,14/5/2018,2,2,0,0,4,2,4,0,2
1538,6175,1538.0,16,Ceara,America-MG,14/5/2018,1,3,0,0,4,1,4,0,3
1539,6176,1539.0,16,Atletico-MG,Cruzeiro,19/5/2018,3,2,0,1,5,3,6,1,3
1540,6177,1540.0,16,Flamengo,Vasco,19/5/2018,2,3,2,2,5,4,9,4,5
1541,6178,1541.0,16,Palmeiras,Bahia,19/5/2018,3,2,0,0,5,3,5,0,2
1542,6179,1542.0,16,Vitoria,Ceara,20/5/2018,4,0,0,0,4,4,4,0,0
1543,6180,1543.0,16,Sao Paulo,Santos,20/5/2018,4,2,1,0,6,5,7,1,2
1544,6181,1544.0,16,America-MG,Botafogo-RJ,20/5/2018,2,4,0,0,6,2,6,0,4
1545,6182,1545.0,16,Parana,Gremio,20/5/2018,2,1,0,0,3,2,3,0,1
1546,6183,1546.0,16,Sport,Corinthians,20/5/2018,2,3,0,0,5,2,5,0,3
1547,6184,1547.0,16,Fluminense,Athletico-PR,20/5/2018,1,2,0,0,3,1,3,0,2
1548,6185,1548.0,16,Internacional,Chapecoense,21/5/2018,1,2,0,0,3,1,3,0,2
1549,6186,1549.0,16,Fluminense,Chapecoense,26/5/2018,1,1,0,0,2,1,2,0,1
1550,6187,1550.0,16,Palmeiras,Sport,26/5/2018,3,3,0,1,6,3,7,1,4
1551,6188,1551.0,16,Atletico-MG,Flamengo,26/5/2018,1,4,0,0,5,1,5,0,4
1552,6189,1552.0,16,Parana,Athletico-PR,27/5/2018,3,1,0,0,4,3,4,0,1
1553,6190,1553.0,16,Internacional,Corinthians,27/5/2018,3,1,0,0,4,3,4,0,1
1554,6191,1554.0,16,Bahia,Vasco,27/5/2018,1,6,0,1,7,1,8,1,7
1555,6192,1555.0,16,Santos,Cruzeiro,27/5/2018,1,4,0,0,5,1,5,0,4
1556,6193,1556.0,16,Botafogo-RJ,Vitoria,27/5/2018,1,4,0,0,5,1,5,0,4
1557,6194,1557.0,16,Ceara,Gremio,27/5/2018,4,2,0,0,6,4,6,0,2
1558,6195,1558.0,16,America-MG,Sao Paulo,27/5/2018,4,3,0,0,7,4,7,0,3
1559,6196,1559.0,16,Vasco,Parana,30/5/2018,3,3,1,1,6,4,8,2,4
1560,6197,1560.0,16,Vitoria,Internacional,30/5/2018,3,2,0,0,5,3,5,0,2
1561,6198,1561.0,16,Sport,Atletico-MG,30/5/2018,4,2,0,0,6,4,6,0,2
1562,6199,1562.0,16,Chapecoense,Ceara,30/5/2018,2,3,0,0,5,2,5,0,3
1563,6200,1563.0,16,Sao Paulo,Botafogo-RJ,30/5/2018,2,3,0,0,5,2,5,0,3
1564,6201,1564.0,16,Gremio,Fluminense,30/5/2018,1,5,0,0,6,1,6,0,5
1565,6202,1565.0,16,Cruzeiro,Palmeiras,30/5/2018,3,6,0,0,9,3,9,0,6
1566,6203,1566.0,16,Flamengo,Bahia,31/5/2018,0,2,0,0,2,0,2,0,2
1567,6204,1567.0,16,Corinthians,America-MG,31/5/2018,2,3,0,2,5,2,7,2,5
1568,6205,1568.0,16,Athletico-PR,Santos,31/5/2018,1,1,0,0,2,1,2,0,1
1569,6206,1569.0,16,Internacional,Sport,2/6/2018,3,3,0,0,6,3,6,0,3
1570,6207,1570.0,16,Atletico-MG,Chapecoense,2/6/2018,2,4,0,1,6,2,7,1,5
1571,6208,1571.0,16,Vasco,Botafogo-RJ,2/6/2018,2,4,0,0,6,2,6,0,4
1572,6209,1572.0,16,Palmeiras,Sao Paulo,2/6/2018,4,4,0,0,8,4,8,0,4
1573,6210,1573.0,16,Flamengo,Corinthians,3/6/2018,3,1,0,0,4,3,4,0,1
1574,6211,1574.0,16,Bahia,Gremio,3/6/2018,2,5,0,0,7,2,7,0,5
1575,6212,1575.0,16,America-MG,Athletico-PR,3/6/2018,1,2,0,0,3,1,3,0,2
1576,6213,1576.0,16,Santos,Vitoria,3/6/2018,0,4,0,0,4,0,4,0,4
1577,6214,1577.0,16,Ceara,Cruzeiro,3/6/2018,2,4,0,0,6,2,6,0,4
1578,6215,1578.0,16,Parana,Fluminense,4/6/2018,6,3,0,0,9,6,9,0,3
1579,6216,1579.0,16,Sao Paulo,Internacional,5/6/2018,4,2,0,0,6,4,6,0,2
1580,6217,1580.0,16,Vitoria,Chapecoense,6/6/2018,3,2,0,0,5,3,5,0,2
1581,6218,1581.0,16,Botafogo-RJ,Ceara,6/6/2018,0,3,0,0,3,0,3,0,3
1582,6219,1582.0,16,Corinthians,Santos,6/6/2018,3,2,0,0,5,3,5,0,2
1583,6220,1583.0,16,Sport,Athletico-PR,6/6/2018,2,4,0,0,6,2,6,0,4
1584,6221,1584.0,16,Gremio,Palmeiras,6/6/2018,2,5,0,0,7,2,7,0,5
1585,6222,1585.0,16,Cruzeiro,Vasco,6/6/2018,1,1,0,0,2,1,2,0,1
1586,6223,1586.0,16,Parana,Bahia,7/6/2018,4,2,0,0,6,4,6,0,2
1587,6224,1587.0,16,Fluminense,Flamengo,7/6/2018,5,2,0,0,7,5,7,0,2
1588,6225,1588.0,16,America-MG,Atletico-MG,7/6/2018,2,2,0,0,4,2,4,0,2
1589,6226,1589.0,16,Athletico-PR,Sao Paulo,9/6/2018,3,3,0,0,6,3,6,0,3
1590,6227,1590.0,16,Chapecoense,Cruzeiro,9/6/2018,2,3,0,0,5,2,5,0,3
1591,6228,1591.0,16,Vasco,Sport,9/6/2018,4,3,0,0,7,4,7,0,3
1592,6229,1592.0,16,Corinthians,Vitoria,9/6/2018,2,2,0,0,4,2,4,0,2
1593,6230,1593.0,16,Atletico-MG,Fluminense,10/6/2018,2,2,0,0,4,2,4,0,2
1594,6231,1594.0,16,Bahia,Botafogo-RJ,10/6/2018,4,3,0,1,7,4,8,1,4
1595,6232,1595.0,16,Gremio,America-MG,10/6/2018,2,3,0,0,5,2,5,0,3
1596,6233,1596.0,16,Ceara,Palmeiras,10/6/2018,3,2,0,0,5,3,5,0,2
1597,6234,1597.0,16,Flamengo,Parana,10/6/2018,2,0,0,0,2,2,2,0,0
1598,6235,1598.0,16,Santos,Internacional,10/6/2018,3,4,1,0,7,4,8,1,4
1599,6236,1599.0,16,Sao Paulo,Vitoria,12/6/2018,4,3,1,1,7,5,9,2,4
1600,6237,1600.0,16,America-MG,Chapecoense,13/6/2018,5,0,0,0,5,5,5,0,0
1601,6238,1601.0,16,Fluminense,Santos,13/6/2018,2,3,0,0,5,2,5,0,3
1602,6239,1602.0,16,Sport,Gremio,13/6/2018,3,2,0,0,5,3,5,0,2
1603,6240,1603.0,16,Parana,Cruzeiro,13/6/2018,8,2,0,0,10,8,10,0,2
1604,6241,1604.0,16,Palmeiras,Flamengo,13/6/2018,4,6,3,3,10,7,16,6,9
1605,6242,1605.0,16,Botafogo-RJ,Athletico-PR,13/6/2018,0,2,0,0,2,0,2,0,2
1606,6243,1606.0,16,Bahia,Corinthians,13/6/2018,2,1,0,0,3,2,3,0,1
1607,6244,1607.0,16,Internacional,Vasco,13/6/2018,2,0,0,0,2,2,2,0,0
1608,6245,1608.0,16,Atletico-MG,Ceara,13/6/2018,1,0,0,0,1,1,1,0,0
1609,6247,1609.0,16,Vitoria,Parana,18/7/2018,2,2,0,0,4,2,4,0,2
1610,6248,1610.0,16,Corinthians,Botafogo-RJ,18/7/2018,2,3,0,0,5,2,5,0,3
1611,6249,1611.0,16,Gremio,Atletico-MG,18/7/2018,1,2,0,0,3,1,3,0,2
1612,6250,1612.0,16,Flamengo,Sao Paulo,18/7/2018,3,4,0,1,7,3,8,1,5
1613,6251,1613.0,16,Chapecoense,Bahia,19/7/2018,1,2,0,0,3,1,3,0,2
1614,6252,1614.0,16,Cruzeiro,America-MG,19/7/2018,3,1,0,0,4,3,4,0,1
1615,6253,1615.0,16,Vasco,Fluminense,19/7/2018,4,2,0,0,6,4,6,0,2
1616,6254,1616.0,16,Santos,Palmeiras,19/7/2018,4,6,0,0,10,4,10,0,6
1617,6255,1617.0,16,Athletico-PR,Internacional,19/7/2018,4,5,1,0,9,5,10,1,5
1618,6256,1618.0,16,Flamengo,Botafogo-RJ,21/7/2018,0,1,0,1,1,0,2,1,2
1619,6257,1619.0,16,Sao Paulo,Corinthians,21/7/2018,2,7,0,0,9,2,9,0,7
1620,6258,1620.0,16,Vasco,Gremio,22/7/2018,5,6,1,0,11,6,12,1,6
1621,6259,1621.0,16,Palmeiras,Atletico-MG,22/7/2018,2,2,0,1,4,2,5,1,3
1622,6260,1622.0,16,Parana,America-MG,22/7/2018,3,3,0,0,6,3,6,0,3
1623,6261,1623.0,16,Bahia,Vitoria,22/7/2018,3,5,0,1,8,3,9,1,6
1624,6262,1624.0,16,Sport,Fluminense,22/7/2018,1,5,0,0,6,1,6,0,5
1625,6263,1625.0,16,Cruzeiro,Athletico-PR,22/7/2018,1,3,0,1,4,1,5,1,4
1626,6264,1626.0,16,Chapecoense,Santos,22/7/2018,1,4,0,0,5,1,5,0,4
1627,6265,1627.0,16,Internacional,Ceara,23/7/2018,2,3,0,0,5,2,5,0,3
1628,6266,1628.0,16,Fluminense,Palmeiras,25/7/2018,2,2,0,1,4,2,5,1,3
1629,6267,1629.0,16,Atletico-MG,Parana,25/7/2018,1,1,1,0,2,2,3,1,1
1630,6268,1630.0,16,Corinthians,Cruzeiro,25/7/2018,0,2,0,0,2,0,2,0,2
1631,6269,1631.0,16,Santos,Flamengo,25/7/2018,1,1,0,0,2,1,2,0,1
1632,6270,1632.0,16,Botafogo-RJ,Chapecoense,26/7/2018,2,3,0,0,5,2,5,0,3
1633,6271,1633.0,16,Vitoria,Sport,26/7/2018,2,2,0,0,4,2,4,0,2
1634,6272,1634.0,16,Gremio,Sao Paulo,26/7/2018,4,5,0,0,9,4,9,0,5
1635,6273,1635.0,16,America-MG,Internacional,26/7/2018,2,2,1,1,4,3,6,2,3
1636,6274,1636.0,16,Ceara,Bahia,29/8/2018,3,4,0,0,7,3,7,0,4
1637,6275,1637.0,16,Athletico-PR,Vasco,29/8/2018,1,2,0,0,3,1,3,0,2
1638,6276,1638.0,16,Ceara,Fluminense,28/7/2018,5,1,0,0,6,5,6,0,1
1639,6277,1639.0,16,Palmeiras,Parana,29/7/2018,2,2,0,0,4,2,4,0,2
1640,6278,1640.0,16,Vasco,Corinthians,29/7/2018,4,0,0,0,4,4,4,0,0
1641,6279,1641.0,16,Flamengo,Sport,29/7/2018,1,1,0,0,2,1,2,0,1
1642,6280,1642.0,16,Athletico-PR,Vitoria,29/7/2018,3,5,0,0,8,3,8,0,5
1643,6281,1643.0,16,Internacional,Botafogo-RJ,29/7/2018,1,2,0,0,3,1,3,0,2
1644,6282,1644.0,16,Cruzeiro,Sao Paulo,29/7/2018,2,1,0,0,3,2,3,0,1
1645,6283,1645.0,16,Santos,America-MG,29/7/2018,2,2,0,0,4,2,4,0,2
1646,6284,1646.0,16,Chapecoense,Gremio,29/7/2018,1,3,0,0,4,1,4,0,3
1647,6285,1647.0,16,Bahia,Atletico-MG,30/7/2018,4,2,0,0,6,4,6,0,2
1648,6286,1648.0,16,Botafogo-RJ,Santos,4/8/2018,1,5,0,0,6,1,6,0,5
1649,6287,1649.0,16,Gremio,Flamengo,4/8/2018,3,4,0,0,7,3,7,0,4
1650,6288,1650.0,16,Corinthians,Athletico-PR,4/8/2018,2,2,0,0,4,2,4,0,2
1651,6289,1651.0,16,Vitoria,Cruzeiro,5/8/2018,3,5,0,0,8,3,8,0,5
1652,6290,1652.0,16,Parana,Ceara,5/8/2018,4,2,0,0,6,4,6,0,2
1653,6291,1653.0,16,America-MG,Palmeiras,5/8/2018,1,2,0,0,3,1,3,0,2
1654,6292,1654.0,16,Sao Paulo,Vasco,5/8/2018,2,2,0,0,4,2,4,0,2
1655,6293,1655.0,16,Fluminense,Bahia,5/8/2018,4,2,0,0,6,4,6,0,2
1656,6294,1656.0,16,Sport,Chapecoense,5/8/2018,1,1,0,0,2,1,2,0,1
1657,6295,1657.0,16,Atletico-MG,Internacional,6/8/2018,1,1,0,0,2,1,2,0,1
1658,6296,1658.0,16,Ceara,Santos,8/8/2018,3,2,0,0,5,3,5,0,2
1659,6297,1659.0,16,Bahia,Internacional,22/8/2018,1,2,0,0,3,1,3,0,2
1660,6298,1660.0,16,Parana,Sao Paulo,22/8/2018,3,1,0,0,4,3,4,0,1
1661,6299,1661.0,16,Palmeiras,Botafogo-RJ,22/8/2018,2,5,0,1,7,2,8,1,6
1662,6300,1662.0,16,Sport,America-MG,22/8/2018,2,2,0,0,4,2,4,0,2
1663,6301,1663.0,16,Fluminense,Corinthians,22/8/2018,1,2,0,1,3,1,4,1,3
1664,6302,1664.0,16,Gremio,Cruzeiro,22/8/2018,2,4,0,0,6,2,6,0,4
1665,6303,1665.0,16,Flamengo,Vitoria,23/8/2018,2,2,0,0,4,2,4,0,2
1666,6304,1666.0,16,Atletico-MG,Vasco,23/8/2018,2,4,0,0,6,2,6,0,4
1667,6305,1667.0,16,Chapecoense,Athletico-PR,13/9/2018,1,3,0,0,4,1,4,0,3
1668,6306,1668.0,16,Ceara,Athletico-PR,11/8/2018,3,3,0,0,6,3,6,0,3
1669,6307,1669.0,16,Bahia,America-MG,11/8/2018,1,4,0,0,5,1,5,0,4
1670,6308,1670.0,16,Parana,Botafogo-RJ,12/8/2018,3,4,1,1,7,4,9,2,5
1671,6309,1671.0,16,Atletico-MG,Santos,12/8/2018,2,0,0,0,2,2,2,0,0
1672,6310,1672.0,16,Sport,Sao Paulo,12/8/2018,1,3,0,0,4,1,4,0,3
1673,6311,1673.0,16,Flamengo,Cruzeiro,12/8/2018,3,3,0,0,6,3,6,0,3
1674,6312,1674.0,16,Chapecoense,Corinthians,12/8/2018,1,2,1,0,3,2,4,1,2
1675,6313,1675.0,16,Gremio,Vitoria,12/8/2018,1,3,0,0,4,1,4,0,3
1676,6314,1676.0,16,Palmeiras,Vasco,12/8/2018,1,2,0,0,3,1,3,0,2
1677,6315,1677.0,16,Fluminense,Internacional,13/8/2018,3,3,0,0,6,3,6,0,3
1678,6316,1678.0,16,Santos,Sport,18/8/2018,3,3,0,1,6,3,7,1,4
1679,6317,1679.0,16,Corinthians,Gremio,18/8/2018,1,1,0,0,2,1,2,0,1
1680,6318,1680.0,16,Athletico-PR,Flamengo,19/8/2018,3,1,0,0,4,3,4,0,1
1681,6319,1681.0,16,Internacional,Parana,19/8/2018,3,5,0,0,8,3,8,0,5
1682,6320,1682.0,16,Vitoria,Palmeiras,19/8/2018,2,1,0,0,3,2,3,0,1
1683,6321,1683.0,16,Botafogo-RJ,Atletico-MG,19/8/2018,2,4,0,0,6,2,6,0,4
1684,6322,1684.0,16,Cruzeiro,Bahia,19/8/2018,2,2,0,0,4,2,4,0,2
1685,6323,1685.0,16,America-MG,Fluminense,19/8/2018,2,0,1,0,2,3,3,1,0
1686,6324,1686.0,16,Sao Paulo,Chapecoense,19/8/2018,2,1,0,0,3,2,3,0,1
1687,6325,1687.0,16,Vasco,Ceara,20/8/2018,1,1,0,1,2,1,3,1,2
1688,6326,1688.0,16,Santos,Bahia,25/8/2018,1,2,0,0,3,1,3,0,2
1689,6327,1689.0,16,Corinthians,Parana,25/8/2018,3,4,0,1,7,3,8,1,5
1690,6328,1690.0,16,Athletico-PR,Gremio,25/8/2018,2,2,0,0,4,2,4,0,2
1691,6329,1691.0,16,Cruzeiro,Fluminense,25/8/2018,4,3,0,0,7,4,7,0,3
1692,6330,1692.0,16,Botafogo-RJ,Sport,25/8/2018,2,2,0,0,4,2,4,0,2
1693,6331,1693.0,16,Sao Paulo,Ceara,26/8/2018,3,6,0,1,9,3,10,1,7
1694,6332,1694.0,16,America-MG,Flamengo,26/8/2018,3,2,0,1,5,3,6,1,3
1695,6333,1695.0,16,Internacional,Palmeiras,26/8/2018,2,3,0,0,5,2,5,0,3
1696,6334,1696.0,16,Vitoria,Atletico-MG,26/8/2018,2,3,0,0,5,2,5,0,3
1697,6335,1697.0,16,Vasco,Chapecoense,26/8/2018,3,2,0,0,5,3,5,0,2
1698,6336,1698.0,16,Vitoria,America-MG,1/9/2018,5,1,0,1,6,5,7,1,2
1699,6337,1699.0,16,Gremio,Botafogo-RJ,1/9/2018,2,3,0,0,5,2,5,0,3
1700,6338,1700.0,16,Vasco,Santos,1/9/2018,1,1,0,0,2,1,2,0,1
1701,6339,1701.0,16,Corinthians,Atletico-MG,1/9/2018,1,3,0,0,4,1,4,0,3
1702,6340,1702.0,16,Flamengo,Ceara,2/9/2018,2,2,0,0,4,2,4,0,2
1703,6341,1703.0,16,Athletico-PR,Bahia,2/9/2018,2,2,0,0,4,2,4,0,2
1704,6342,1704.0,16,Sport,Parana,2/9/2018,3,2,0,0,5,3,5,0,2
1705,6343,1705.0,16,Sao Paulo,Fluminense,2/9/2018,2,2,1,0,4,3,5,1,2
1706,6344,1706.0,16,Cruzeiro,Internacional,2/9/2018,3,2,0,0,5,3,5,0,2
1707,6345,1707.0,16,Chapecoense,Palmeiras,2/9/2018,4,4,0,0,8,4,8,0,4
1708,6346,1708.0,16,Bahia,Sport,5/9/2018,1,1,0,0,2,1,2,0,1
1709,6347,1709.0,16,Botafogo-RJ,Cruzeiro,5/9/2018,3,3,0,0,6,3,6,0,3
1710,6348,1710.0,16,Ceara,Corinthians,5/9/2018,6,2,0,0,8,6,8,0,2
1711,6349,1711.0,16,Palmeiras,Athletico-PR,5/9/2018,2,3,0,0,5,2,5,0,3
1712,6350,1712.0,16,Parana,Chapecoense,5/9/2018,2,2,0,0,4,2,4,0,2
1713,6351,1713.0,16,Atletico-MG,Sao Paulo,5/9/2018,3,1,0,0,4,3,4,0,1
1714,6352,1714.0,16,Internacional,Flamengo,5/9/2018,4,1,0,0,5,4,5,0,1
1715,6353,1715.0,16,Santos,Gremio,6/9/2018,2,1,0,0,3,2,3,0,1
1716,6354,1716.0,16,Fluminense,Vitoria,6/9/2018,1,1,0,0,2,1,2,0,1
1717,6355,1717.0,16,America-MG,Vasco,6/9/2018,1,1,0,0,2,1,2,0,1
1718,6356,1718.0,16,Sport,Cruzeiro,8/9/2018,3,1,0,0,4,3,4,0,1
1719,6357,1719.0,16,Sao Paulo,Bahia,8/9/2018,3,2,0,0,5,3,5,0,2
1720,6358,1720.0,16,Flamengo,Chapecoense,8/9/2018,2,2,0,0,4,2,4,0,2
1721,6359,1721.0,16,America-MG,Ceara,9/9/2018,1,1,0,0,2,1,2,0,1
1722,6360,1722.0,16,Palmeiras,Corinthians,9/9/2018,2,3,0,0,5,2,5,0,3
1723,6361,1723.0,16,Fluminense,Botafogo-RJ,9/9/2018,3,4,0,0,7,3,7,0,4
1724,6362,1724.0,16,Internacional,Gremio,9/9/2018,5,5,0,0,10,5,10,0,5
1725,6363,1725.0,16,Parana,Santos,9/9/2018,4,3,0,0,7,4,7,0,3
1726,6364,1726.0,16,Vitoria,Vasco,9/9/2018,4,1,1,1,5,5,7,2,2
1727,6365,1727.0,16,Atletico-MG,Athletico-PR,10/9/2018,4,5,0,1,9,4,10,1,6
1728,6366,1728.0,16,Ceara,Vitoria,15/9/2018,2,4,0,0,6,2,6,0,4
1729,6367,1729.0,16,Gremio,Parana,15/9/2018,1,1,0,0,2,1,2,0,1
1730,6368,1730.0,16,Vasco,Flamengo,15/9/2018,3,2,0,1,5,3,6,1,3
1731,6369,1731.0,16,Botafogo-RJ,America-MG,16/9/2018,1,1,1,1,2,2,4,2,2
1732,6370,1732.0,16,Cruzeiro,Atletico-MG,16/9/2018,3,1,0,0,4,3,4,0,1
1733,6371,1733.0,16,Bahia,Palmeiras,16/9/2018,1,2,0,0,3,1,3,0,2
1734,6372,1734.0,16,Athletico-PR,Fluminense,16/9/2018,3,2,0,0,5,3,5,0,2
1735,6373,1735.0,16,Santos,Sao Paulo,16/9/2018,7,4,0,0,11,7,11,0,4
1736,6374,1736.0,16,Corinthians,Sport,16/9/2018,2,1,0,0,3,2,3,0,1
1737,6375,1737.0,16,Chapecoense,Internacional,17/9/2018,4,3,0,1,7,4,8,1,4
1738,6376,1738.0,16,Sao Paulo,America-MG,22/9/2018,1,1,0,0,2,1,2,0,1
1739,6377,1739.0,16,Gremio,Ceara,23/9/2018,3,1,0,0,4,3,4,0,1
1740,6378,1740.0,16,Athletico-PR,Parana,23/9/2018,0,4,0,0,4,0,4,0,4
1741,6379,1741.0,16,Flamengo,Atletico-MG,23/9/2018,2,2,0,0,4,2,4,0,2
1742,6380,1742.0,16,Corinthians,Internacional,23/9/2018,0,2,0,0,2,0,2,0,2
1743,6381,1743.0,16,Sport,Palmeiras,23/9/2018,2,2,0,0,4,2,4,0,2
1744,6382,1744.0,16,Vitoria,Botafogo-RJ,23/9/2018,1,4,0,0,5,1,5,0,4
1745,6383,1745.0,16,Cruzeiro,Santos,23/9/2018,2,2,0,0,4,2,4,0,2
1746,6384,1746.0,16,Chapecoense,Fluminense,24/9/2018,3,3,1,0,6,4,7,1,3
1747,6385,1747.0,16,Vasco,Bahia,24/9/2018,5,2,0,1,7,5,8,1,3
1748,6386,1748.0,16,Fluminense,Gremio,29/9/2018,1,2,0,0,3,1,3,0,2
1749,6387,1749.0,16,America-MG,Corinthians,29/9/2018,0,1,0,0,1,0,1,0,1
1750,6388,1750.0,16,Bahia,Flamengo,29/9/2018,2,1,0,0,3,2,3,0,1
1751,6389,1751.0,16,Palmeiras,Cruzeiro,30/9/2018,5,6,0,0,11,5,11,0,6
1752,6390,1752.0,16,Atletico-MG,Sport,30/9/2018,1,4,0,1,5,1,6,1,5
1753,6391,1753.0,16,Santos,Athletico-PR,30/9/2018,2,6,0,0,8,2,8,0,6
1754,6392,1754.0,16,Botafogo-RJ,Sao Paulo,30/9/2018,1,2,0,0,3,1,3,0,2
1755,6393,1755.0,16,Internacional,Vitoria,30/9/2018,3,6,0,1,9,3,10,1,7
1756,6394,1756.0,16,Ceara,Chapecoense,30/9/2018,4,5,0,0,9,4,9,0,5
1757,6395,1757.0,16,Parana,Vasco,1/10/2018,1,0,0,1,1,1,2,1,1
1758,6396,1758.0,16,Sport,Internacional,5/10/2018,4,1,0,0,5,4,5,0,1
1759,6397,1759.0,16,Corinthians,Flamengo,5/10/2018,2,1,0,0,3,2,3,0,1
1760,6398,1760.0,16,Vitoria,Santos,5/10/2018,3,2,1,0,5,4,6,1,2
1761,6399,1761.0,16,Athletico-PR,America-MG,6/10/2018,3,3,0,0,6,3,6,0,3
1762,6400,1762.0,16,Chapecoense,Atletico-MG,6/10/2018,3,3,0,0,6,3,6,0,3
1763,6401,1763.0,16,Sao Paulo,Palmeiras,6/10/2018,2,3,0,0,5,2,5,0,3
1764,6402,1764.0,16,Gremio,Bahia,6/10/2018,2,4,0,1,6,2,7,1,5
1765,6403,1765.0,16,Fluminense,Parana,8/10/2018,1,2,0,0,3,1,3,0,2
1766,6404,1766.0,16,Botafogo-RJ,Vasco,9/10/2018,3,2,0,0,5,3,5,0,2
1767,6405,1767.0,16,Cruzeiro,Ceara,24/10/2018,1,3,0,0,4,1,4,0,3
1768,6406,1768.0,16,Flamengo,Fluminense,13/10/2018,2,3,0,0,5,2,5,0,3
1769,6407,1769.0,16,Santos,Corinthians,13/10/2018,3,3,0,0,6,3,6,0,3
1770,6408,1770.0,16,Bahia,Parana,13/10/2018,3,3,0,0,6,3,6,0,3
1771,6409,1771.0,16,Chapecoense,Vitoria,14/10/2018,3,2,0,0,5,3,5,0,2
1772,6410,1772.0,16,Vasco,Cruzeiro,14/10/2018,6,2,0,1,8,6,9,1,3
1773,6411,1773.0,16,Internacional,Sao Paulo,14/10/2018,0,4,0,1,4,0,5,1,5
1774,6412,1774.0,16,Palmeiras,Gremio,14/10/2018,4,2,0,0,6,4,6,0,2
1775,6413,1775.0,16,Atletico-MG,America-MG,14/10/2018,1,0,0,0,1,1,1,0,0
1776,6414,1776.0,16,Athletico-PR,Sport,14/10/2018,0,3,0,0,3,0,3,0,3
1777,6415,1777.0,16,Ceara,Botafogo-RJ,15/10/2018,1,3,0,0,4,1,4,0,3
1778,6417,1778.0,16,Botafogo-RJ,Bahia,20/10/2018,2,1,0,0,3,2,3,0,1
1779,6418,1779.0,16,Sao Paulo,Athletico-PR,20/10/2018,3,2,0,0,5,3,5,0,2
1780,6419,1780.0,16,Sport,Vasco,20/10/2018,0,3,0,0,3,0,3,0,3
1781,6420,1781.0,16,Vitoria,Corinthians,21/10/2018,1,4,0,0,5,1,5,0,4
1782,6421,1782.0,16,Fluminense,Atletico-MG,21/10/2018,2,2,1,0,4,3,5,1,2
1783,6422,1783.0,16,Palmeiras,Ceara,21/10/2018,5,2,1,0,7,6,8,1,2
1784,6423,1784.0,16,Cruzeiro,Chapecoense,21/10/2018,2,1,0,0,3,2,3,0,1
1785,6424,1785.0,16,Parana,Flamengo,21/10/2018,1,0,1,0,1,2,2,1,0
1786,6425,1786.0,16,Internacional,Santos,22/10/2018,1,3,0,0,4,1,4,0,3
1787,6426,1787.0,16,Vitoria,Sao Paulo,26/10/2018,1,2,0,1,3,1,4,1,3
1788,6427,1788.0,16,Vasco,Internacional,26/10/2018,3,5,0,1,8,3,9,1,6
1789,6428,1789.0,16,Santos,Fluminense,27/10/2018,2,3,0,0,5,2,5,0,3
1790,6429,1790.0,16,Gremio,Sport,27/10/2018,2,2,0,0,4,2,4,0,2
1791,6430,1791.0,16,Corinthians,Bahia,27/10/2018,3,3,0,0,6,3,6,0,3
1792,6431,1792.0,16,Chapecoense,America-MG,27/10/2018,3,4,0,0,7,3,7,0,4
1793,6432,1793.0,16,Flamengo,Palmeiras,27/10/2018,2,5,0,0,7,2,7,0,5
1794,6433,1794.0,16,Cruzeiro,Parana,27/10/2018,0,2,0,0,2,0,2,0,2
1795,6434,1795.0,16,Athletico-PR,Botafogo-RJ,27/10/2018,2,5,0,0,7,2,7,0,5
1796,6435,1796.0,16,Ceara,Atletico-MG,29/10/2018,2,4,0,0,6,2,6,0,4
1797,6436,1797.0,16,Fluminense,Vasco,3/11/2018,2,3,1,0,5,3,6,1,3
1798,6437,1798.0,16,Atletico-MG,Gremio,3/11/2018,4,1,0,0,5,4,5,0,1
1799,6438,1799.0,16,Palmeiras,Santos,3/11/2018,3,5,0,1,8,3,9,1,6
1800,6439,1800.0,16,America-MG,Cruzeiro,4/11/2018,3,1,0,0,4,3,4,0,1
1801,6440,1801.0,16,Parana,Vitoria,4/11/2018,3,4,0,1,7,3,8,1,5
1802,6441,1802.0,16,Sao Paulo,Flamengo,4/11/2018,2,1,0,0,3,2,3,0,1
1803,6442,1803.0,16,Botafogo-RJ,Corinthians,4/11/2018,1,2,0,0,3,1,3,0,2
1804,6443,1804.0,16,Internacional,Athletico-PR,4/11/2018,2,3,0,0,5,2,5,0,3
1805,6444,1805.0,16,Bahia,Chapecoense,4/11/2018,1,1,0,0,2,1,2,0,1
1806,6445,1806.0,16,Sport,Ceara,5/11/2018,3,3,0,0,6,3,6,0,3
1807,6446,1807.0,16,America-MG,Parana,10/11/2018,3,1,1,1,4,4,6,2,2
1808,6447,1808.0,16,Corinthians,Sao Paulo,10/11/2018,1,3,1,0,4,2,5,1,3
1809,6448,1809.0,16,Botafogo-RJ,Flamengo,10/11/2018,4,6,0,0,10,4,10,0,6
1810,6449,1810.0,16,Athletico-PR,Cruzeiro,10/11/2018,4,7,0,0,11,4,11,0,7
1811,6450,1811.0,16,Vitoria,Bahia,11/11/2018,3,4,0,0,7,3,7,0,4
1812,6451,1812.0,16,Ceara,Internacional,11/11/2018,2,5,0,0,7,2,7,0,5
1813,6452,1813.0,16,Atletico-MG,Palmeiras,11/11/2018,3,2,0,0,5,3,5,0,2
1814,6453,1814.0,16,Gremio,Vasco,11/11/2018,2,4,0,0,6,2,6,0,4
1815,6454,1815.0,16,Fluminense,Sport,11/11/2018,0,2,0,0,2,0,2,0,2
1816,6455,1816.0,16,Santos,Chapecoense,12/11/2018,2,1,0,0,3,2,3,0,1
1817,6456,1817.0,16,Vasco,Athletico-PR,14/11/2018,1,0,0,0,1,1,1,0,0
1818,6457,1818.0,16,Bahia,Ceara,14/11/2018,2,3,0,0,5,2,5,0,3
1819,6458,1819.0,16,Parana,Atletico-MG,14/11/2018,4,3,2,0,7,6,9,2,3
1820,6459,1820.0,16,Sport,Vitoria,14/11/2018,4,4,0,0,8,4,8,0,4
1821,6460,1821.0,16,Palmeiras,Fluminense,14/11/2018,6,5,0,1,11,6,12,1,6
1822,6461,1822.0,16,Cruzeiro,Corinthians,14/11/2018,2,2,0,1,4,2,5,1,3
1823,6462,1823.0,16,Chapecoense,Botafogo-RJ,15/11/2018,1,2,0,0,3,1,3,0,2
1824,6463,1824.0,16,Flamengo,Santos,15/11/2018,3,5,0,0,8,3,8,0,5
1825,6464,1825.0,16,Sao Paulo,Gremio,15/11/2018,1,2,0,0,3,1,3,0,2
1826,6465,1826.0,16,Internacional,America-MG,15/11/2018,1,2,0,0,3,1,3,0,2
1827,6466,1827.0,16,Corinthians,Vasco,17/11/2018,2,2,0,0,4,2,4,0,2
1828,6467,1828.0,16,Vitoria,Athletico-PR,17/11/2018,3,3,1,0,6,4,7,1,3
1829,6468,1829.0,16,Atletico-MG,Bahia,17/11/2018,3,3,1,0,6,4,7,1,3
1830,6469,1830.0,16,Parana,Palmeiras,18/11/2018,4,2,0,0,6,4,6,0,2
1831,6470,1831.0,16,America-MG,Santos,18/11/2018,6,1,0,0,7,6,7,0,1
1832,6471,1832.0,16,Sport,Flamengo,18/11/2018,1,1,0,1,2,1,3,1,2
1833,6472,1833.0,16,Botafogo-RJ,Internacional,18/11/2018,2,4,0,2,6,2,8,2,6
1834,6473,1834.0,16,Sao Paulo,Cruzeiro,18/11/2018,2,2,0,0,4,2,4,0,2
1835,6474,1835.0,16,Gremio,Chapecoense,18/11/2018,2,2,0,0,4,2,4,0,2
1836,6475,1836.0,16,Fluminense,Ceara,19/11/2018,4,3,0,0,7,4,7,0,3
1837,6476,1837.0,16,Internacional,Atletico-MG,21/11/2018,1,2,0,0,3,1,3,0,2
1838,6477,1838.0,16,Santos,Botafogo-RJ,21/11/2018,2,2,0,0,4,2,4,0,2
1839,6478,1839.0,16,Athletico-PR,Corinthians,21/11/2018,2,4,0,0,6,2,6,0,4
1840,6479,1840.0,16,Palmeiras,America-MG,21/11/2018,0,6,0,0,6,0,6,0,6
1841,6480,1841.0,16,Flamengo,Gremio,21/11/2018,2,3,0,0,5,2,5,0,3
1842,6481,1842.0,16,Cruzeiro,Vitoria,21/11/2018,2,1,0,0,3,2,3,0,1
1843,6482,1843.0,16,Vasco,Sao Paulo,22/11/2018,2,4,0,0,6,2,6,0,4
1844,6483,1844.0,16,Ceara,Parana,22/11/2018,2,1,0,0,3,2,3,0,1
1845,6484,1845.0,16,Bahia,Fluminense,22/11/2018,2,1,0,0,3,2,3,0,1
1846,6485,1846.0,16,Chapecoense,Sport,22/11/2018,2,1,0,0,3,2,3,0,1
1847,6486,1847.0,16,Santos,Atletico-MG,24/11/2018,4,1,1,0,5,5,6,1,1
1848,6487,1848.0,16,Athletico-PR,Ceara,25/11/2018,3,4,0,0,7,3,7,0,4
1849,6488,1849.0,16,Cruzeiro,Flamengo,25/11/2018,6,3,0,0,9,6,9,0,3
1850,6489,1850.0,16,Vitoria,Gremio,25/11/2018,2,4,0,0,6,2,6,0,4
1851,6490,1851.0,16,Vasco,Palmeiras,25/11/2018,4,5,1,0,9,5,10,1,5
1852,6491,1852.0,16,Internacional,Fluminense,25/11/2018,3,2,0,1,5,3,6,1,3
1853,6492,1853.0,16,America-MG,Bahia,25/11/2018,2,2,0,1,4,2,5,1,3
1854,6493,1854.0,16,Corinthians,Chapecoense,25/11/2018,2,1,0,0,3,2,3,0,1
1855,6494,1855.0,16,Botafogo-RJ,Parana,26/11/2018,1,3,0,0,4,1,4,0,3
1856,6495,1856.0,16,Sao Paulo,Sport,26/11/2018,2,3,0,1,5,2,6,1,4
1857,6496,1857.0,16,Flamengo,Athletico-PR,1/12/2018,4,1,1,1,5,5,7,2,2
1858,6497,1858.0,16,Atletico-MG,Botafogo-RJ,1/12/2018,4,3,0,0,7,4,7,0,3
1859,6498,1859.0,16,Ceara,Vasco,2/12/2018,3,2,1,0,5,4,6,1,2
1860,6499,1860.0,16,Gremio,Corinthians,2/12/2018,2,4,0,0,6,2,6,0,4
1861,6500,1861.0,16,Bahia,Cruzeiro,2/12/2018,4,1,0,0,5,4,5,0,1
1862,6501,1862.0,16,Sport,Santos,2/12/2018,3,1,0,0,4,3,4,0,1
1863,6502,1863.0,16,Parana,Internacional,2/12/2018,1,2,1,0,3,2,4,1,2
1864,6503,1864.0,16,Fluminense,America-MG,2/12/2018,5,2,0,0,7,5,7,0,2
1865,6504,1865.0,16,Chapecoense,Sao Paulo,2/12/2018,0,3,0,0,3,0,3,0,3
1866,6505,1866.0,16,Palmeiras,Vitoria,2/12/2018,2,2,0,0,4,2,4,0,2
1867,6506,1867.0,17,Sao Paulo,Botafogo-RJ,27/4/2019,0,4,0,0,4,0,4,0,4
1868,6507,1868.0,17,Atletico-MG,Avai,27/4/2019,0,1,0,0,1,0,1,0,1
1869,6508,1869.0,17,Chapecoense,Internacional,27/4/2019,1,1,0,0,2,1,2,0,1
1870,6509,1870.0,17,Flamengo,Cruzeiro,27/4/2019,4,5,0,1,9,4,10,1,6
1871,6510,1871.0,17,Gremio,Santos,28/4/2019,3,4,0,1,7,3,8,1,5
1872,6511,1872.0,17,Bahia,Corinthians,28/4/2019,1,4,0,0,5,1,5,0,4
1873,6512,1873.0,17,Athletico-PR,Vasco,28/4/2019,1,1,0,0,2,1,2,0,1
1874,6513,1874.0,17,Ceara,CSA,28/4/2019,0,0,0,1,0,0,1,1,1
1875,6514,1875.0,17,Palmeiras,Fortaleza,28/4/2019,1,2,0,0,3,1,3,0,2
1876,6515,1876.0,17,Fluminense,Goias,28/4/2019,4,1,0,0,5,4,5,0,1
1877,6516,1877.0,17,Internacional,Flamengo,1/5/2019,3,2,0,0,5,3,5,0,2
1878,6518,1878.0,17,Corinthians,Chapecoense,1/5/2019,2,1,0,0,3,2,3,0,1
1879,6519,1879.0,17,Cruzeiro,Ceara,1/5/2019,1,0,0,0,1,1,1,0,0
1880,6520,1880.0,17,Avai,Gremio,1/5/2019,4,3,0,0,7,4,7,0,3
1881,6521,1881.0,17,Goias,Sao Paulo,1/5/2019,3,2,0,1,5,3,6,1,3
1882,6523,1882.0,17,Fortaleza,Athletico-PR,1/5/2019,3,3,0,0,6,3,6,0,3
1883,6524,1883.0,17,Santos,Fluminense,2/5/2019,3,2,0,0,5,3,5,0,2
1884,6525,1884.0,17,Botafogo-RJ,Bahia,2/5/2019,3,0,0,0,3,3,3,0,0
1885,6526,1885.0,17,Vasco,Corinthians,4/5/2019,2,1,0,0,3,2,3,0,1
1886,6527,1886.0,17,Palmeiras,Internacional,4/5/2019,2,5,0,0,7,2,7,0,5
1887,6528,1887.0,17,Ceara,Atletico-MG,4/5/2019,0,1,0,0,1,0,1,0,1
1888,6529,1888.0,17,Chapecoense,Athletico-PR,5/5/2019,1,3,0,0,4,1,4,0,3
1889,6530,1889.0,17,Sao Paulo,Flamengo,5/5/2019,1,7,0,0,8,1,8,0,7
1890,6531,1890.0,17,Botafogo-RJ,Fortaleza,5/5/2019,0,2,0,0,2,0,2,0,2
1891,6532,1891.0,17,CSA,Santos,5/5/2019,1,4,0,0,5,1,5,0,4
1892,6533,1892.0,17,Cruzeiro,Goias,5/5/2019,1,2,0,1,3,1,4,1,3
1893,6534,1893.0,17,Gremio,Fluminense,5/5/2019,2,1,0,0,3,2,3,0,1
1894,6535,1894.0,17,Bahia,Avai,5/5/2019,1,2,0,0,3,1,3,0,2
1895,6536,1895.0,17,Fluminense,Botafogo-RJ,11/5/2019,3,5,0,0,8,3,8,0,5
1896,6537,1896.0,17,Corinthians,Gremio,11/5/2019,2,4,0,0,6,2,6,0,4
1897,6538,1897.0,17,Goias,Ceara,11/5/2019,2,2,0,0,4,2,4,0,2
1898,6539,1898.0,17,Flamengo,Chapecoense,12/5/2019,2,3,0,0,5,2,5,0,3
1899,6540,1899.0,17,Santos,Vasco,12/5/2019,2,4,0,1,6,2,7,1,5
1900,6541,1900.0,17,Atletico-MG,Palmeiras,12/5/2019,1,3,0,0,4,1,4,0,3
1901,6542,1901.0,17,Internacional,Cruzeiro,12/5/2019,0,0,0,1,0,0,1,1,1
1902,6543,1902.0,17,Avai,CSA,12/5/2019,1,2,0,0,3,1,3,0,2
1903,6544,1903.0,17,Athletico-PR,Bahia,12/5/2019,2,3,0,0,5,2,5,0,3
1904,6545,1904.0,17,Fortaleza,Sao Paulo,12/5/2019,2,2,0,0,4,2,4,0,2
1905,6546,1905.0,17,Fluminense,Cruzeiro,18/5/2019,3,2,0,0,5,3,5,0,2
1906,6547,1906.0,17,Palmeiras,Santos,18/5/2019,2,4,0,0,6,2,6,0,4
1907,6548,1907.0,17,Atletico-MG,Flamengo,18/5/2019,3,1,1,0,4,4,5,1,1
1908,6549,1908.0,17,Sao Paulo,Bahia,19/5/2019,1,3,1,0,4,2,5,1,3
1909,6550,1909.0,17,Internacional,CSA,19/5/2019,2,3,0,0,5,2,5,0,3
1910,6551,1910.0,17,Athletico-PR,Corinthians,19/5/2019,1,4,0,0,5,1,5,0,4
1911,6552,1911.0,17,Goias,Botafogo-RJ,19/5/2019,1,3,0,0,4,1,4,0,3
1912,6553,1912.0,17,Chapecoense,Fortaleza,19/5/2019,1,1,0,0,2,1,2,0,1
1913,6554,1913.0,17,Vasco,Avai,19/5/2019,1,2,0,0,3,1,3,0,2
1914,6555,1914.0,17,Ceara,Gremio,19/5/2019,3,6,0,0,9,3,9,0,6
1915,6556,1915.0,17,Botafogo-RJ,Palmeiras,25/5/2019,10,0,0,0,10,10,10,0,0
1916,6557,1916.0,17,Gremio,Atletico-MG,25/5/2019,1,4,0,0,5,1,5,0,4
1917,6558,1917.0,17,Flamengo,Athletico-PR,26/5/2019,4,3,0,0,7,4,7,0,3
1918,6559,1918.0,17,Santos,Internacional,26/5/2019,5,5,0,0,10,5,10,0,5
1919,6560,1919.0,17,Fortaleza,Vasco,26/5/2019,1,2,0,0,3,1,3,0,2
1920,6561,1920.0,17,Cruzeiro,Chapecoense,26/5/2019,1,3,0,0,4,1,4,0,3
1921,6562,1921.0,17,Bahia,Fluminense,26/5/2019,2,3,0,1,5,2,6,1,4
1922,6563,1922.0,17,Corinthians,Sao Paulo,26/5/2019,3,4,0,0,7,3,7,0,4
1923,6564,1923.0,17,CSA,Goias,27/5/2019,3,1,0,0,4,3,4,0,1
1924,6565,1924.0,17,Avai,Ceara,27/5/2019,4,3,0,0,7,4,7,0,3
1925,6566,1925.0,17,Flamengo,Fortaleza,1/6/2019,1,0,0,0,1,1,1,0,0
1926,6567,1926.0,17,Bahia,Gremio,1/6/2019,1,2,0,0,3,1,3,0,2
1927,6568,1927.0,17,Botafogo-RJ,Vasco,2/6/2019,2,3,0,0,5,2,5,0,3
1928,6569,1928.0,17,Ceara,Santos,2/6/2019,2,1,0,0,3,2,3,0,1
1929,6570,1929.0,17,Athletico-PR,Fluminense,2/6/2019,1,3,0,1,4,1,5,1,4
1930,6571,1930.0,17,Sao Paulo,Cruzeiro,2/6/2019,2,3,1,0,5,3,6,1,3
1931,6572,1931.0,17,Atletico-MG,CSA,2/6/2019,0,3,0,0,3,0,3,0,3
1932,6573,1932.0,17,Chapecoense,Palmeiras,2/6/2019,2,5,0,0,7,2,7,0,5
1933,6575,1933.0,17,Corinthians,Goias,7/8/2019,1,2,0,1,3,1,4,1,3
1934,6576,1934.0,17,Vasco,Internacional,7/6/2019,0,2,0,0,2,0,2,0,2
1935,6577,1935.0,17,Palmeiras,Athletico-PR,8/6/2019,2,4,0,0,6,2,6,0,4
1936,6578,1936.0,17,Gremio,Fortaleza,8/6/2019,1,4,0,1,5,1,6,1,5
1937,6579,1937.0,17,Cruzeiro,Corinthians,8/6/2019,1,1,0,0,2,1,2,0,1
1938,6580,1938.0,17,Ceara,Bahia,8/6/2019,2,2,0,0,4,2,4,0,2
1939,6581,1939.0,17,Avai,Sao Paulo,8/6/2019,5,2,0,0,7,5,7,0,2
1940,6582,1940.0,17,CSA,Botafogo-RJ,9/6/2019,2,1,0,0,3,2,3,0,1
1941,6583,1941.0,17,Fluminense,Flamengo,9/6/2019,2,3,0,0,5,2,5,0,3
1942,6584,1942.0,17,Santos,Atletico-MG,9/6/2019,1,2,0,0,3,1,3,0,2
1943,6585,1943.0,17,Goias,Chapecoense,10/6/2019,2,0,0,1,2,2,3,1,1
1944,6586,1944.0,17,Botafogo-RJ,Gremio,12/6/2019,1,2,0,0,3,1,3,0,2
1945,6587,1945.0,17,Fortaleza,Cruzeiro,12/6/2019,1,6,1,0,7,2,8,1,6
1946,6588,1946.0,17,Internacional,Bahia,12/6/2019,1,1,0,0,2,1,2,0,1
1947,6589,1947.0,17,CSA,Flamengo,12/6/2019,3,1,0,0,4,3,4,0,1
1948,6590,1948.0,17,Santos,Corinthians,12/6/2019,4,4,0,0,8,4,8,0,4
1949,6591,1949.0,17,Vasco,Ceara,13/6/2019,0,2,0,0,2,0,2,0,2
1950,6592,1950.0,17,Chapecoense,Fluminense,13/6/2019,2,6,0,1,8,2,9,1,7
1951,6593,1951.0,17,Palmeiras,Avai,13/6/2019,1,1,0,0,2,1,2,0,1
1952,6594,1952.0,17,Atletico-MG,Sao Paulo,13/6/2019,2,4,0,0,6,2,6,0,4
1953,6595,1953.0,17,Goias,Athletico-PR,13/6/2019,1,3,0,0,4,1,4,0,3
1954,6596,1954.0,17,Gremio,Vasco,13/7/2019,2,4,0,0,6,2,6,0,4
1955,6597,1955.0,17,Fortaleza,Avai,13/7/2019,2,2,0,0,4,2,4,0,2
1956,6598,1956.0,17,Bahia,Santos,13/7/2019,2,3,0,0,5,2,5,0,3
1957,6599,1957.0,17,Sao Paulo,Palmeiras,13/7/2019,3,3,0,0,6,3,6,0,3
1958,6600,1958.0,17,Flamengo,Goias,14/7/2019,1,2,0,0,3,1,3,0,2
1959,6601,1959.0,17,Corinthians,CSA,14/7/2019,2,6,0,0,8,2,8,0,6
1960,6602,1960.0,17,Athletico-PR,Internacional,14/7/2019,3,3,0,0,6,3,6,0,3
1961,6604,1961.0,17,Chapecoense,Atletico-MG,14/7/2019,3,5,0,0,8,3,8,0,5
1962,6605,1962.0,17,Fluminense,Ceara,15/7/2019,2,2,0,0,4,2,4,0,2
1963,6606,1963.0,17,Vasco,Fluminense,20/7/2019,4,3,0,2,7,4,9,2,5
1964,6607,1964.0,17,Bahia,Cruzeiro,20/7/2019,2,1,1,0,3,3,4,1,1
1965,6608,1965.0,17,Ceara,Palmeiras,20/7/2019,3,2,0,0,5,3,5,0,2
1966,6609,1966.0,17,CSA,Athletico-PR,20/7/2019,2,1,0,0,3,2,3,0,1
1967,6610,1967.0,17,Internacional,Gremio,20/7/2019,3,2,0,0,5,3,5,0,2
1968,6611,1968.0,17,Botafogo-RJ,Santos,21/7/2019,2,3,1,1,5,3,7,2,4
1969,6612,1969.0,17,Atletico-MG,Fortaleza,21/7/2019,1,4,0,0,5,1,5,0,4
1970,6613,1970.0,17,Corinthians,Flamengo,21/7/2019,1,4,0,1,5,1,6,1,5
1971,6614,1971.0,17,Avai,Goias,21/7/2019,4,2,0,0,6,4,6,0,2
1972,6615,1972.0,17,Sao Paulo,Chapecoense,22/7/2019,1,3,0,0,4,1,4,0,3
1973,6616,1973.0,17,Palmeiras,Vasco,27/7/2019,1,4,0,0,5,1,5,0,4
1974,6617,1974.0,17,Cruzeiro,Athletico-PR,27/7/2019,1,0,0,0,1,1,1,0,0
1975,6618,1975.0,17,Fluminense,Sao Paulo,27/7/2019,1,3,0,0,4,1,4,0,3
1976,6619,1976.0,17,Internacional,Ceara,27/7/2019,3,3,0,0,6,3,6,0,3
1977,6620,1977.0,17,Chapecoense,Bahia,28/7/2019,1,1,0,0,2,1,2,0,1
1978,6621,1978.0,17,Flamengo,Botafogo-RJ,28/7/2019,5,2,0,0,7,5,7,0,2
1979,6622,1979.0,17,Santos,Avai,28/7/2019,2,2,0,0,4,2,4,0,2
1980,6623,1980.0,17,Goias,Atletico-MG,28/7/2019,1,0,0,0,1,1,1,0,0
1981,6624,1981.0,17,Fortaleza,Corinthians,28/7/2019,2,1,0,0,3,2,3,0,1
1982,6625,1982.0,17,CSA,Gremio,29/7/2019,4,2,0,0,6,4,6,0,2
1983,6626,1983.0,17,Ceara,Fortaleza,3/8/2019,3,1,0,1,4,3,5,1,2
1984,6627,1984.0,17,Fluminense,Internacional,3/8/2019,1,2,0,0,3,1,3,0,2
1985,6628,1985.0,17,Santos,Goias,4/8/2019,3,4,0,0,7,3,7,0,4
1986,6629,1986.0,17,Avai,Botafogo-RJ,4/8/2019,2,1,1,0,3,3,4,1,1
1987,6630,1987.0,17,Bahia,Flamengo,4/8/2019,1,1,1,0,2,2,3,1,1
1988,6631,1988.0,17,Corinthians,Palmeiras,4/8/2019,1,3,0,0,4,1,4,0,3
1989,6632,1989.0,17,Vasco,CSA,4/8/2019,4,1,0,0,5,4,5,0,1
1990,6633,1990.0,17,Atletico-MG,Cruzeiro,4/8/2019,2,3,0,0,5,2,5,0,3
1991,6634,1991.0,17,Gremio,Chapecoense,5/8/2019,4,3,0,0,7,4,7,0,3
1992,6635,1992.0,17,Athletico-PR,Sao Paulo,21/8/2019,3,3,0,0,6,3,6,0,3
1993,6636,1993.0,17,Ceara,Chapecoense,10/8/2019,3,2,0,0,5,3,5,0,2
1994,6637,1994.0,17,Sao Paulo,Santos,10/8/2019,6,1,0,0,7,6,7,0,1
1995,6638,1995.0,17,Flamengo,Gremio,10/8/2019,4,2,0,0,6,4,6,0,2
1996,6639,1996.0,17,Atletico-MG,Fluminense,10/8/2019,4,3,0,1,7,4,8,1,4
1997,6640,1997.0,17,Internacional,Corinthians,11/8/2019,3,2,0,0,5,3,5,0,2
1998,6641,1998.0,17,Palmeiras,Bahia,11/8/2019,6,4,1,1,10,7,12,2,5
1999,6642,1999.0,17,Avai,Cruzeiro,11/8/2019,4,2,1,1,6,5,8,2,3
2000,6643,2000.0,17,Botafogo-RJ,Athletico-PR,11/8/2019,3,1,0,0,4,3,4,0,1
2001,6644,2001.0,17,Goias,Vasco,11/8/2019,4,4,0,1,8,4,9,1,5
2002,6645,2002.0,17,CSA,Fortaleza,12/8/2019,3,1,0,0,4,3,4,0,1
2003,6646,2003.0,17,Corinthians,Botafogo-RJ,17/8/2019,2,3,0,0,5,2,5,0,3
2004,6647,2004.0,17,Fortaleza,Internacional,17/8/2019,2,2,1,0,4,3,5,1,2
2005,6648,2005.0,17,Vasco,Flamengo,17/8/2019,0,3,0,0,3,0,3,0,3
2006,6649,2006.0,17,Athletico-PR,Atletico-MG,17/8/2019,3,1,0,0,4,3,4,0,1
2007,6651,2007.0,17,Fluminense,CSA,18/8/2019,1,2,0,0,3,1,3,0,2
2008,6652,2008.0,17,Sao Paulo,Ceara,18/8/2019,3,2,0,0,5,3,5,0,2
2009,6653,2009.0,17,Bahia,Goias,18/8/2019,2,3,1,0,5,3,6,1,3
2010,6654,2010.0,17,Cruzeiro,Santos,18/8/2019,2,0,0,1,2,2,3,1,1
2011,6655,2011.0,17,Chapecoense,Avai,18/8/2019,1,0,0,0,1,1,1,0,0
2012,6656,2012.0,17,Atletico-MG,Bahia,24/8/2019,0,2,0,0,2,0,2,0,2
2013,6657,2013.0,17,Gremio,Athletico-PR,24/8/2019,3,1,0,0,4,3,4,0,1
2014,6658,2014.0,17,Goias,Internacional,25/8/2019,2,2,1,0,4,3,5,1,2
2015,6659,2015.0,17,Vasco,Sao Paulo,25/8/2019,4,3,0,1,7,4,8,1,4
2016,6660,2016.0,17,Santos,Fortaleza,25/8/2019,3,3,0,0,6,3,6,0,3
2017,6661,2017.0,17,Ceara,Flamengo,25/8/2019,3,0,0,0,3,3,3,0,0
2018,6662,2018.0,17,Avai,Corinthians,25/8/2019,0,1,1,1,1,1,3,2,2
2019,6663,2019.0,17,CSA,Cruzeiro,25/8/2019,3,3,0,0,6,3,6,0,3
2020,6664,2020.0,17,Botafogo-RJ,Chapecoense,26/8/2019,2,1,0,0,3,2,3,0,1
2021,6665,2021.0,17,Palmeiras,Fluminense,10/9/2019,0,2,0,0,2,0,2,0,2
2022,6666,2022.0,17,Sao Paulo,Gremio,31/8/2019,1,1,1,0,2,2,3,1,1
2023,6667,2023.0,17,Bahia,CSA,31/8/2019,1,1,0,0,2,1,2,0,1
2024,6668,2024.0,17,Chapecoense,Santos,31/8/2019,2,4,0,0,6,2,6,0,4
2025,6669,2025.0,17,Athletico-PR,Ceara,31/8/2019,1,3,0,0,4,1,4,0,3
2026,6670,2026.0,17,Internacional,Botafogo-RJ,31/8/2019,4,4,0,0,8,4,8,0,4
2027,6671,2027.0,17,Flamengo,Palmeiras,1/9/2019,2,2,0,1,4,2,5,1,3
2028,6672,2028.0,17,Fortaleza,Goias,1/9/2019,3,2,0,1,5,3,6,1,3
2029,6673,2029.0,17,Cruzeiro,Vasco,1/9/2019,3,4,0,0,7,3,7,0,4
2030,6674,2030.0,17,Corinthians,Atletico-MG,1/9/2019,0,1,0,0,1,0,1,0,1
2031,6675,2031.0,17,Fluminense,Avai,2/9/2019,3,1,0,0,4,3,4,0,1
2032,6676,2032.0,17,Vasco,Bahia,7/9/2019,3,1,0,0,4,3,4,0,1
2033,6677,2033.0,17,Corinthians,Ceara,7/9/2019,1,1,0,0,2,1,2,0,1
2034,6678,2034.0,17,Avai,Flamengo,7/9/2019,1,2,1,0,3,2,4,1,2
2035,6679,2035.0,17,Fortaleza,Fluminense,7/9/2019,1,2,0,0,3,1,3,0,2
2036,6680,2036.0,17,Internacional,Sao Paulo,7/9/2019,1,5,0,0,6,1,6,0,5
2037,6681,2037.0,17,Goias,Palmeiras,7/9/2019,5,1,0,1,6,5,7,1,2
2038,6682,2038.0,17,Cruzeiro,Gremio,8/9/2019,2,1,0,0,3,2,3,0,1
2039,6683,2039.0,17,Santos,Athletico-PR,8/9/2019,3,6,0,0,9,3,9,0,6
2040,6684,2040.0,17,Botafogo-RJ,Atletico-MG,8/9/2019,4,3,0,1,7,4,8,1,4
2041,6685,2041.0,17,CSA,Chapecoense,8/9/2019,3,2,0,2,5,3,7,2,4
2042,6686,2042.0,17,Flamengo,Santos,14/9/2019,2,5,0,0,7,2,7,0,5
2043,6687,2043.0,17,Chapecoense,Vasco,14/9/2019,2,5,0,0,7,2,7,0,5
2044,6688,2044.0,17,Palmeiras,Cruzeiro,14/9/2019,2,3,0,0,5,2,5,0,3
2045,6689,2045.0,17,Ceara,Botafogo-RJ,14/9/2019,1,1,0,0,2,1,2,0,1
2046,6690,2046.0,17,Athletico-PR,Avai,15/9/2019,1,0,0,0,1,1,1,0,0
2047,6691,2047.0,17,Atletico-MG,Internacional,15/9/2019,0,1,0,0,1,0,1,0,1
2048,6692,2048.0,17,Bahia,Fortaleza,15/9/2019,1,1,0,0,2,1,2,0,1
2049,6693,2049.0,17,Gremio,Goias,15/9/2019,0,1,0,0,1,0,1,0,1
2050,6694,2050.0,17,Fluminense,Corinthians,15/9/2019,4,1,0,0,5,4,5,0,1
2051,6695,2051.0,17,Sao Paulo,CSA,15/9/2019,1,3,0,0,4,1,4,0,3
2052,6696,2052.0,17,Botafogo-RJ,Sao Paulo,21/9/2019,3,1,0,0,4,3,4,0,1
2053,6697,2053.0,17,Cruzeiro,Flamengo,21/9/2019,2,2,0,0,4,2,4,0,2
2054,6698,2054.0,17,Corinthians,Bahia,21/9/2019,2,4,0,0,6,2,6,0,4
2055,6699,2055.0,17,Santos,Gremio,21/9/2019,1,4,0,0,5,1,5,0,4
2056,6700,2056.0,17,Internacional,Chapecoense,22/9/2019,0,4,0,0,4,0,4,0,4
2057,6701,2057.0,17,Fortaleza,Palmeiras,22/9/2019,4,1,0,0,5,4,5,0,1
2058,6702,2058.0,17,CSA,Ceara,22/9/2019,1,2,0,0,3,1,3,0,2
2059,6703,2059.0,17,Vasco,Athletico-PR,22/9/2019,3,3,0,0,6,3,6,0,3
2060,6704,2060.0,17,Goias,Fluminense,22/9/2019,4,0,1,0,4,5,5,1,0
2061,6705,2061.0,17,Avai,Atletico-MG,23/9/2019,3,1,0,0,4,3,4,0,1
2062,6706,2062.0,17,Ceara,Cruzeiro,25/9/2019,2,3,0,0,5,2,5,0,3
2063,6707,2063.0,17,Bahia,Botafogo-RJ,25/9/2019,1,0,0,1,1,1,2,1,1
2064,6708,2064.0,17,Flamengo,Internacional,25/9/2019,1,1,0,2,2,1,4,2,3
2065,6709,2065.0,17,Sao Paulo,Goias,25/9/2019,2,4,0,0,6,2,6,0,4
2066,6710,2066.0,17,Palmeiras,CSA,26/9/2019,0,1,0,0,1,0,1,0,1
2067,6711,2067.0,17,Fluminense,Santos,26/9/2019,2,3,2,1,5,4,8,3,4
2068,6712,2068.0,17,Gremio,Avai,26/9/2019,1,1,0,0,2,1,2,0,1
2069,6713,2069.0,17,Athletico-PR,Fortaleza,26/9/2019,3,0,0,0,3,3,3,0,0
2070,6714,2070.0,17,Atletico-MG,Vasco,2/10/2019,3,2,0,0,5,3,5,0,2
2071,6715,2071.0,17,Chapecoense,Corinthians,2/10/2019,3,2,0,0,5,3,5,0,2
2072,6716,2072.0,17,Flamengo,Sao Paulo,28/9/2019,3,4,0,0,7,3,7,0,4
2073,6717,2073.0,17,Corinthians,Vasco,29/9/2019,3,5,0,0,8,3,8,0,5
2074,6718,2074.0,17,Santos,CSA,29/9/2019,1,2,1,0,3,2,4,1,2
2075,6719,2075.0,17,Internacional,Palmeiras,29/9/2019,3,2,0,0,5,3,5,0,2
2076,6720,2076.0,17,Fluminense,Gremio,29/9/2019,1,4,0,0,5,1,5,0,4
2077,6721,2077.0,17,Athletico-PR,Chapecoense,29/9/2019,0,1,0,0,1,0,1,0,1
2078,6722,2078.0,17,Atletico-MG,Ceara,29/9/2019,0,2,0,0,2,0,2,0,2
2079,6723,2079.0,17,Avai,Bahia,30/9/2019,1,2,0,0,3,1,3,0,2
2080,6724,2080.0,17,Fortaleza,Botafogo-RJ,30/9/2019,3,2,0,0,5,3,5,0,2
2081,6725,2081.0,17,Goias,Cruzeiro,30/9/2019,0,3,0,0,3,0,3,0,3
2082,6726,2082.0,17,Vasco,Santos,5/10/2019,4,2,0,1,6,4,7,1,3
2083,6727,2083.0,17,Sao Paulo,Fortaleza,5/10/2019,3,2,0,0,5,3,5,0,2
2084,6728,2084.0,17,Gremio,Corinthians,5/10/2019,3,2,0,0,5,3,5,0,2
2085,6729,2085.0,17,Bahia,Athletico-PR,5/10/2019,2,3,0,0,5,2,5,0,3
2086,6730,2086.0,17,Cruzeiro,Internacional,5/10/2019,5,3,0,0,8,5,8,0,3
2087,6731,2087.0,17,Chapecoense,Flamengo,6/10/2019,1,0,0,0,1,1,1,0,0
2088,6732,2088.0,17,Ceara,Goias,6/10/2019,1,0,0,0,1,1,1,0,0
2089,6733,2089.0,17,Palmeiras,Atletico-MG,6/10/2019,3,4,0,0,7,3,7,0,4
2090,6734,2090.0,17,Botafogo-RJ,Fluminense,6/10/2019,4,1,0,0,5,4,5,0,1
2091,6735,2091.0,17,CSA,Avai,6/10/2019,3,3,0,0,6,3,6,0,3
2092,6736,2092.0,17,CSA,Internacional,9/10/2019,2,2,0,0,4,2,4,0,2
2093,6737,2093.0,17,Botafogo-RJ,Goias,9/10/2019,4,2,0,0,6,4,6,0,2
2094,6738,2094.0,17,Fortaleza,Chapecoense,9/10/2019,4,2,0,0,6,4,6,0,2
2095,6739,2095.0,17,Bahia,Sao Paulo,9/10/2019,2,1,0,0,3,2,3,0,1
2096,6740,2096.0,17,Gremio,Ceara,9/10/2019,0,3,0,0,3,0,3,0,3
2097,6741,2097.0,17,Cruzeiro,Fluminense,9/10/2019,4,3,0,0,7,4,7,0,3
2098,6742,2098.0,17,Santos,Palmeiras,9/10/2019,1,2,0,1,3,1,4,1,3
2099,6743,2099.0,17,Corinthians,Athletico-PR,10/10/2019,2,2,0,0,4,2,4,0,2
2100,6744,2100.0,17,Avai,Vasco,10/10/2019,1,1,0,0,2,1,2,0,1
2101,6745,2101.0,17,Flamengo,Atletico-MG,10/10/2019,0,3,0,0,3,0,3,0,3
2102,6746,2102.0,17,Goias,CSA,12/10/2019,2,3,0,0,5,2,5,0,3
2103,6747,2103.0,17,Fluminense,Bahia,12/10/2019,0,1,0,0,1,0,1,0,1
2104,6748,2104.0,17,Palmeiras,Botafogo-RJ,12/10/2019,2,2,0,0,4,2,4,0,2
2105,6749,2105.0,17,Internacional,Santos,13/10/2019,2,3,0,0,5,2,5,0,3
2106,6750,2106.0,17,Athletico-PR,Flamengo,13/10/2019,2,4,0,0,6,2,6,0,4
2107,6751,2107.0,17,Ceara,Avai,13/10/2019,1,3,0,0,4,1,4,0,3
2108,6752,2108.0,17,Vasco,Fortaleza,13/10/2019,2,4,0,1,6,2,7,1,5
2109,6753,2109.0,17,Sao Paulo,Corinthians,13/10/2019,0,1,0,0,1,0,1,0,1
2110,6754,2110.0,17,Atletico-MG,Gremio,13/10/2019,4,1,1,0,5,5,6,1,1
2111,6755,2111.0,17,Chapecoense,Cruzeiro,13/10/2019,1,1,0,0,2,1,2,0,1
2112,6756,2112.0,17,CSA,Atletico-MG,16/10/2019,3,3,0,1,6,3,7,1,4
2113,6757,2113.0,17,Gremio,Bahia,16/10/2019,3,2,0,0,5,3,5,0,2
2114,6758,2114.0,17,Fortaleza,Flamengo,16/10/2019,1,3,0,0,4,1,4,0,3
2115,6759,2115.0,17,Cruzeiro,Sao Paulo,16/10/2019,2,2,0,0,4,2,4,0,2
2116,6760,2116.0,17,Palmeiras,Chapecoense,16/10/2019,1,3,0,1,4,1,5,1,4
2117,6761,2117.0,17,Goias,Corinthians,16/10/2019,3,4,2,0,7,5,9,2,4
2118,6762,2118.0,17,Vasco,Botafogo-RJ,16/10/2019,1,0,0,0,1,1,1,0,0
2119,6763,2119.0,17,Avai,Internacional,17/10/2019,1,3,1,0,4,2,5,1,3
2120,6764,2120.0,17,Santos,Ceara,17/10/2019,3,4,0,0,7,3,7,0,4
2121,6765,2121.0,17,Fluminense,Athletico-PR,17/10/2019,0,1,0,0,1,0,1,0,1
2122,6766,2122.0,17,Fortaleza,Gremio,19/10/2019,4,2,0,1,6,4,7,1,3
2123,6767,2123.0,17,Corinthians,Cruzeiro,19/10/2019,3,1,0,0,4,3,4,0,1
2124,6768,2124.0,17,Internacional,Vasco,20/10/2019,3,1,0,0,4,3,4,0,1
2125,6769,2125.0,17,Sao Paulo,Avai,20/10/2019,4,1,0,1,5,4,6,1,2
2126,6770,2126.0,17,Atletico-MG,Santos,20/10/2019,3,4,0,0,7,3,7,0,4
2127,6771,2127.0,17,Flamengo,Fluminense,20/10/2019,3,5,0,0,8,3,8,0,5
2128,6772,2128.0,17,Chapecoense,Goias,20/10/2019,2,5,0,0,7,2,7,0,5
2129,6773,2129.0,17,Athletico-PR,Palmeiras,20/10/2019,1,2,0,0,3,1,3,0,2
2130,6774,2130.0,17,Bahia,Ceara,21/10/2019,2,3,0,0,5,2,5,0,3
2131,6775,2131.0,17,Botafogo-RJ,CSA,21/10/2019,2,2,0,1,4,2,5,1,3
2132,6776,2132.0,17,Corinthians,Santos,26/10/2019,3,1,0,0,4,3,4,0,1
2133,6777,2133.0,17,Ceara,Vasco,26/10/2019,3,3,0,0,6,3,6,0,3
2134,6778,2134.0,17,Bahia,Internacional,26/10/2019,1,5,0,0,6,1,6,0,5
2135,6779,2135.0,17,Fluminense,Chapecoense,26/10/2019,1,4,0,0,5,1,5,0,4
2136,6780,2136.0,17,Cruzeiro,Fortaleza,26/10/2019,3,1,0,0,4,3,4,0,1
2137,6781,2137.0,17,Athletico-PR,Goias,27/10/2019,1,1,0,0,2,1,2,0,1
2138,6782,2138.0,17,Gremio,Botafogo-RJ,27/10/2019,3,2,0,0,5,3,5,0,2
2139,6784,2139.0,17,Avai,Palmeiras,27/10/2019,3,2,0,0,5,3,5,0,2
2140,6785,2140.0,17,Flamengo,CSA,27/10/2019,1,2,0,0,3,1,3,0,2
2141,6787,2141.0,17,Avai,Fortaleza,30/10/2019,4,1,1,0,5,5,6,1,1
2142,6788,2142.0,17,Atletico-MG,Chapecoense,30/10/2019,3,3,0,0,6,3,6,0,3
2143,6789,2143.0,17,Ceara,Fluminense,30/10/2019,1,1,0,0,2,1,2,0,1
2144,6790,2144.0,17,Vasco,Gremio,30/10/2019,2,2,0,0,4,2,4,0,2
2145,6791,2145.0,17,CSA,Corinthians,30/10/2019,6,2,0,0,8,6,8,0,2
2146,6792,2146.0,17,Santos,Bahia,31/10/2019,5,3,0,0,8,5,8,0,3
2147,6793,2147.0,17,Goias,Flamengo,31/10/2019,5,3,0,1,8,5,9,1,4
2148,6794,2148.0,17,Internacional,Athletico-PR,31/10/2019,3,2,0,0,5,3,5,0,2
2149,6795,2149.0,17,Botafogo-RJ,Cruzeiro,31/10/2019,1,3,0,0,4,1,4,0,3
2150,6796,2150.0,17,Fortaleza,Atletico-MG,2/11/2019,3,3,0,1,6,3,7,1,4
2151,6797,2151.0,17,Fluminense,Vasco,2/11/2019,2,3,0,0,5,2,5,0,3
2152,6798,2152.0,17,Palmeiras,Ceara,2/11/2019,2,2,0,0,4,2,4,0,2
2153,6799,2153.0,17,Chapecoense,Sao Paulo,2/11/2019,2,2,0,0,4,2,4,0,2
2154,6800,2154.0,17,Flamengo,Corinthians,3/11/2019,0,1,0,0,1,0,1,0,1
2155,6801,2155.0,17,Athletico-PR,CSA,3/11/2019,3,4,0,0,7,3,7,0,4
2156,6802,2156.0,17,Gremio,Internacional,3/11/2019,2,2,0,1,4,2,5,1,3
2157,6803,2157.0,17,Santos,Botafogo-RJ,3/11/2019,1,0,0,0,1,1,1,0,0
2158,6804,2158.0,17,Cruzeiro,Bahia,3/11/2019,3,0,1,0,3,4,4,1,0
2159,6805,2159.0,17,Goias,Avai,3/11/2019,1,3,0,0,4,1,4,0,3
2160,6806,2160.0,17,Corinthians,Fortaleza,6/11/2019,2,3,0,0,5,2,5,0,3
2161,6807,2161.0,17,Atletico-MG,Goias,6/11/2019,0,2,0,0,2,0,2,0,2
2162,6808,2162.0,17,Avai,Santos,6/11/2019,5,2,1,1,7,6,9,2,3
2163,6809,2163.0,17,Athletico-PR,Cruzeiro,6/11/2019,3,1,0,1,4,3,5,1,2
2164,6810,2164.0,17,Vasco,Palmeiras,6/11/2019,7,4,1,0,11,8,12,1,4
2165,6811,2165.0,17,Bahia,Chapecoense,6/11/2019,1,3,0,0,4,1,4,0,3
2166,6812,2166.0,17,Ceara,Internacional,7/11/2019,2,2,0,0,4,2,4,0,2
2167,6813,2167.0,17,Sao Paulo,Fluminense,7/11/2019,2,1,0,0,3,2,3,0,1
2168,6814,2168.0,17,Botafogo-RJ,Flamengo,7/11/2019,5,2,1,0,7,6,8,1,2
2169,6815,2169.0,17,Gremio,CSA,7/11/2019,3,2,0,0,5,3,5,0,2
2170,6816,2170.0,17,Goias,Santos,9/11/2019,4,2,0,0,6,4,6,0,2
2171,6817,2171.0,17,Palmeiras,Corinthians,9/11/2019,2,1,0,0,3,2,3,0,1
2172,6818,2172.0,17,Internacional,Fluminense,10/11/2019,3,2,0,0,5,3,5,0,2
2173,6819,2173.0,17,Cruzeiro,Atletico-MG,10/11/2019,1,1,0,0,2,1,2,0,1
2174,6820,2174.0,17,Sao Paulo,Athletico-PR,10/11/2019,2,2,0,0,4,2,4,0,2
2175,6821,2175.0,17,Flamengo,Bahia,10/11/2019,1,0,0,0,1,1,1,0,0
2176,6822,2176.0,17,Chapecoense,Gremio,10/11/2019,2,2,0,0,4,2,4,0,2
2177,6823,2177.0,17,Fortaleza,Ceara,10/11/2019,4,4,0,0,8,4,8,0,4
2178,6824,2178.0,17,CSA,Vasco,10/11/2019,2,2,1,0,4,3,5,1,2
2179,6825,2179.0,17,Botafogo-RJ,Avai,11/11/2019,4,3,0,1,7,4,8,1,4
2180,6826,2180.0,17,Flamengo,Vasco,13/11/2019,6,5,0,0,11,6,11,0,5
2181,6827,2181.0,17,Santos,Cruzeiro,23/11/2019,2,2,0,0,4,2,4,0,2
2182,6828,2182.0,17,Palmeiras,Gremio,24/11/2019,2,3,0,0,5,2,5,0,3
2183,6829,2183.0,17,Atletico-MG,Athletico-PR,24/11/2019,3,2,0,0,5,3,5,0,2
2184,6830,2184.0,17,Goias,Bahia,24/11/2019,2,2,0,0,4,2,4,0,2
2185,6831,2185.0,17,Botafogo-RJ,Corinthians,24/11/2019,4,2,0,0,6,4,6,0,2
2186,6832,2186.0,17,Ceara,Sao Paulo,24/11/2019,3,1,0,0,4,3,4,0,1
2187,6833,2187.0,17,Internacional,Fortaleza,24/11/2019,4,2,0,0,6,4,6,0,2
2188,6834,2188.0,17,Avai,Chapecoense,24/11/2019,0,1,1,1,1,1,3,2,2
2189,6835,2189.0,17,CSA,Fluminense,25/11/2019,2,2,0,0,4,2,4,0,2
2190,6836,2190.0,17,Santos,Sao Paulo,16/11/2019,0,3,0,0,3,0,3,0,3
2191,6837,2191.0,17,Fluminense,Atletico-MG,16/11/2019,2,3,0,0,5,2,5,0,3
2192,6838,2192.0,17,Gremio,Flamengo,17/11/2019,1,3,0,1,4,1,5,1,4
2193,6839,2193.0,17,Bahia,Palmeiras,17/11/2019,2,0,0,0,2,2,2,0,0
2194,6840,2194.0,17,Chapecoense,Ceara,17/11/2019,2,1,0,0,3,2,3,0,1
2195,6841,2195.0,17,Athletico-PR,Botafogo-RJ,17/11/2019,4,1,0,0,5,4,5,0,1
2196,6842,2196.0,17,Corinthians,Internacional,17/11/2019,0,2,0,0,2,0,2,0,2
2197,6843,2197.0,17,Fortaleza,CSA,17/11/2019,0,1,0,0,1,0,1,0,1
2198,6844,2198.0,17,Vasco,Goias,18/11/2019,2,2,0,0,4,2,4,0,2
2199,6845,2199.0,17,Cruzeiro,Avai,18/11/2019,3,2,0,0,5,3,5,0,2
2200,6846,2200.0,17,Internacional,Goias,27/11/2019,2,4,0,0,6,2,6,0,4
2201,6847,2201.0,17,Chapecoense,Botafogo-RJ,27/11/2019,2,3,0,0,5,2,5,0,3
2202,6848,2202.0,17,Bahia,Atletico-MG,27/11/2019,1,1,0,0,2,1,2,0,1
2203,6849,2203.0,17,Athletico-PR,Gremio,27/11/2019,3,4,0,1,7,3,8,1,5
2204,6850,2204.0,17,Flamengo,Ceara,27/11/2019,2,1,0,1,3,2,4,1,2
2205,6851,2205.0,17,Corinthians,Avai,27/11/2019,0,1,0,0,1,0,1,0,1
2206,6852,2206.0,17,Fluminense,Palmeiras,28/11/2019,3,4,0,0,7,3,7,0,4
2207,6853,2207.0,17,Fortaleza,Santos,28/11/2019,2,8,0,2,10,2,12,2,10
2208,6854,2208.0,17,Sao Paulo,Vasco,28/11/2019,4,2,0,0,6,4,6,0,2
2209,6855,2209.0,17,Cruzeiro,CSA,28/11/2019,0,4,0,0,4,0,4,0,4
2210,6856,2210.0,17,Botafogo-RJ,Internacional,30/11/2019,2,3,0,0,5,2,5,0,3
2211,6857,2211.0,17,Ceara,Athletico-PR,30/11/2019,7,2,0,1,9,7,10,1,3
2212,6858,2212.0,17,Avai,Fluminense,1/12/2019,4,5,0,0,9,4,9,0,5
2213,6859,2213.0,17,Palmeiras,Flamengo,1/12/2019,1,2,0,0,3,1,3,0,2
2214,6860,2214.0,17,Goias,Fortaleza,1/12/2019,1,4,0,0,5,1,5,0,4
2215,6861,2215.0,17,CSA,Bahia,1/12/2019,3,4,0,1,7,3,8,1,5
2216,6862,2216.0,17,Atletico-MG,Corinthians,1/12/2019,3,1,0,0,4,3,4,0,1
2217,6863,2217.0,17,Santos,Chapecoense,1/12/2019,3,4,0,0,7,3,7,0,4
2218,6865,2218.0,17,Vasco,Cruzeiro,2/12/2019,3,3,0,0,6,3,6,0,3
2219,6866,2219.0,17,Athletico-PR,Santos,4/12/2019,2,4,0,1,6,2,7,1,5
2220,6867,2220.0,17,Ceara,Corinthians,4/12/2019,3,4,1,0,7,4,8,1,4
2221,6868,2221.0,17,Atletico-MG,Botafogo-RJ,4/12/2019,1,3,0,0,4,1,4,0,3
2222,6869,2222.0,17,Chapecoense,CSA,4/12/2019,1,2,0,1,3,1,4,1,3
2223,6870,2223.0,17,Fluminense,Fortaleza,4/12/2019,2,1,1,1,3,3,5,2,2
2224,6871,2224.0,17,Sao Paulo,Internacional,4/12/2019,3,4,0,0,7,3,7,0,4
2225,6872,2225.0,17,Gremio,Cruzeiro,5/12/2019,0,4,0,1,4,0,5,1,5
2226,6873,2226.0,17,Palmeiras,Goias,5/12/2019,5,1,0,0,6,5,6,0,1
2227,6874,2227.0,17,Bahia,Vasco,5/12/2019,3,2,1,1,5,4,7,2,3
2228,6875,2228.0,17,Flamengo,Avai,5/12/2019,0,1,0,0,1,0,1,0,1
2229,6876,2229.0,17,Corinthians,Fluminense,8/12/2019,1,3,0,0,4,1,4,0,3
2230,6877,2230.0,17,Santos,Flamengo,8/12/2019,2,3,0,0,5,2,5,0,3
2231,6878,2231.0,17,Botafogo-RJ,Ceara,8/12/2019,0,2,0,0,2,0,2,0,2
2232,6879,2232.0,17,CSA,Sao Paulo,8/12/2019,1,3,0,1,4,1,5,1,4
2233,6880,2233.0,17,Internacional,Atletico-MG,8/12/2019,4,1,0,0,5,4,5,0,1
2234,6881,2234.0,17,Cruzeiro,Palmeiras,8/12/2019,0,1,0,0,1,0,1,0,1
2235,6882,2235.0,17,Goias,Gremio,8/12/2019,1,1,0,0,2,1,2,0,1
2236,6883,2236.0,17,Vasco,Chapecoense,8/12/2019,2,3,0,0,5,2,5,0,3
2237,6884,2237.0,17,Avai,Athletico-PR,8/12/2019,2,1,0,0,3,2,3,0,1
2238,6885,2238.0,17,Fortaleza,Bahia,8/12/2019,2,1,0,0,3,2,3,0,1
2239,6886,2239.0,18,Fortaleza,Athletico-PR,8/8/2020,3,2,1,0,5,4,6,1,2
2240,6887,2240.0,18,Coritiba,Internacional,8/8/2020,3,4,0,0,7,3,7,0,4
2241,6888,2241.0,18,Sport,Ceara,8/8/2020,3,3,0,0,6,3,6,0,3
2242,6889,2242.0,18,Santos,Bragantino,9/8/2020,0,1,0,0,1,0,1,0,1
2243,6890,2243.0,18,Flamengo,Atletico-MG,9/8/2020,3,2,0,0,5,3,5,0,2
2244,6891,2244.0,18,Gremio,Fluminense,9/8/2020,2,3,0,0,5,2,5,0,3
2245,6892,2245.0,18,Corinthians,Atletico-GO,30/9/2020,2,0,0,0,2,2,2,0,0
2246,6893,2246.0,18,Botafogo-RJ,Bahia,30/9/2020,2,3,1,0,5,3,6,1,3
2247,6894,2247.0,18,Goias,Sao Paulo,3/12/2020,3,0,0,0,3,3,3,0,0
2248,6895,2248.0,18,Palmeiras,Vasco,26/1/2021,1,1,0,0,2,1,2,0,1
2249,6896,2249.0,18,Athletico-PR,Goias,12/8/2020,3,3,0,0,6,3,6,0,3
2250,6897,2250.0,18,Atletico-MG,Corinthians,12/8/2020,0,1,0,0,1,0,1,0,1
2251,6898,2251.0,18,Bragantino,Botafogo-RJ,12/8/2020,3,1,0,0,4,3,4,0,1
2252,6899,2252.0,18,Bahia,Coritiba,12/8/2020,0,5,0,0,5,0,5,0,5
2253,6900,2253.0,18,Atletico-GO,Flamengo,12/8/2020,1,1,0,1,2,1,3,1,2
2254,6901,2254.0,18,Ceara,Gremio,12/8/2020,3,1,0,0,4,3,4,0,1
2255,6902,2255.0,18,Fluminense,Palmeiras,12/8/2020,3,3,0,0,6,3,6,0,3
2256,6903,2256.0,18,Sao Paulo,Fortaleza,13/8/2020,1,2,0,0,3,1,3,0,2
2257,6904,2257.0,18,Internacional,Santos,13/8/2020,2,3,0,0,5,2,5,0,3
2258,6905,2258.0,18,Vasco,Sport,13/8/2020,2,3,0,1,5,2,6,1,4
2259,6906,2259.0,18,Gremio,Corinthians,15/8/2020,2,3,0,0,5,2,5,0,3
2260,6907,2260.0,18,Coritiba,Flamengo,15/8/2020,5,3,1,0,8,6,9,1,3
2261,6908,2261.0,18,Palmeiras,Goias,15/8/2020,1,3,0,0,4,1,4,0,3
2262,6909,2262.0,18,Atletico-MG,Ceara,16/8/2020,2,4,0,0,6,2,6,0,4
2263,6910,2263.0,18,Bahia,Bragantino,16/8/2020,1,1,0,0,2,1,2,0,1
2264,6911,2264.0,18,Vasco,Sao Paulo,16/8/2020,2,5,0,0,7,2,7,0,5
2265,6912,2265.0,18,Fluminense,Internacional,16/8/2020,2,2,0,0,4,2,4,0,2
2266,6913,2266.0,18,Atletico-GO,Sport,16/8/2020,1,2,1,0,3,2,4,1,2
2267,6914,2267.0,18,Fortaleza,Botafogo-RJ,16/8/2020,2,1,0,0,3,2,3,0,1
2268,6915,2268.0,18,Santos,Athletico-PR,16/8/2020,1,1,0,0,2,1,2,0,1
2269,6916,2269.0,18,Flamengo,Gremio,19/8/2020,3,3,0,0,6,3,6,0,3
2270,6917,2270.0,18,Bragantino,Fluminense,19/8/2020,5,5,0,0,10,5,10,0,5
2271,6918,2271.0,18,Athletico-PR,Palmeiras,19/8/2020,5,0,0,0,5,5,5,0,0
2272,6919,2272.0,18,Goias,Fortaleza,19/8/2020,4,2,0,0,6,4,6,0,2
2273,6920,2273.0,18,Internacional,Atletico-GO,19/8/2020,3,3,1,0,6,4,7,1,3
2274,6921,2274.0,18,Corinthians,Coritiba,19/8/2020,2,1,0,1,3,2,4,1,2
2275,6922,2275.0,18,Botafogo-RJ,Atletico-MG,19/8/2020,2,0,0,0,2,2,2,0,0
2276,6923,2276.0,18,Sport,Santos,20/8/2020,5,2,0,0,7,5,7,0,2
2277,6924,2277.0,18,Ceara,Vasco,20/8/2020,3,3,0,0,6,3,6,0,3
2278,6925,2278.0,18,Sao Paulo,Bahia,20/8/2020,2,2,0,0,4,2,4,0,2
2279,6926,2279.0,18,Athletico-PR,Fluminense,22/8/2020,4,3,0,0,7,4,7,0,3
2280,6927,2280.0,18,Internacional,Atletico-MG,22/8/2020,1,2,0,0,3,1,3,0,2
2281,6928,2281.0,18,Goias,Atletico-GO,22/8/2020,5,2,0,0,7,5,7,0,2
2282,6929,2282.0,18,Flamengo,Botafogo-RJ,23/8/2020,3,3,0,0,6,3,6,0,3
2283,6930,2283.0,18,Vasco,Gremio,23/8/2020,5,2,0,0,7,5,7,0,2
2284,6931,2284.0,18,Palmeiras,Santos,23/8/2020,5,3,0,1,8,5,9,1,4
2285,6932,2285.0,18,Bragantino,Coritiba,23/8/2020,2,0,1,0,2,3,3,1,0
2286,6933,2286.0,18,Sport,Sao Paulo,23/8/2020,2,3,0,0,5,2,5,0,3
2287,6934,2287.0,18,Ceara,Bahia,23/8/2020,1,2,0,0,3,1,3,0,2
2288,6935,2288.0,18,Corinthians,Fortaleza,26/8/2020,0,2,0,0,2,0,2,0,2
2289,6936,2289.0,18,Sao Paulo,Athletico-PR,26/8/2020,2,1,0,0,3,2,3,0,1
2290,6937,2290.0,18,Corinthians,Bahia,16/9/2020,3,2,0,0,5,3,5,0,2
2291,6938,2291.0,18,Fortaleza,Internacional,19/9/2020,1,3,0,0,4,1,4,0,3
2292,6939,2292.0,18,Bragantino,Ceara,19/9/2020,4,3,0,0,7,4,7,0,3
2293,6940,2293.0,18,Atletico-GO,Atletico-MG,19/9/2020,2,0,0,0,2,2,2,0,0
2294,6941,2294.0,18,Gremio,Palmeiras,20/9/2020,2,3,0,0,5,2,5,0,3
2295,6942,2295.0,18,Coritiba,Vasco,20/9/2020,1,2,0,0,3,1,3,0,2
2296,6943,2296.0,18,Botafogo-RJ,Santos,20/9/2020,4,2,0,0,6,4,6,0,2
2297,6944,2297.0,18,Sport,Fluminense,20/9/2020,0,1,0,0,1,0,1,0,1
2298,6945,2298.0,18,Flamengo,Goias,13/10/2020,1,4,0,0,5,1,5,0,4
2299,6946,2299.0,18,Botafogo-RJ,Internacional,29/8/2020,3,1,0,0,4,3,4,0,1
2300,6947,2300.0,18,Fluminense,Vasco,29/8/2020,4,1,0,1,5,4,6,1,2
2301,6948,2301.0,18,Bahia,Palmeiras,29/8/2020,2,2,0,0,4,2,4,0,2
2302,6949,2302.0,18,Fortaleza,Bragantino,29/8/2020,2,2,0,1,4,2,5,1,3
2303,6950,2303.0,18,Sao Paulo,Corinthians,30/8/2020,3,0,0,0,3,3,3,0,0
2304,6951,2304.0,18,Coritiba,Sport,30/8/2020,1,4,0,0,5,1,5,0,4
2305,6952,2305.0,18,Santos,Flamengo,30/8/2020,6,7,0,0,13,6,13,0,7
2306,6953,2306.0,18,Atletico-GO,Ceara,30/8/2020,1,2,1,0,3,2,4,1,2
2307,6954,2307.0,18,Atletico-MG,Athletico-PR,18/11/2020,1,2,0,0,3,1,3,0,2
2308,6955,2308.0,18,Gremio,Goias,30/11/2020,2,2,0,0,4,2,4,0,2
2309,6956,2309.0,18,Ceara,Fortaleza,2/9/2020,2,2,0,0,4,2,4,0,2
2310,6957,2310.0,18,Fluminense,Atletico-GO,2/9/2020,3,1,1,0,4,4,5,1,1
2311,6958,2311.0,18,Goias,Corinthians,2/9/2020,1,3,0,0,4,1,4,0,3
2312,6959,2312.0,18,Botafogo-RJ,Coritiba,2/9/2020,1,1,0,0,2,1,2,0,1
2313,6960,2313.0,18,Athletico-PR,Bragantino,2/9/2020,2,2,0,0,4,2,4,0,2
2314,6961,2314.0,18,Bahia,Flamengo,2/9/2020,1,2,0,0,3,1,3,0,2
2315,6962,2315.0,18,Palmeiras,Internacional,2/9/2020,3,5,0,0,8,3,8,0,5
2316,6963,2316.0,18,Santos,Vasco,2/9/2020,2,3,0,0,5,2,5,0,3
2317,6964,2317.0,18,Gremio,Sport,3/9/2020,1,5,0,0,6,1,6,0,5
2318,6966,2318.0,18,Flamengo,Fortaleza,5/9/2020,1,1,0,0,2,1,2,0,1
2319,6967,2319.0,18,Corinthians,Botafogo-RJ,5/9/2020,3,1,0,0,4,3,4,0,1
2320,6968,2320.0,18,Ceara,Santos,5/9/2020,3,4,2,2,7,5,11,4,6
2321,6969,2321.0,18,Bragantino,Palmeiras,6/9/2020,1,3,1,0,4,2,5,1,3
2322,6970,2322.0,18,Internacional,Bahia,6/9/2020,2,3,0,0,5,2,5,0,3
2323,6971,2323.0,18,Sao Paulo,Fluminense,6/9/2020,3,0,0,0,3,3,3,0,0
2324,6972,2324.0,18,Vasco,Athletico-PR,6/9/2020,1,1,0,0,2,1,2,0,1
2325,6973,2325.0,18,Atletico-GO,Gremio,6/9/2020,1,3,0,1,4,1,5,1,4
2326,6974,2326.0,18,Sport,Goias,6/9/2020,1,0,0,0,1,1,1,0,0
2327,6975,2327.0,18,Coritiba,Atletico-MG,6/9/2020,1,3,0,0,4,1,4,0,3
2328,6976,2328.0,18,Athletico-PR,Botafogo-RJ,9/9/2020,1,0,0,0,1,1,1,0,0
2329,6977,2329.0,18,Fortaleza,Sport,9/9/2020,5,1,0,0,6,5,6,0,1
2330,6978,2330.0,18,Goias,Coritiba,9/9/2020,5,2,1,1,7,6,9,2,3
2331,6979,2331.0,18,Sao Paulo,Bragantino,9/9/2020,4,2,0,0,6,4,6,0,2
2332,6980,2332.0,18,Fluminense,Flamengo,9/9/2020,1,1,0,0,2,1,2,0,1
2333,6981,2333.0,18,Santos,Atletico-MG,9/9/2020,1,2,0,1,3,1,4,1,3
2334,6982,2334.0,18,Internacional,Ceara,10/9/2020,0,2,0,0,2,0,2,0,2
2335,6983,2335.0,18,Corinthians,Palmeiras,10/9/2020,3,2,2,0,5,5,7,2,2
2336,6984,2336.0,18,Bahia,Gremio,10/9/2020,1,3,1,1,4,2,6,2,4
2337,6985,2337.0,18,Vasco,Atletico-GO,10/9/2020,2,1,1,0,3,3,4,1,1
2338,6986,2338.0,18,Athletico-PR,Coritiba,12/9/2020,4,1,0,1,5,4,6,1,2
2339,6987,2339.0,18,Santos,Sao Paulo,12/9/2020,3,2,0,0,5,3,5,0,2
2340,6988,2340.0,18,Fluminense,Corinthians,13/9/2020,2,4,1,0,6,3,7,1,4
2341,6989,2341.0,18,Gremio,Fortaleza,13/9/2020,1,2,1,1,3,2,5,2,3
2342,6990,2342.0,18,Atletico-MG,Bragantino,13/9/2020,1,1,0,0,2,1,2,0,1
2343,6991,2343.0,18,Bahia,Atletico-GO,13/9/2020,2,2,1,0,4,3,5,1,2
2344,6992,2344.0,18,Ceara,Flamengo,13/9/2020,1,0,0,0,1,1,1,0,0
2345,6993,2345.0,18,Goias,Internacional,13/9/2020,4,3,1,0,7,5,8,1,3
2346,6994,2346.0,18,Palmeiras,Sport,13/9/2020,2,3,1,1,5,3,7,2,4
2347,6995,2347.0,18,Botafogo-RJ,Vasco,13/9/2020,2,2,0,0,4,2,4,0,2
2348,6996,2348.0,18,Sport,Corinthians,23/9/2020,3,4,0,0,7,3,7,0,4
2349,6997,2349.0,18,Athletico-PR,Bahia,26/9/2020,4,1,0,0,5,4,5,0,1
2350,6998,2350.0,18,Internacional,Sao Paulo,26/9/2020,2,0,1,0,2,3,3,1,0
2351,6999,2351.0,18,Atletico-MG,Gremio,26/9/2020,1,1,0,0,2,1,2,0,1
2352,7000,2352.0,18,Vasco,Bragantino,27/9/2020,2,1,0,0,3,2,3,0,1
2353,7001,2353.0,18,Palmeiras,Flamengo,27/9/2020,4,2,0,0,6,4,6,0,2
2354,7002,2354.0,18,Ceara,Goias,27/9/2020,3,4,0,0,7,3,7,0,4
2355,7003,2355.0,18,Atletico-GO,Botafogo-RJ,27/9/2020,2,3,0,0,5,2,5,0,3
2356,7004,2356.0,18,Santos,Fortaleza,27/9/2020,1,1,0,0,2,1,2,0,1
2357,7005,2357.0,18,Fluminense,Coritiba,28/9/2020,1,1,0,1,2,1,3,1,2
2358,7006,2358.0,18,Gremio,Internacional,3/10/2020,1,1,1,1,2,2,4,2,2
2359,7007,2359.0,18,Palmeiras,Ceara,3/10/2020,1,4,0,0,5,1,5,0,4
2360,7008,2360.0,18,Bragantino,Corinthians,3/10/2020,1,2,0,0,3,1,3,0,2
2361,7009,2361.0,18,Botafogo-RJ,Fluminense,4/10/2020,0,1,0,0,1,0,1,0,1
2362,7010,2362.0,18,Coritiba,Sao Paulo,4/10/2020,2,3,0,0,5,2,5,0,3
2363,7011,2363.0,18,Flamengo,Athletico-PR,4/10/2020,3,4,0,0,7,3,7,0,4
2364,7012,2364.0,18,Fortaleza,Atletico-GO,4/10/2020,5,5,0,0,10,5,10,0,5
2365,7013,2365.0,18,Goias,Santos,4/10/2020,4,3,1,1,7,5,9,2,4
2366,7014,2366.0,18,Bahia,Sport,4/10/2020,2,3,0,0,5,2,5,0,3
2367,7015,2367.0,18,Atletico-MG,Vasco,4/10/2020,3,3,0,1,6,3,7,1,4
2368,7016,2368.0,18,Corinthians,Santos,7/10/2020,2,2,0,0,4,2,4,0,2
2369,7017,2369.0,18,Flamengo,Sport,7/10/2020,0,3,0,0,3,0,3,0,3
2370,7018,2370.0,18,Bahia,Vasco,7/10/2020,4,3,0,1,7,4,8,1,4
2371,7019,2371.0,18,Gremio,Coritiba,7/10/2020,2,2,0,0,4,2,4,0,2
2372,7020,2372.0,18,Sao Paulo,Atletico-GO,7/10/2020,3,2,0,0,5,3,5,0,2
2373,7021,2373.0,18,Goias,Fluminense,7/10/2020,3,2,0,0,5,3,5,0,2
2374,7022,2374.0,18,Botafogo-RJ,Palmeiras,7/10/2020,4,4,0,0,8,4,8,0,4
2375,7023,2375.0,18,Fortaleza,Atletico-MG,7/10/2020,3,3,1,0,6,4,7,1,3
2376,7024,2376.0,18,Athletico-PR,Ceara,8/10/2020,3,2,0,0,5,3,5,0,2
2377,7025,2377.0,18,Bragantino,Internacional,8/10/2020,3,3,1,0,6,4,7,1,3
2378,7026,2378.0,18,Vasco,Flamengo,10/10/2020,2,5,0,0,7,2,7,0,5
2379,7027,2379.0,18,Coritiba,Fortaleza,10/10/2020,1,0,0,0,1,1,1,0,0
2380,7028,2380.0,18,Palmeiras,Sao Paulo,10/10/2020,2,1,0,0,3,2,3,0,1
2381,7029,2381.0,18,Atletico-MG,Goias,10/10/2020,0,1,0,0,1,0,1,0,1
2382,7030,2382.0,18,Fluminense,Bahia,11/10/2020,2,3,0,0,5,2,5,0,3
2383,7031,2383.0,18,Santos,Gremio,11/10/2020,2,3,0,1,5,2,6,1,4
2384,7032,2384.0,18,Sport,Botafogo-RJ,11/10/2020,3,2,0,1,5,3,6,1,3
2385,7033,2385.0,18,Atletico-GO,Bragantino,11/10/2020,1,1,0,0,2,1,2,0,1
2386,7034,2386.0,18,Ceara,Corinthians,11/10/2020,4,1,1,1,5,5,7,2,2
2387,7035,2387.0,18,Internacional,Athletico-PR,11/10/2020,2,0,0,0,2,2,2,0,0
2388,7036,2388.0,18,Palmeiras,Coritiba,14/10/2020,3,2,0,0,5,3,5,0,2
2389,7037,2389.0,18,Gremio,Botafogo-RJ,14/10/2020,3,2,1,0,5,4,6,1,2
2390,7038,2390.0,18,Santos,Atletico-GO,14/10/2020,3,3,0,0,6,3,6,0,3
2391,7039,2391.0,18,Athletico-PR,Corinthians,14/10/2020,3,3,0,1,6,3,7,1,4
2392,7040,2392.0,18,Atletico-MG,Fluminense,14/10/2020,3,1,0,0,4,3,4,0,1
2393,7041,2393.0,18,Sport,Internacional,14/10/2020,3,2,0,0,5,3,5,0,2
2394,7042,2394.0,18,Flamengo,Bragantino,15/10/2020,2,1,0,0,3,2,3,0,1
2395,7043,2395.0,18,Goias,Bahia,16/10/2020,5,4,0,2,9,5,11,2,6
2396,7044,2396.0,18,Vasco,Fortaleza,19/11/2020,2,0,0,0,2,2,2,0,0
2397,7045,2397.0,18,Ceara,Sao Paulo,25/11/2020,5,3,0,0,8,5,8,0,3
2398,7046,2398.0,18,Atletico-GO,Athletico-PR,17/10/2020,3,5,2,0,8,5,10,2,5
2399,7047,2399.0,18,Coritiba,Santos,17/10/2020,5,2,0,0,7,5,7,0,2
2400,7048,2400.0,18,Fluminense,Ceara,17/10/2020,3,3,0,0,6,3,6,0,3
2401,7049,2401.0,18,Sao Paulo,Gremio,17/10/2020,4,2,0,0,6,4,6,0,2
2402,7050,2402.0,18,Corinthians,Flamengo,18/10/2020,4,5,0,0,9,4,9,0,5
2403,7051,2403.0,18,Internacional,Vasco,18/10/2020,1,1,0,0,2,1,2,0,1
2404,7052,2404.0,18,Bragantino,Sport,18/10/2020,2,2,0,0,4,2,4,0,2
2405,7053,2405.0,18,Fortaleza,Palmeiras,18/10/2020,2,3,0,1,5,2,6,1,4
2406,7054,2406.0,18,Bahia,Atletico-MG,19/10/2020,4,1,0,0,5,4,5,0,1
2407,7055,2407.0,18,Botafogo-RJ,Goias,19/10/2020,2,1,0,0,3,2,3,0,1
2408,7056,2408.0,18,Vasco,Corinthians,21/10/2020,1,2,0,0,3,1,3,0,2
2409,7057,2409.0,18,Bragantino,Goias,24/10/2020,0,3,0,0,3,0,3,0,3
2410,7058,2410.0,18,Ceara,Coritiba,24/10/2020,3,1,0,0,4,3,4,0,1
2411,7059,2411.0,18,Atletico-MG,Sport,24/10/2020,1,0,0,0,1,1,1,0,0
2412,7060,2412.0,18,Atletico-GO,Palmeiras,25/10/2020,1,4,0,0,5,1,5,0,4
2413,7061,2413.0,18,Fluminense,Santos,25/10/2020,5,4,0,0,9,5,9,0,4
2414,7062,2414.0,18,Athletico-PR,Gremio,25/10/2020,3,1,0,0,4,3,4,0,1
2415,7063,2415.0,18,Internacional,Flamengo,25/10/2020,6,5,0,0,11,6,11,0,5
2416,7064,2416.0,18,Bahia,Fortaleza,11/11/2020,3,3,0,0,6,3,6,0,3
2417,7065,2417.0,18,Sao Paulo,Botafogo-RJ,9/12/2020,0,2,0,1,2,0,3,1,3
2418,7066,2418.0,18,Botafogo-RJ,Ceara,31/10/2020,4,5,1,1,9,5,11,2,6
2419,7067,2419.0,18,Coritiba,Atletico-GO,31/10/2020,2,5,0,0,7,2,7,0,5
2420,7068,2420.0,18,Corinthians,Internacional,31/10/2020,4,3,0,1,7,4,8,1,4
2421,7069,2421.0,18,Fortaleza,Fluminense,31/10/2020,2,1,1,0,3,3,4,1,1
2422,7070,2422.0,18,Flamengo,Sao Paulo,1/11/2020,4,3,0,0,7,4,7,0,3
2423,7071,2423.0,18,Sport,Athletico-PR,1/11/2020,2,1,1,0,3,3,4,1,1
2424,7072,2424.0,18,Santos,Bahia,1/11/2020,4,2,0,0,6,4,6,0,2
2425,7073,2425.0,18,Goias,Vasco,1/11/2020,5,7,0,0,12,5,12,0,7
2426,7074,2426.0,18,Palmeiras,Atletico-MG,2/11/2020,2,1,0,0,3,2,3,0,1
2427,7075,2427.0,18,Gremio,Bragantino,2/11/2020,1,1,0,0,2,1,2,0,1
2428,7076,2428.0,18,Athletico-PR,Fortaleza,7/11/2020,3,2,0,0,5,3,5,0,2
2429,7077,2429.0,18,Sao Paulo,Goias,7/11/2020,2,1,0,1,3,2,4,1,2
2430,7078,2430.0,18,Atletico-GO,Corinthians,7/11/2020,3,4,0,0,7,3,7,0,4
2431,7079,2431.0,18,Vasco,Palmeiras,8/11/2020,1,3,0,0,4,1,4,0,3
2432,7080,2432.0,18,Internacional,Coritiba,8/11/2020,2,3,1,0,5,3,6,1,3
2433,7081,2433.0,18,Bragantino,Santos,8/11/2020,1,4,0,0,5,1,5,0,4
2434,7082,2434.0,18,Atletico-MG,Flamengo,8/11/2020,5,4,0,0,9,5,9,0,4
2435,7083,2435.0,18,Bahia,Botafogo-RJ,8/11/2020,2,3,0,0,5,2,5,0,3
2436,7084,2436.0,18,Fluminense,Gremio,8/11/2020,0,1,0,0,1,0,1,0,1
2437,7085,2437.0,18,Ceara,Sport,8/11/2020,0,3,0,0,3,0,3,0,3
2438,7086,2438.0,18,Sport,Vasco,14/11/2020,0,2,0,0,2,0,2,0,2
2439,7087,2439.0,18,Santos,Internacional,14/11/2020,1,2,0,0,3,1,3,0,2
2440,7088,2440.0,18,Goias,Athletico-PR,14/11/2020,5,1,0,0,6,5,6,0,1
2441,7089,2441.0,18,Corinthians,Atletico-MG,14/11/2020,3,5,0,0,8,3,8,0,5
2442,7090,2442.0,18,Fortaleza,Sao Paulo,14/11/2020,2,4,0,0,6,2,6,0,4
2443,7091,2443.0,18,Gremio,Ceara,14/11/2020,1,2,0,0,3,1,3,0,2
2444,7092,2444.0,18,Palmeiras,Fluminense,14/11/2020,2,2,0,0,4,2,4,0,2
2445,7093,2445.0,18,Flamengo,Atletico-GO,14/11/2020,2,1,0,0,3,2,3,0,1
2446,7094,2446.0,18,Coritiba,Bahia,16/11/2020,3,4,0,0,7,3,7,0,4
2447,7095,2447.0,18,Botafogo-RJ,Bragantino,16/11/2020,0,3,0,0,3,0,3,0,3
2448,7096,2448.0,18,Bragantino,Bahia,20/11/2020,2,4,0,0,6,2,6,0,4
2449,7097,2449.0,18,Athletico-PR,Santos,21/11/2020,0,2,0,0,2,0,2,0,2
2450,7098,2450.0,18,Flamengo,Coritiba,21/11/2020,1,3,0,0,4,1,4,0,3
2451,7099,2451.0,18,Goias,Palmeiras,21/11/2020,2,2,0,1,4,2,5,1,3
2452,7100,2452.0,18,Sao Paulo,Vasco,22/11/2020,2,4,0,0,6,2,6,0,4
2453,7101,2453.0,18,Ceara,Atletico-MG,22/11/2020,4,1,0,1,5,4,6,1,2
2454,7102,2454.0,18,Internacional,Fluminense,22/11/2020,2,4,0,0,6,2,6,0,4
2455,7103,2455.0,18,Botafogo-RJ,Fortaleza,22/11/2020,1,1,0,0,2,1,2,0,1
2456,7104,2456.0,18,Corinthians,Gremio,22/11/2020,2,1,2,0,3,4,5,2,1
2457,7105,2457.0,18,Sport,Atletico-GO,23/11/2020,1,3,0,0,4,1,4,0,3
2458,7106,2458.0,18,Atletico-MG,Botafogo-RJ,25/11/2020,2,4,0,0,6,2,6,0,4
2459,7107,2459.0,18,Coritiba,Corinthians,25/11/2020,2,2,0,0,4,2,4,0,2
2460,7108,2460.0,18,Fortaleza,Goias,26/11/2020,2,0,0,0,2,2,2,0,0
2461,7109,2461.0,18,Palmeiras,Athletico-PR,28/11/2020,2,1,0,0,3,2,3,0,1
2462,7110,2462.0,18,Santos,Sport,28/11/2020,3,3,0,0,6,3,6,0,3
2463,7111,2463.0,18,Bahia,Sao Paulo,28/11/2020,0,2,0,0,2,0,2,0,2
2464,7112,2464.0,18,Atletico-GO,Internacional,28/11/2020,1,3,0,1,4,1,5,1,4
2465,7113,2465.0,18,Vasco,Ceara,30/11/2020,3,2,0,0,5,3,5,0,2
2466,7114,2466.0,18,Fluminense,Bragantino,30/11/2020,2,3,0,0,5,2,5,0,3
2467,7115,2467.0,18,Gremio,Flamengo,28/1/2021,5,3,0,0,8,5,8,0,3
2468,7116,2468.0,18,Fortaleza,Corinthians,2/12/2020,2,2,1,1,4,3,6,2,3
2469,7117,2469.0,18,Santos,Palmeiras,5/12/2020,3,3,0,1,6,3,7,1,4
2470,7118,2470.0,18,Botafogo-RJ,Flamengo,5/12/2020,1,1,1,1,2,2,4,2,2
2471,7119,2471.0,18,Fluminense,Athletico-PR,5/12/2020,4,3,0,1,7,4,8,1,4
2472,7120,2472.0,18,Bahia,Ceara,5/12/2020,2,2,0,0,4,2,4,0,2
2473,7121,2473.0,18,Coritiba,Bragantino,5/12/2020,4,3,0,0,7,4,7,0,3
2474,7122,2474.0,18,Sao Paulo,Sport,6/12/2020,4,4,0,0,8,4,8,0,4
2475,7123,2475.0,18,Gremio,Vasco,6/12/2020,2,1,0,0,3,2,3,0,1
2476,7124,2476.0,18,Atletico-MG,Internacional,6/12/2020,2,6,0,0,8,2,8,0,6
2477,7125,2477.0,18,Atletico-GO,Goias,7/12/2020,3,3,0,0,6,3,6,0,3
2478,7126,2478.0,18,Athletico-PR,Atletico-MG,12/12/2020,2,2,0,0,4,2,4,0,2
2479,7127,2479.0,18,Bragantino,Fortaleza,12/12/2020,3,2,0,0,5,3,5,0,2
2480,7128,2480.0,18,Internacional,Botafogo-RJ,12/12/2020,4,5,0,0,9,4,9,0,5
2481,7129,2481.0,18,Palmeiras,Bahia,12/12/2020,2,3,0,0,5,2,5,0,3
2482,7130,2482.0,18,Goias,Gremio,12/12/2020,4,1,0,0,5,4,5,0,1
2483,7131,2483.0,18,Ceara,Atletico-GO,12/12/2020,0,3,0,0,3,0,3,0,3
2484,7132,2484.0,18,Flamengo,Santos,13/12/2020,2,1,0,0,3,2,3,0,1
2485,7133,2485.0,18,Corinthians,Sao Paulo,13/12/2020,0,1,0,0,1,0,1,0,1
2486,7134,2486.0,18,Sport,Coritiba,13/12/2020,0,1,0,0,1,0,1,0,1
2487,7135,2487.0,18,Vasco,Fluminense,13/12/2020,6,2,0,0,8,6,8,0,2
2488,7136,2488.0,18,Sao Paulo,Atletico-MG,16/12/2020,2,3,0,1,5,2,6,1,4
2489,7137,2489.0,18,Atletico-GO,Fluminense,16/12/2020,3,4,0,0,7,3,7,0,4
2490,7138,2490.0,18,Sport,Gremio,19/12/2020,2,2,0,1,4,2,5,1,3
2491,7139,2491.0,18,Internacional,Palmeiras,19/12/2020,4,2,0,0,6,4,6,0,2
2492,7140,2492.0,18,Coritiba,Botafogo-RJ,19/12/2020,3,1,0,0,4,3,4,0,1
2493,7141,2493.0,18,Bragantino,Athletico-PR,20/12/2020,2,5,0,0,7,2,7,0,5
2494,7142,2494.0,18,Vasco,Santos,20/12/2020,2,0,0,0,2,2,2,0,0
2495,7143,2495.0,18,Flamengo,Bahia,20/12/2020,1,3,1,1,4,2,6,2,4
2496,7144,2496.0,18,Fortaleza,Ceara,20/12/2020,1,1,1,0,2,2,3,1,1
2497,7145,2497.0,18,Corinthians,Goias,21/12/2020,1,0,0,0,1,1,1,0,0
2498,7147,2498.0,18,Goias,Sport,26/12/2020,4,1,0,0,5,4,5,0,1
2499,7148,2499.0,18,Fortaleza,Flamengo,26/12/2020,3,3,0,0,6,3,6,0,3
2500,7149,2500.0,18,Fluminense,Sao Paulo,26/12/2020,3,1,0,0,4,3,4,0,1
2501,7150,2501.0,18,Botafogo-RJ,Corinthians,27/12/2020,1,1,0,0,2,1,2,0,1
2502,7151,2502.0,18,Bahia,Internacional,27/12/2020,3,1,0,0,4,3,4,0,1
2503,7152,2503.0,18,Athletico-PR,Vasco,27/12/2020,0,1,0,0,1,0,1,0,1
2504,7153,2504.0,18,Palmeiras,Bragantino,27/12/2020,3,0,0,0,3,3,3,0,0
2505,7154,2505.0,18,Santos,Ceara,27/12/2020,2,3,0,0,5,2,5,0,3
2506,7155,2506.0,18,Gremio,Atletico-GO,27/12/2020,2,3,0,0,5,2,5,0,3
2507,7156,2507.0,18,Gremio,Bahia,6/1/2021,2,4,0,0,6,2,6,0,4
2508,7157,2508.0,18,Botafogo-RJ,Athletico-PR,6/1/2021,3,2,0,0,5,3,5,0,2
2509,7158,2509.0,18,Coritiba,Goias,6/1/2021,4,3,0,0,7,4,7,0,3
2510,7159,2510.0,18,Sport,Fortaleza,6/1/2021,3,1,0,0,4,3,4,0,1
2511,7160,2511.0,18,Flamengo,Fluminense,6/1/2021,1,4,0,0,5,1,5,0,4
2512,7161,2512.0,18,Bragantino,Sao Paulo,6/1/2021,2,2,0,1,4,2,5,1,3
2513,7162,2513.0,18,Ceara,Internacional,7/1/2021,6,4,0,0,10,6,10,0,4
2514,7163,2514.0,18,Atletico-GO,Vasco,7/1/2021,3,2,0,0,5,3,5,0,2
2515,7164,2515.0,18,Palmeiras,Corinthians,18/1/2021,2,3,0,1,5,2,6,1,4
2516,7165,2516.0,18,Atletico-MG,Santos,26/1/2021,1,1,0,0,2,1,2,0,1
2517,7166,2517.0,18,Sport,Palmeiras,9/1/2021,5,3,0,0,8,5,8,0,3
2518,7167,2518.0,18,Coritiba,Athletico-PR,9/1/2021,2,1,0,0,3,2,3,0,1
2519,7168,2519.0,18,Fortaleza,Gremio,9/1/2021,4,2,0,0,6,4,6,0,2
2520,7169,2520.0,18,Sao Paulo,Santos,10/1/2021,2,4,0,0,6,2,6,0,4
2521,7170,2521.0,18,Flamengo,Ceara,10/1/2021,3,1,0,0,4,3,4,0,1
2522,7171,2522.0,18,Atletico-GO,Bahia,10/1/2021,2,0,0,0,2,2,2,0,0
2523,7172,2523.0,18,Internacional,Goias,10/1/2021,0,2,0,0,2,0,2,0,2
2524,7173,2524.0,18,Vasco,Botafogo-RJ,10/1/2021,1,0,0,0,1,1,1,0,0
2525,7174,2525.0,18,Bragantino,Atletico-MG,11/1/2021,4,0,0,0,4,4,4,0,0
2526,7175,2526.0,18,Corinthians,Fluminense,13/1/2021,1,2,0,0,3,1,3,0,2
2527,7176,2527.0,18,Palmeiras,Gremio,15/1/2021,3,1,0,0,4,3,4,0,1
2528,7177,2528.0,18,Fluminense,Sport,16/1/2021,1,1,0,1,2,1,3,1,2
2529,7178,2529.0,18,Vasco,Coritiba,16/1/2021,2,2,1,0,4,3,5,1,2
2530,7179,2530.0,18,Athletico-PR,Sao Paulo,17/1/2021,2,1,0,0,3,2,3,0,1
2531,7180,2531.0,18,Santos,Botafogo-RJ,17/1/2021,2,1,0,0,3,2,3,0,1
2532,7181,2532.0,18,Atletico-MG,Atletico-GO,17/1/2021,2,3,0,0,5,2,5,0,3
2533,7182,2533.0,18,Ceara,Bragantino,17/1/2021,1,2,0,0,3,1,3,0,2
2534,7183,2534.0,18,Internacional,Fortaleza,17/1/2021,0,3,0,0,3,0,3,0,3
2535,7184,2535.0,18,Goias,Flamengo,18/1/2021,5,1,0,0,6,5,6,0,1
2536,7185,2536.0,18,Bahia,Corinthians,28/1/2021,3,1,0,0,4,3,4,0,1
2537,7186,2537.0,18,Botafogo-RJ,Atletico-GO,20/1/2021,2,3,0,0,5,2,5,0,3
2538,7187,2538.0,18,Bahia,Athletico-PR,20/1/2021,2,0,0,0,2,2,2,0,0
2539,7188,2539.0,18,Gremio,Atletico-MG,20/1/2021,1,1,0,0,2,1,2,0,1
2540,7189,2540.0,18,Coritiba,Fluminense,20/1/2021,1,4,1,1,5,2,7,2,5
2541,7190,2541.0,18,Sao Paulo,Internacional,20/1/2021,2,1,0,0,3,2,3,0,1
2542,7192,2542.0,18,Flamengo,Palmeiras,21/1/2021,2,2,0,0,4,2,4,0,2
2543,7193,2543.0,18,Fortaleza,Santos,21/1/2021,3,0,0,0,3,3,3,0,0
2544,7194,2544.0,18,Goias,Ceara,21/1/2021,1,0,0,0,1,1,1,0,0
2545,7195,2545.0,18,Corinthians,Sport,21/1/2021,1,0,0,0,1,1,1,0,0
2546,7196,2546.0,18,Sao Paulo,Coritiba,23/1/2021,1,2,0,0,3,1,3,0,2
2547,7197,2547.0,18,Vasco,Atletico-MG,23/1/2021,4,1,0,0,5,4,5,0,1
2548,7198,2548.0,18,Internacional,Gremio,24/1/2021,2,2,0,0,4,2,4,0,2
2549,7199,2549.0,18,Athletico-PR,Flamengo,24/1/2021,2,0,0,0,2,2,2,0,0
2550,7200,2550.0,18,Ceara,Palmeiras,24/1/2021,3,5,1,0,8,4,9,1,5
2551,7201,2551.0,18,Atletico-GO,Fortaleza,24/1/2021,2,2,0,1,4,2,5,1,3
2552,7202,2552.0,18,Sport,Bahia,24/1/2021,3,0,0,0,3,3,3,0,0
2553,7203,2553.0,18,Santos,Goias,24/1/2021,4,4,0,0,8,4,8,0,4
2554,7204,2554.0,18,Fluminense,Botafogo-RJ,24/1/2021,2,1,0,0,3,2,3,0,1
2555,7205,2555.0,18,Corinthians,Bragantino,25/1/2021,5,4,0,0,9,5,9,0,4
2556,7206,2556.0,18,Vasco,Bahia,31/1/2021,1,3,1,0,4,2,5,1,3
2557,7207,2557.0,18,Ceara,Athletico-PR,31/1/2021,0,2,0,0,2,0,2,0,2
2558,7208,2558.0,18,Atletico-GO,Sao Paulo,31/1/2021,3,1,0,0,4,3,4,0,1
2559,7209,2559.0,18,Coritiba,Gremio,31/1/2021,3,3,0,0,6,3,6,0,3
2560,7210,2560.0,18,Atletico-MG,Fortaleza,31/1/2021,0,1,0,0,1,0,1,0,1
2561,7211,2561.0,18,Internacional,Bragantino,31/1/2021,3,0,0,0,3,3,3,0,0
2562,7212,2562.0,18,Fluminense,Goias,31/1/2021,1,2,0,0,3,1,3,0,2
2563,7213,2563.0,18,Sport,Flamengo,1/2/2021,2,2,0,0,4,2,4,0,2
2564,7214,2564.0,18,Palmeiras,Botafogo-RJ,2/2/2021,2,1,0,0,3,2,3,0,1
2565,7216,2565.0,18,Gremio,Santos,3/2/2021,5,2,0,1,7,5,8,1,3
2566,7217,2566.0,18,Bragantino,Atletico-GO,3/2/2021,3,3,0,0,6,3,6,0,3
2567,7219,2567.0,18,Goias,Atletico-MG,3/2/2021,3,3,0,0,6,3,6,0,3
2568,7220,2568.0,18,Bahia,Fluminense,3/2/2021,1,1,0,0,2,1,2,0,1
2569,7221,2569.0,18,Fortaleza,Coritiba,4/2/2021,2,5,0,2,7,2,9,2,7
2570,7222,2570.0,18,Flamengo,Vasco,4/2/2021,1,3,0,0,4,1,4,0,3
2571,7223,2571.0,18,Athletico-PR,Internacional,4/2/2021,3,2,0,0,5,3,5,0,2
2572,7224,2572.0,18,Botafogo-RJ,Sport,5/2/2021,1,3,0,0,4,1,4,0,3
2573,7225,2573.0,18,Sao Paulo,Palmeiras,19/2/2021,2,1,0,0,3,2,3,0,1
2574,7226,2574.0,18,Bahia,Goias,6/2/2021,3,4,1,0,7,4,8,1,4
2575,7227,2575.0,18,Atletico-GO,Santos,6/2/2021,2,2,1,0,4,3,5,1,2
2576,7228,2576.0,18,Bragantino,Flamengo,7/2/2021,4,2,0,0,6,4,6,0,2
2577,7230,2577.0,18,Internacional,Sport,10/2/2021,2,3,2,0,5,4,7,2,3
2578,7231,2578.0,18,Fortaleza,Vasco,10/2/2021,2,3,0,0,5,2,5,0,3
2579,7232,2579.0,18,Sao Paulo,Ceara,10/2/2021,4,4,0,0,8,4,8,0,4
2580,7233,2580.0,18,Fluminense,Atletico-MG,10/2/2021,0,1,0,0,1,0,1,0,1
2581,7234,2581.0,18,Corinthians,Athletico-PR,10/2/2021,3,0,0,0,3,3,3,0,0
2582,7235,2582.0,18,Coritiba,Palmeiras,17/2/2021,2,3,0,1,5,2,6,1,4
2583,7236,2583.0,18,Goias,Botafogo-RJ,13/2/2021,4,3,0,1,7,4,8,1,4
2584,7237,2584.0,18,Atletico-MG,Bahia,13/2/2021,1,1,0,0,2,1,2,0,1
2585,7238,2585.0,18,Santos,Coritiba,13/2/2021,0,4,0,0,4,0,4,0,4
2586,7239,2586.0,18,Flamengo,Corinthians,14/2/2021,1,5,0,0,6,1,6,0,5
2587,7240,2587.0,18,Vasco,Internacional,14/2/2021,1,6,0,0,7,1,7,0,6
2588,7241,2588.0,18,Athletico-PR,Atletico-GO,14/2/2021,3,1,0,0,4,3,4,0,1
2589,7242,2589.0,18,Palmeiras,Fortaleza,14/2/2021,0,3,0,0,3,0,3,0,3
2590,7243,2590.0,18,Gremio,Sao Paulo,14/2/2021,5,4,1,0,9,6,10,1,4
2591,7244,2591.0,18,Ceara,Fluminense,15/2/2021,1,1,0,0,2,1,2,0,1
2592,7245,2592.0,18,Sport,Bragantino,15/2/2021,3,0,0,0,3,3,3,0,0
2593,7246,2593.0,18,Coritiba,Ceara,20/2/2021,1,0,0,0,1,1,1,0,0
2594,7247,2594.0,18,Fortaleza,Bahia,20/2/2021,4,3,1,0,7,5,8,1,3
2595,7248,2595.0,18,Sport,Atletico-MG,21/2/2021,4,4,0,0,8,4,8,0,4
2596,7249,2596.0,18,Corinthians,Vasco,21/2/2021,1,2,0,0,3,1,3,0,2
2597,7250,2597.0,18,Flamengo,Internacional,21/2/2021,4,0,0,1,4,4,5,1,1
2598,7251,2598.0,18,Santos,Fluminense,21/2/2021,3,4,0,1,7,3,8,1,5
2599,7252,2599.0,18,Gremio,Athletico-PR,21/2/2021,3,1,0,2,4,3,6,2,3
2600,7253,2600.0,18,Goias,Bragantino,21/2/2021,2,0,0,0,2,2,2,0,0
2601,7254,2601.0,18,Palmeiras,Atletico-GO,22/2/2021,2,1,0,0,3,2,3,0,1
2602,7255,2602.0,18,Botafogo-RJ,Sao Paulo,22/2/2021,3,5,0,1,8,3,9,1,6
2603,7256,2603.0,18,Bragantino,Gremio,25/2/2021,4,0,0,0,4,4,4,0,0
2604,7258,2604.0,18,Athletico-PR,Sport,25/2/2021,0,1,0,0,1,0,1,0,1
2605,7259,2605.0,18,Atletico-GO,Coritiba,25/2/2021,0,1,0,0,1,0,1,0,1
2606,7260,2606.0,18,Internacional,Corinthians,25/2/2021,0,2,0,0,2,0,2,0,2
2607,7261,2607.0,18,Ceara,Botafogo-RJ,25/2/2021,3,0,1,0,3,4,4,1,0
2608,7262,2608.0,18,Sao Paulo,Flamengo,25/2/2021,6,3,0,0,9,6,9,0,3
2609,7263,2609.0,18,Atletico-MG,Palmeiras,25/2/2021,3,0,0,0,3,3,3,0,0
2610,7264,2610.0,18,Vasco,Goias,25/2/2021,1,2,0,0,3,1,3,0,2
2611,7266,2611.0,19,Cuiaba,Juventude,29/5/2021,1,3,0,0,4,1,4,0,3
2612,7267,2612.0,19,Bahia,Santos,29/5/2021,3,3,0,0,6,3,6,0,3
2613,7268,2613.0,19,Sao Paulo,Fluminense,29/5/2021,1,2,0,0,3,1,3,0,2
2614,7269,2614.0,19,Atletico-MG,Fortaleza,30/5/2021,2,4,0,0,6,2,6,0,4
2615,7270,2615.0,19,Flamengo,Palmeiras,30/5/2021,2,3,0,0,5,2,5,0,3
2616,7271,2616.0,19,Ceara,Gremio,30/5/2021,3,3,0,0,6,3,6,0,3
2617,7272,2617.0,19,Corinthians,Atletico-GO,30/5/2021,5,3,0,0,8,5,8,0,3
2618,7273,2618.0,19,Chapecoense,Bragantino,30/5/2021,1,0,0,0,1,1,1,0,0
2619,7274,2619.0,19,Athletico-PR,America-MG,30/5/2021,1,2,0,0,3,1,3,0,2
2620,7275,2620.0,19,Internacional,Sport,30/5/2021,4,2,0,0,6,4,6,0,2
2621,7276,2621.0,19,Atletico-GO,Sao Paulo,5/6/2021,4,5,0,0,9,4,9,0,5
2622,7277,2622.0,19,Santos,Ceara,5/6/2021,3,1,0,0,4,3,4,0,1
2623,7278,2623.0,19,Bragantino,Bahia,5/6/2021,2,4,0,0,6,2,6,0,4
2624,7279,2624.0,19,Fluminense,Cuiaba,6/6/2021,2,1,0,0,3,2,3,0,1
2625,7280,2625.0,19,America-MG,Corinthians,6/6/2021,2,3,0,0,5,2,5,0,3
2626,7281,2626.0,19,Fortaleza,Internacional,6/6/2021,1,4,0,2,5,1,7,2,6
2627,7282,2627.0,19,Juventude,Athletico-PR,6/6/2021,0,2,0,0,2,0,2,0,2
2628,7283,2628.0,19,Palmeiras,Chapecoense,6/6/2021,2,0,0,0,2,2,2,0,0
2629,7284,2629.0,19,Sport,Atletico-MG,6/6/2021,3,2,0,0,5,3,5,0,2
2630,7285,2630.0,19,Gremio,Flamengo,23/11/2021,3,2,2,0,5,5,7,2,2
2631,7286,2631.0,19,Santos,Juventude,12/6/2021,2,3,0,0,5,2,5,0,3
2632,7287,2632.0,19,Palmeiras,Corinthians,12/6/2021,3,0,0,0,3,3,3,0,0
2633,7288,2633.0,19,Atletico-MG,Sao Paulo,13/6/2021,0,1,0,0,1,0,1,0,1
2634,7289,2634.0,19,Gremio,Athletico-PR,13/6/2021,5,4,0,0,9,5,9,0,4
2635,7291,2635.0,19,Bahia,Internacional,13/6/2021,4,4,0,1,8,4,9,1,5
2636,7292,2636.0,19,Fortaleza,Sport,13/6/2021,3,3,0,1,6,3,7,1,4
2637,7293,2637.0,19,Bragantino,Fluminense,13/6/2021,3,1,0,0,4,3,4,0,1
2638,7294,2638.0,19,Chapecoense,Ceara,13/6/2021,2,2,0,0,4,2,4,0,2
2639,7295,2639.0,19,Cuiaba,Atletico-GO,21/7/2021,5,4,0,1,9,5,10,1,5
2640,7296,2640.0,19,Internacional,Atletico-MG,16/6/2021,3,1,0,0,4,3,4,0,1
2641,7297,2641.0,19,Sao Paulo,Chapecoense,16/6/2021,3,2,1,0,5,4,6,1,2
2642,7298,2642.0,19,Corinthians,Bragantino,16/6/2021,2,0,0,0,2,2,2,0,0
2643,7299,2643.0,19,Juventude,Palmeiras,16/6/2021,0,3,0,0,3,0,3,0,3
2644,7300,2644.0,19,America-MG,Cuiaba,17/6/2021,1,1,0,0,2,1,2,0,1
2645,7301,2645.0,19,Ceara,Bahia,17/6/2021,3,5,0,0,8,3,8,0,5
2646,7302,2646.0,19,Sport,Gremio,17/6/2021,5,4,0,0,9,5,9,0,4
2647,7303,2647.0,19,Atletico-GO,Fortaleza,17/6/2021,3,1,0,0,4,3,4,0,1
2648,7304,2648.0,19,Fluminense,Santos,17/6/2021,4,3,0,0,7,4,7,0,3
2649,7305,2649.0,19,Athletico-PR,Flamengo,2/11/2021,4,2,0,0,6,4,6,0,2
2650,7306,2650.0,19,Flamengo,Bragantino,19/6/2021,2,3,0,0,5,2,5,0,3
2651,7307,2651.0,19,Palmeiras,America-MG,20/6/2021,3,4,0,0,7,3,7,0,4
2652,7308,2652.0,19,Bahia,Corinthians,20/6/2021,1,3,0,0,4,1,4,0,3
2653,7309,2653.0,19,Internacional,Ceara,20/6/2021,2,3,0,0,5,2,5,0,3
2654,7310,2654.0,19,Fortaleza,Fluminense,20/6/2021,3,0,0,0,3,3,3,0,0
2655,7311,2655.0,19,Athletico-PR,Atletico-GO,20/6/2021,2,2,0,0,4,2,4,0,2
2656,7312,2656.0,19,Santos,Sao Paulo,20/6/2021,2,4,0,0,6,2,6,0,4
2657,7313,2657.0,19,Juventude,Sport,20/6/2021,4,0,0,0,4,4,4,0,0
2658,7314,2658.0,19,Atletico-MG,Chapecoense,21/6/2021,1,1,0,0,2,1,2,0,1
2659,7315,2659.0,19,Cuiaba,Gremio,18/8/2021,1,5,0,0,6,1,6,0,5
2660,7316,2660.0,19,Atletico-GO,Fluminense,23/6/2021,3,3,0,0,6,3,6,0,3
2661,7317,2661.0,19,Sao Paulo,Cuiaba,23/6/2021,1,1,0,0,2,1,2,0,1
2662,7318,2662.0,19,Flamengo,Fortaleza,23/6/2021,1,1,0,0,2,1,2,0,1
2663,7319,2663.0,19,Bragantino,Palmeiras,23/6/2021,3,3,0,0,6,3,6,0,3
2664,7320,2664.0,19,America-MG,Juventude,24/6/2021,2,2,1,0,4,3,5,1,2
2665,7321,2665.0,19,Chapecoense,Internacional,24/6/2021,2,3,1,2,5,3,8,3,5
2666,7322,2666.0,19,Corinthians,Sport,24/6/2021,0,3,0,0,3,0,3,0,3
2667,7323,2667.0,19,Ceara,Atletico-MG,24/6/2021,3,4,0,0,7,3,7,0,4
2668,7324,2668.0,19,Bahia,Athletico-PR,24/6/2021,2,1,0,2,3,2,5,2,3
2669,7325,2669.0,19,Gremio,Santos,24/6/2021,2,3,0,0,5,2,5,0,3
2670,7326,2670.0,19,Juventude,Flamengo,27/6/2021,2,1,0,0,3,2,3,0,1
2671,7327,2671.0,19,Fluminense,Corinthians,27/6/2021,3,1,1,0,4,4,5,1,1
2672,7328,2672.0,19,Palmeiras,Bahia,27/6/2021,3,4,0,0,7,3,7,0,4
2673,7329,2673.0,19,Athletico-PR,Chapecoense,27/6/2021,1,1,0,0,2,1,2,0,1
2674,7330,2674.0,19,Gremio,Fortaleza,27/6/2021,2,4,1,0,6,3,7,1,4
2675,7331,2675.0,19,Santos,Atletico-MG,27/6/2021,4,3,0,1,7,4,8,1,4
2676,7332,2676.0,19,America-MG,Internacional,27/6/2021,2,3,0,0,5,2,5,0,3
2677,7333,2677.0,19,Sport,Cuiaba,27/6/2021,0,1,0,0,1,0,1,0,1
2678,7334,2678.0,19,Ceara,Sao Paulo,27/6/2021,4,6,0,0,10,4,10,0,6
2679,7335,2679.0,19,Atletico-GO,Bragantino,28/6/2021,2,2,0,0,4,2,4,0,2
2680,7336,2680.0,19,Fluminense,Athletico-PR,30/6/2021,1,2,0,0,3,1,3,0,2
2681,7337,2681.0,19,Fortaleza,Chapecoense,30/6/2021,3,3,1,0,6,4,7,1,3
2682,7338,2682.0,19,Internacional,Palmeiras,30/6/2021,3,2,0,1,5,3,6,1,3
2683,7339,2683.0,19,Bahia,America-MG,30/6/2021,4,0,0,0,4,4,4,0,0
2684,7340,2684.0,19,Santos,Sport,30/6/2021,1,4,0,0,5,1,5,0,4
2685,7341,2685.0,19,Corinthians,Sao Paulo,30/6/2021,1,1,0,0,2,1,2,0,1
2686,7342,2686.0,19,Juventude,Gremio,30/6/2021,3,0,0,0,3,3,3,0,0
2687,7343,2687.0,19,Bragantino,Ceara,1/7/2021,1,3,0,1,4,1,5,1,4
2688,7344,2688.0,19,Atletico-MG,Atletico-GO,1/7/2021,0,2,0,0,2,0,2,0,2
2689,7345,2689.0,19,Cuiaba,Flamengo,1/7/2021,3,5,0,0,8,3,8,0,5
2690,7346,2690.0,19,Athletico-PR,Fortaleza,3/7/2021,3,3,0,0,6,3,6,0,3
2691,7347,2691.0,19,America-MG,Santos,3/7/2021,4,3,0,0,7,4,7,0,3
2692,7348,2692.0,19,Corinthians,Internacional,3/7/2021,2,2,0,0,4,2,4,0,2
2693,7349,2693.0,19,Chapecoense,Bahia,4/7/2021,2,1,0,0,3,2,3,0,1
2694,7350,2694.0,19,Flamengo,Fluminense,4/7/2021,2,1,0,0,3,2,3,0,1
2695,7351,2695.0,19,Sport,Palmeiras,4/7/2021,2,1,0,0,3,2,3,0,1
2696,7352,2696.0,19,Ceara,Juventude,4/7/2021,2,2,0,1,4,2,5,1,3
2697,7353,2697.0,19,Sao Paulo,Bragantino,4/7/2021,1,2,0,0,3,1,3,0,2
2698,7354,2698.0,19,Cuiaba,Atletico-MG,4/7/2021,5,2,0,0,7,5,7,0,2
2699,7355,2699.0,19,Gremio,Atletico-GO,4/7/2021,3,0,0,0,3,3,3,0,0
2700,7356,2700.0,19,Santos,Athletico-PR,6/7/2021,2,2,0,0,4,2,4,0,2
2701,7357,2701.0,19,Bahia,Juventude,7/7/2021,2,3,0,0,5,2,5,0,3
2702,7358,2702.0,19,Bragantino,Cuiaba,7/7/2021,3,2,0,0,5,3,5,0,2
2703,7359,2703.0,19,Fortaleza,America-MG,7/7/2021,2,1,0,0,3,2,3,0,1
2704,7360,2704.0,19,Palmeiras,Gremio,7/7/2021,2,2,0,0,4,2,4,0,2
2705,7361,2705.0,19,Atletico-MG,Flamengo,7/7/2021,1,1,0,0,2,1,2,0,1
2706,7362,2706.0,19,Atletico-GO,Sport,7/7/2021,4,1,0,0,5,4,5,0,1
2707,7363,2707.0,19,Internacional,Sao Paulo,7/7/2021,2,3,0,0,5,2,5,0,3
2708,7364,2708.0,19,Fluminense,Ceara,7/7/2021,2,3,0,0,5,2,5,0,3
2709,7365,2709.0,19,Chapecoense,Corinthians,8/7/2021,3,0,0,0,3,3,3,0,0
2710,7366,2710.0,19,Palmeiras,Santos,10/7/2021,1,6,0,0,7,1,7,0,6
2711,7367,2711.0,19,Gremio,Internacional,10/7/2021,1,2,0,0,3,1,3,0,2
2712,7368,2712.0,19,Athletico-PR,Bragantino,10/7/2021,0,4,0,0,4,0,4,0,4
2713,7369,2713.0,19,Sport,Fluminense,10/7/2021,1,3,0,0,4,1,4,0,3
2714,7370,2714.0,19,Sao Paulo,Bahia,10/7/2021,0,1,0,0,1,0,1,0,1
2715,7371,2715.0,19,America-MG,Atletico-MG,10/7/2021,1,1,0,0,2,1,2,0,1
2716,7372,2716.0,19,Juventude,Atletico-GO,11/7/2021,2,2,0,0,4,2,4,0,2
2717,7373,2717.0,19,Cuiaba,Ceara,11/7/2021,1,2,1,0,3,2,4,1,2
2718,7374,2718.0,19,Flamengo,Chapecoense,11/7/2021,3,3,0,0,6,3,6,0,3
2719,7375,2719.0,19,Fortaleza,Corinthians,11/7/2021,4,3,0,0,7,4,7,0,3
2720,7376,2720.0,19,Ceara,Athletico-PR,17/7/2021,4,3,0,0,7,4,7,0,3
2721,7377,2721.0,19,Sao Paulo,Fortaleza,17/7/2021,3,2,0,0,5,3,5,0,2
2722,7378,2722.0,19,Corinthians,Atletico-MG,17/7/2021,0,2,0,0,2,0,2,0,2
2723,7379,2723.0,19,Fluminense,Gremio,17/7/2021,1,4,0,0,5,1,5,0,4
2724,7380,2724.0,19,Chapecoense,Cuiaba,18/7/2021,2,2,0,0,4,2,4,0,2
2725,7381,2725.0,19,Atletico-GO,Palmeiras,18/7/2021,2,1,0,0,3,2,3,0,1
2726,7382,2726.0,19,Bahia,Flamengo,18/7/2021,5,1,0,0,6,5,6,0,1
2727,7383,2727.0,19,Internacional,Juventude,18/7/2021,4,4,0,1,8,4,9,1,5
2728,7384,2728.0,19,Bragantino,Santos,18/7/2021,3,6,0,0,9,3,9,0,6
2729,7385,2729.0,19,America-MG,Sport,19/7/2021,1,3,0,0,4,1,4,0,3
2730,7386,2730.0,19,Gremio,America-MG,24/7/2021,3,3,0,0,6,3,6,0,3
2731,7387,2731.0,19,Palmeiras,Fluminense,24/7/2021,1,2,0,0,3,1,3,0,2
2732,7388,2732.0,19,Atletico-MG,Bahia,25/7/2021,2,1,0,0,3,2,3,0,1
2733,7389,2733.0,19,Fortaleza,Bragantino,25/7/2021,4,2,0,0,6,4,6,0,2
2734,7390,2734.0,19,Flamengo,Sao Paulo,25/7/2021,3,6,0,0,9,3,9,0,6
2735,7391,2735.0,19,Santos,Atletico-GO,25/7/2021,2,2,0,0,4,2,4,0,2
2736,7392,2736.0,19,Athletico-PR,Internacional,25/7/2021,4,3,0,0,7,4,7,0,3
2737,7393,2737.0,19,Sport,Ceara,25/7/2021,4,1,0,0,5,4,5,0,1
2738,7394,2738.0,19,Juventude,Chapecoense,26/7/2021,5,1,0,0,6,5,6,0,1
2739,7395,2739.0,19,Cuiaba,Corinthians,26/7/2021,2,1,1,0,3,3,4,1,1
2740,7396,2740.0,19,Sao Paulo,Palmeiras,31/7/2021,3,3,1,0,6,4,7,1,3
2741,7397,2741.0,19,Internacional,Cuiaba,31/7/2021,2,3,1,0,5,3,6,1,3
2742,7398,2742.0,19,Bragantino,Gremio,31/7/2021,1,2,0,0,3,1,3,0,2
2743,7399,2743.0,19,Corinthians,Flamengo,1/8/2021,1,1,0,0,2,1,2,0,1
2744,7400,2744.0,19,Atletico-MG,Athletico-PR,1/8/2021,3,3,1,0,6,4,7,1,3
2745,7402,2745.0,19,Bahia,Sport,1/8/2021,2,3,0,0,5,2,5,0,3
2746,7403,2746.0,19,Atletico-GO,America-MG,1/8/2021,4,0,0,0,4,4,4,0,0
2747,7404,2747.0,19,Ceara,Fortaleza,1/8/2021,2,3,0,0,5,2,5,0,3
2748,7405,2748.0,19,Fluminense,Juventude,2/9/2021,2,1,0,0,3,2,3,0,1
2749,7406,2749.0,19,Sport,Bragantino,6/8/2021,3,1,0,0,4,3,4,0,1
2750,7407,2750.0,19,Athletico-PR,Sao Paulo,7/8/2021,2,4,0,1,6,2,7,1,5
2751,7408,2751.0,19,Palmeiras,Fortaleza,7/8/2021,5,2,1,1,7,6,9,2,3
2752,7409,2752.0,19,Cuiaba,Bahia,7/8/2021,1,2,1,0,3,2,4,1,2
2753,7410,2753.0,19,Juventude,Atletico-MG,8/8/2021,1,3,0,0,4,1,4,0,3
2754,7411,2754.0,19,America-MG,Fluminense,8/8/2021,2,2,0,0,4,2,4,0,2
2755,7412,2755.0,19,Santos,Corinthians,8/8/2021,1,1,0,0,2,1,2,0,1
2756,7413,2756.0,19,Ceara,Atletico-GO,8/8/2021,2,2,0,0,4,2,4,0,2
2757,7414,2757.0,19,Flamengo,Internacional,8/8/2021,2,2,1,0,4,3,5,1,2
2758,7415,2758.0,19,Gremio,Chapecoense,9/8/2021,1,3,0,0,4,1,4,0,3
2759,7416,2759.0,19,Bragantino,Juventude,14/8/2021,4,4,0,0,8,4,8,0,4
2760,7417,2760.0,19,Atletico-MG,Palmeiras,14/8/2021,2,1,0,1,3,2,4,1,2
2761,7418,2761.0,19,Sao Paulo,Gremio,14/8/2021,3,1,0,0,4,3,4,0,1
2762,7419,2762.0,19,Flamengo,Sport,15/8/2021,4,1,0,0,5,4,5,0,1
2763,7420,2763.0,19,Corinthians,Ceara,15/8/2021,1,1,0,0,2,1,2,0,1
2764,7421,2764.0,19,Bahia,Atletico-GO,15/8/2021,2,0,0,0,2,2,2,0,0
2765,7422,2765.0,19,Cuiaba,Athletico-PR,15/8/2021,1,1,0,0,2,1,2,0,1
2766,7423,2766.0,19,Fortaleza,Santos,15/8/2021,2,1,0,0,3,2,3,0,1
2767,7424,2767.0,19,Internacional,Fluminense,15/8/2021,2,0,0,0,2,2,2,0,0
2768,7425,2768.0,19,Chapecoense,America-MG,16/8/2021,1,1,1,0,2,2,3,1,1
2769,7426,2769.0,19,Atletico-GO,Chapecoense,21/8/2021,2,5,1,0,7,3,8,1,5
2770,7427,2770.0,19,Gremio,Bahia,21/8/2021,1,1,0,0,2,1,2,0,1
2771,7428,2771.0,19,Juventude,Fortaleza,21/8/2021,1,1,0,0,2,1,2,0,1
2772,7429,2772.0,19,Palmeiras,Cuiaba,22/8/2021,1,1,0,0,2,1,2,0,1
2773,7430,2773.0,19,Ceara,Flamengo,22/8/2021,0,2,0,0,2,0,2,0,2
2774,7431,2774.0,19,Athletico-PR,Corinthians,22/8/2021,1,0,1,0,1,2,2,1,0
2775,7432,2775.0,19,Santos,Internacional,22/8/2021,2,2,0,0,4,2,4,0,2
2776,7433,2776.0,19,Sport,Sao Paulo,22/8/2021,2,2,0,0,4,2,4,0,2
2777,7434,2777.0,19,America-MG,Bragantino,23/8/2021,2,0,0,0,2,2,2,0,0
2778,7435,2778.0,19,Fluminense,Atletico-MG,23/8/2021,3,3,0,0,6,3,6,0,3
2779,7436,2779.0,19,Sport,Chapecoense,28/8/2021,1,1,1,0,2,2,3,1,1
2780,7437,2780.0,19,Santos,Flamengo,28/8/2021,4,4,0,0,8,4,8,0,4
2781,7438,2781.0,19,Gremio,Corinthians,28/8/2021,1,2,1,0,3,2,4,1,2
2782,7439,2782.0,19,Palmeiras,Athletico-PR,28/8/2021,3,0,0,0,3,3,3,0,0
2783,7440,2783.0,19,America-MG,Ceara,29/8/2021,1,2,0,0,3,1,3,0,2
2784,7441,2784.0,19,Juventude,Sao Paulo,29/8/2021,2,5,0,0,7,2,7,0,5
2785,7442,2785.0,19,Atletico-GO,Internacional,29/8/2021,1,2,0,0,3,1,3,0,2
2786,7443,2786.0,19,Bragantino,Atletico-MG,29/8/2021,3,4,0,0,7,3,7,0,4
2787,7444,2787.0,19,Fluminense,Bahia,30/8/2021,2,4,0,0,6,2,6,0,4
2788,7445,2788.0,19,Fortaleza,Cuiaba,30/8/2021,2,5,0,0,7,2,7,0,5
2789,7446,2789.0,19,Bahia,Fortaleza,4/9/2021,3,1,0,0,4,3,4,0,1
2790,7447,2790.0,19,Cuiaba,Santos,4/9/2021,3,1,0,0,4,3,4,0,1
2791,7448,2791.0,19,Athletico-PR,Sport,5/9/2021,1,2,0,1,3,1,4,1,3
2792,7449,2792.0,19,Corinthians,Juventude,7/9/2021,3,4,0,0,7,3,7,0,4
2793,7451,2793.0,19,Sao Paulo,America-MG,22/9/2021,3,1,0,0,4,3,4,0,1
2794,7452,2794.0,19,Ceara,Palmeiras,20/10/2021,4,2,0,0,6,4,6,0,2
2795,7453,2795.0,19,Internacional,Bragantino,21/10/2021,5,2,0,0,7,5,7,0,2
2796,7454,2796.0,19,Atletico-MG,Gremio,3/11/2021,5,6,0,0,11,5,11,0,6
2797,7455,2797.0,19,Flamengo,Atletico-GO,5/11/2021,2,1,0,0,3,2,3,0,1
2798,7456,2798.0,19,America-MG,Athletico-PR,11/9/2021,1,1,0,0,2,1,2,0,1
2799,7457,2799.0,19,Juventude,Cuiaba,11/9/2021,3,5,0,1,8,3,9,1,6
2800,7458,2800.0,19,Bragantino,Chapecoense,11/9/2021,4,2,1,0,6,5,7,1,2
2801,7459,2801.0,19,Santos,Bahia,11/9/2021,1,4,0,0,5,1,5,0,4
2802,7461,2802.0,19,Fortaleza,Atletico-MG,12/9/2021,1,2,0,0,3,1,3,0,2
2803,7462,2803.0,19,Palmeiras,Flamengo,12/9/2021,0,2,1,0,2,1,3,1,2
2804,7463,2804.0,19,Atletico-GO,Corinthians,12/9/2021,4,2,0,0,6,4,6,0,2
2805,7464,2805.0,19,Fluminense,Sao Paulo,12/9/2021,5,4,0,0,9,5,9,0,4
2806,7465,2806.0,19,Sport,Internacional,13/9/2021,4,1,0,0,5,4,5,0,1
2807,7466,2807.0,19,Chapecoense,Palmeiras,18/9/2021,2,2,0,0,4,2,4,0,2
2808,7467,2808.0,19,Athletico-PR,Juventude,18/9/2021,5,1,0,1,6,5,7,1,2
2809,7468,2809.0,19,Atletico-MG,Sport,18/9/2021,2,3,0,0,5,2,5,0,3
2810,7469,2810.0,19,Bahia,Bragantino,18/9/2021,1,4,0,0,5,1,5,0,4
2811,7470,2811.0,19,Ceara,Santos,18/9/2021,3,2,0,0,5,3,5,0,2
2812,7471,2812.0,19,Internacional,Fortaleza,19/9/2021,3,1,1,1,4,4,6,2,2
2813,7472,2813.0,19,Sao Paulo,Atletico-GO,19/9/2021,1,2,0,0,3,1,3,0,2
2814,7473,2814.0,19,Corinthians,America-MG,19/9/2021,1,0,1,0,1,2,2,1,0
2815,7474,2815.0,19,Flamengo,Gremio,19/9/2021,3,4,0,0,7,3,7,0,4
2816,7475,2816.0,19,Cuiaba,Fluminense,20/9/2021,2,2,1,0,4,3,5,1,2
2817,7476,2817.0,19,Ceara,Chapecoense,25/9/2021,0,3,0,1,3,0,4,1,4
2818,7477,2818.0,19,Corinthians,Palmeiras,25/9/2021,1,1,0,0,2,1,2,0,1
2819,7478,2819.0,19,Sao Paulo,Atletico-MG,25/9/2021,1,1,0,0,2,1,2,0,1
2820,7479,2820.0,19,America-MG,Flamengo,26/9/2021,1,1,0,0,2,1,2,0,1
2821,7480,2821.0,19,Internacional,Bahia,26/9/2021,2,2,0,0,4,2,4,0,2
2822,7481,2822.0,19,Fluminense,Bragantino,26/9/2021,2,2,0,0,4,2,4,0,2
2823,7482,2823.0,19,Juventude,Santos,26/9/2021,3,0,0,0,3,3,3,0,0
2824,7483,2824.0,19,Sport,Fortaleza,26/9/2021,5,2,0,0,7,5,7,0,2
2825,7484,2825.0,19,Athletico-PR,Gremio,26/9/2021,1,5,0,0,6,1,6,0,5
2826,7485,2826.0,19,Atletico-GO,Cuiaba,26/9/2021,1,4,0,0,5,1,5,0,4
2827,7486,2827.0,19,Cuiaba,America-MG,2/10/2021,1,2,0,0,3,1,3,0,2
2828,7487,2828.0,19,Fortaleza,Atletico-GO,2/10/2021,1,4,0,0,5,1,5,0,4
2829,7489,2829.0,19,Atletico-MG,Internacional,2/10/2021,4,2,0,0,6,4,6,0,2
2830,7490,2830.0,19,Flamengo,Athletico-PR,3/10/2021,2,2,0,0,4,2,4,0,2
2831,7491,2831.0,19,Chapecoense,Sao Paulo,3/10/2021,1,1,0,0,2,1,2,0,1
2832,7492,2832.0,19,Palmeiras,Juventude,3/10/2021,1,1,0,0,2,1,2,0,1
2833,7493,2833.0,19,Gremio,Sport,3/10/2021,2,1,0,0,3,2,3,0,1
2834,7494,2834.0,19,Santos,Fluminense,27/10/2021,2,2,0,0,4,2,4,0,2
2835,7495,2835.0,19,Bahia,Ceara,27/10/2021,3,2,0,1,5,3,6,1,3
2836,7496,2836.0,19,Corinthians,Bahia,5/10/2021,0,1,0,1,1,0,2,1,2
2837,7497,2837.0,19,Chapecoense,Atletico-MG,6/10/2021,2,1,0,0,3,2,3,0,1
2838,7498,2838.0,19,Atletico-GO,Athletico-PR,6/10/2021,3,3,0,0,6,3,6,0,3
2839,7499,2839.0,19,Sport,Juventude,6/10/2021,2,2,0,0,4,2,4,0,2
2840,7500,2840.0,19,Ceara,Internacional,6/10/2021,5,2,0,0,7,5,7,0,2
2841,7501,2841.0,19,Bragantino,Flamengo,6/10/2021,1,3,0,0,4,1,4,0,3
2842,7502,2842.0,19,Fluminense,Fortaleza,6/10/2021,2,2,0,0,4,2,4,0,2
2843,7503,2843.0,19,America-MG,Palmeiras,6/10/2021,2,3,0,0,5,2,5,0,3
2844,7504,2844.0,19,Gremio,Cuiaba,6/10/2021,2,2,0,0,4,2,4,0,2
2845,7505,2845.0,19,Sao Paulo,Santos,7/10/2021,2,4,0,0,6,2,6,0,4
2846,7506,2846.0,19,Fluminense,Atletico-GO,9/10/2021,2,2,0,0,4,2,4,0,2
2847,7507,2847.0,19,Atletico-MG,Ceara,9/10/2021,1,3,0,0,4,1,4,0,3
2848,7508,2848.0,19,Sport,Corinthians,9/10/2021,3,0,0,0,3,3,3,0,0
2849,7509,2849.0,19,Fortaleza,Flamengo,9/10/2021,0,2,1,0,2,1,3,1,2
2850,7510,2850.0,19,Athletico-PR,Bahia,9/10/2021,1,2,0,0,3,1,3,0,2
2851,7511,2851.0,19,Palmeiras,Bragantino,9/10/2021,1,2,0,0,3,1,3,0,2
2852,7512,2852.0,19,Juventude,America-MG,9/10/2021,6,3,0,0,9,6,9,0,3
2853,7513,2853.0,19,Internacional,Chapecoense,10/10/2021,3,1,0,0,4,3,4,0,1
2854,7514,2854.0,19,Santos,Gremio,10/10/2021,4,6,0,1,10,4,11,1,7
2855,7515,2855.0,19,Cuiaba,Sao Paulo,11/10/2021,2,2,0,0,4,2,4,0,2
2856,7516,2856.0,19,Bragantino,Atletico-GO,12/10/2021,2,4,1,0,6,3,7,1,4
2857,7517,2857.0,19,Bahia,Palmeiras,12/10/2021,4,2,0,1,6,4,7,1,3
2858,7518,2858.0,19,Atletico-MG,Santos,13/10/2021,2,7,0,0,9,2,9,0,7
2859,7519,2859.0,19,Chapecoense,Athletico-PR,13/10/2021,4,5,0,0,9,4,9,0,5
2860,7520,2860.0,19,Flamengo,Juventude,13/10/2021,2,3,0,0,5,2,5,0,3
2861,7521,2861.0,19,Fortaleza,Gremio,13/10/2021,2,2,0,0,4,2,4,0,2
2862,7522,2862.0,19,Corinthians,Fluminense,13/10/2021,1,1,0,0,2,1,2,0,1
2863,7523,2863.0,19,Internacional,America-MG,13/10/2021,1,2,0,0,3,1,3,0,2
2864,7524,2864.0,19,Sao Paulo,Ceara,14/10/2021,3,3,0,0,6,3,6,0,3
2865,7525,2865.0,19,Cuiaba,Sport,14/10/2021,4,0,0,0,4,4,4,0,0
2866,7526,2866.0,19,Chapecoense,Fortaleza,16/10/2021,3,1,0,0,4,3,4,0,1
2867,7527,2867.0,19,America-MG,Bahia,16/10/2021,1,2,0,0,3,1,3,0,2
2868,7528,2868.0,19,Athletico-PR,Fluminense,17/10/2021,2,1,0,0,3,2,3,0,1
2869,7529,2869.0,19,Palmeiras,Internacional,17/10/2021,3,4,0,1,7,3,8,1,5
2870,7530,2870.0,19,Ceara,Bragantino,17/10/2021,2,7,0,0,9,2,9,0,7
2871,7531,2871.0,19,Gremio,Juventude,17/10/2021,1,3,0,0,4,1,4,0,3
2872,7532,2872.0,19,Atletico-GO,Atletico-MG,17/10/2021,1,0,0,0,1,1,1,0,0
2873,7533,2873.0,19,Sport,Santos,17/10/2021,1,3,0,0,4,1,4,0,3
2874,7534,2874.0,19,Flamengo,Cuiaba,17/10/2021,1,1,0,0,2,1,2,0,1
2875,7535,2875.0,19,Sao Paulo,Corinthians,18/10/2021,3,2,0,0,5,3,5,0,2
2876,7536,2876.0,19,Santos,America-MG,23/10/2021,1,2,1,0,3,2,4,1,2
2877,7537,2877.0,19,Juventude,Ceara,23/10/2021,1,2,0,0,3,1,3,0,2
2878,7538,2878.0,19,Fluminense,Flamengo,23/10/2021,6,3,0,0,9,6,9,0,3
2879,7539,2879.0,19,Fortaleza,Athletico-PR,23/10/2021,2,2,0,0,4,2,4,0,2
2880,7540,2880.0,19,Internacional,Corinthians,24/10/2021,3,3,1,1,6,4,8,2,4
2881,7542,2881.0,19,Bragantino,Sao Paulo,24/10/2021,3,0,0,0,3,3,3,0,0
2882,7543,2882.0,19,Bahia,Chapecoense,24/10/2021,1,1,0,0,2,1,2,0,1
2883,7544,2883.0,19,Atletico-GO,Gremio,25/10/2021,2,7,0,1,9,2,10,1,8
2884,7545,2884.0,19,Palmeiras,Sport,25/10/2021,1,3,0,0,4,1,4,0,3
2885,7546,2885.0,19,Bragantino,Sport,28/10/2021,3,6,0,0,9,3,9,0,6
2886,7547,2886.0,19,Atletico-MG,Juventude,20/11/2021,1,2,0,0,3,1,3,0,2
2887,7548,2887.0,19,Fortaleza,Palmeiras,20/11/2021,3,2,0,0,5,3,5,0,2
2888,7549,2888.0,19,Chapecoense,Gremio,20/11/2021,1,1,0,0,2,1,2,0,1
2889,7550,2889.0,19,Atletico-GO,Ceara,20/11/2021,0,3,0,0,3,0,3,0,3
2890,7551,2890.0,19,Internacional,Flamengo,20/11/2021,2,1,0,0,3,2,3,0,1
2891,7552,2891.0,19,Corinthians,Santos,21/11/2021,1,0,0,0,1,1,1,0,0
2892,7553,2892.0,19,Fluminense,America-MG,21/11/2021,1,2,0,0,3,1,3,0,2
2893,7554,2893.0,19,Bahia,Cuiaba,21/11/2021,1,0,0,0,1,1,1,0,0
2894,7555,2894.0,19,Sao Paulo,Athletico-PR,24/11/2021,3,2,0,0,5,3,5,0,2
2895,7556,2895.0,19,Athletico-PR,Santos,30/10/2021,1,2,0,0,3,1,3,0,2
2896,7557,2896.0,19,Flamengo,Atletico-MG,30/10/2021,4,2,0,0,6,4,6,0,2
2897,7558,2897.0,19,Juventude,Bahia,30/10/2021,2,1,0,0,3,2,3,0,1
2898,7559,2898.0,19,America-MG,Fortaleza,30/10/2021,0,5,0,0,5,0,5,0,5
2899,7560,2899.0,19,Gremio,Palmeiras,31/10/2021,5,2,0,0,7,5,7,0,2
2900,7561,2900.0,19,Ceara,Fluminense,31/10/2021,4,2,1,0,6,5,7,1,2
2901,7562,2901.0,19,Sao Paulo,Internacional,31/10/2021,0,2,0,0,2,0,2,0,2
2902,7563,2902.0,19,Sport,Atletico-GO,31/10/2021,4,3,0,0,7,4,7,0,3
2903,7564,2903.0,19,Cuiaba,Bragantino,1/11/2021,2,3,0,0,5,2,5,0,3
2904,7565,2904.0,19,Corinthians,Chapecoense,1/11/2021,1,4,0,0,5,1,5,0,4
2905,7566,2905.0,19,Cuiaba,Chapecoense,4/11/2021,1,1,0,0,2,1,2,0,1
2906,7567,2906.0,19,Gremio,Fluminense,9/11/2021,3,1,0,0,4,3,4,0,1
2907,7568,2907.0,19,Athletico-PR,Ceara,10/11/2021,4,3,0,1,7,4,8,1,4
2908,7569,2908.0,19,Atletico-MG,Corinthians,10/11/2021,2,2,0,0,4,2,4,0,2
2909,7570,2909.0,19,Santos,Bragantino,10/11/2021,2,1,0,0,3,2,3,0,1
2910,7571,2910.0,19,Palmeiras,Atletico-GO,10/11/2021,1,3,0,0,4,1,4,0,3
2911,7572,2911.0,19,Fortaleza,Sao Paulo,10/11/2021,4,5,0,0,9,4,9,0,5
2912,7573,2912.0,19,Sport,America-MG,10/11/2021,2,3,1,0,5,3,6,1,3
2913,7574,2913.0,19,Juventude,Internacional,10/11/2021,2,4,0,0,6,2,6,0,4
2914,7575,2914.0,19,Flamengo,Bahia,11/11/2021,0,2,1,2,2,1,5,3,4
2915,7576,2915.0,19,Corinthians,Fortaleza,6/11/2021,3,3,0,0,6,3,6,0,3
2916,7577,2916.0,19,Internacional,Gremio,6/11/2021,1,3,1,1,4,2,6,2,4
2917,7578,2917.0,19,Fluminense,Sport,6/11/2021,1,1,0,0,2,1,2,0,1
2918,7579,2918.0,19,Bragantino,Athletico-PR,7/11/2021,2,3,0,0,5,2,5,0,3
2919,7580,2919.0,19,Atletico-MG,America-MG,7/11/2021,3,2,0,0,5,3,5,0,2
2920,7581,2920.0,19,Santos,Palmeiras,7/11/2021,3,2,0,0,5,3,5,0,2
2921,7582,2921.0,19,Bahia,Sao Paulo,7/11/2021,1,2,0,0,3,1,3,0,2
2922,7583,2922.0,19,Ceara,Cuiaba,7/11/2021,3,1,0,0,4,3,4,0,1
2923,7584,2923.0,19,Chapecoense,Flamengo,8/11/2021,3,3,1,1,6,4,8,2,4
2924,7585,2924.0,19,Atletico-GO,Juventude,23/11/2021,1,2,0,0,3,1,3,0,2
2925,7586,2925.0,19,Atletico-GO,Santos,13/11/2021,2,3,0,0,5,2,5,0,3
2926,7587,2926.0,19,America-MG,Gremio,13/11/2021,3,1,0,0,4,3,4,0,1
2927,7588,2927.0,19,Bragantino,Fortaleza,13/11/2021,3,4,0,0,7,3,7,0,4
2928,7589,2928.0,19,Internacional,Athletico-PR,13/11/2021,7,3,0,0,10,7,10,0,3
2929,7590,2929.0,19,Corinthians,Cuiaba,13/11/2021,1,1,0,0,2,1,2,0,1
2930,7591,2930.0,19,Sao Paulo,Flamengo,14/11/2021,1,1,1,0,2,2,3,1,1
2931,7592,2931.0,19,Fluminense,Palmeiras,14/11/2021,4,6,1,2,10,5,13,3,8
2932,7593,2932.0,19,Ceara,Sport,14/11/2021,1,2,0,0,3,1,3,0,2
2933,7594,2933.0,19,Chapecoense,Juventude,14/11/2021,3,3,0,0,6,3,6,0,3
2934,7595,2934.0,19,Bahia,Atletico-MG,2/12/2021,2,3,0,0,5,2,5,0,3
2935,7596,2935.0,19,Athletico-PR,Atletico-MG,16/11/2021,1,2,0,0,3,1,3,0,2
2936,7597,2936.0,19,Gremio,Bragantino,16/11/2021,0,2,0,0,2,0,2,0,2
2937,7598,2937.0,19,America-MG,Atletico-GO,17/11/2021,1,1,0,0,2,1,2,0,1
2938,7599,2938.0,19,Santos,Chapecoense,17/11/2021,1,2,0,0,3,1,3,0,2
2939,7600,2939.0,19,Cuiaba,Internacional,17/11/2021,4,1,0,0,5,4,5,0,1
2940,7601,2940.0,19,Fortaleza,Ceara,17/11/2021,1,4,0,0,5,1,5,0,4
2941,7602,2941.0,19,Palmeiras,Sao Paulo,17/11/2021,1,2,0,0,3,1,3,0,2
2942,7603,2942.0,19,Juventude,Fluminense,17/11/2021,2,1,0,0,3,2,3,0,1
2943,7604,2943.0,19,Flamengo,Corinthians,17/11/2021,1,2,0,0,3,1,3,0,2
2944,7605,2944.0,19,Sport,Bahia,18/11/2021,1,3,0,0,4,1,4,0,3
2945,7606,2945.0,19,Palmeiras,Atletico-MG,23/11/2021,4,3,0,0,7,4,7,0,3
2946,7607,2946.0,19,Fluminense,Internacional,24/11/2021,5,5,0,1,10,5,11,1,6
2947,7608,2947.0,19,Santos,Fortaleza,25/11/2021,3,2,0,0,5,3,5,0,2
2948,7609,2948.0,19,Ceara,Corinthians,25/11/2021,3,4,0,0,7,3,7,0,4
2949,7610,2949.0,19,Atletico-GO,Bahia,29/11/2021,5,3,0,1,8,5,9,1,4
2950,7611,2950.0,19,Juventude,Bragantino,30/11/2021,3,3,0,0,6,3,6,0,3
2951,7612,2951.0,19,America-MG,Chapecoense,30/11/2021,2,2,0,0,4,2,4,0,2
2952,7613,2952.0,19,Gremio,Sao Paulo,2/12/2021,3,2,0,0,5,3,5,0,2
2953,7614,2953.0,19,Athletico-PR,Cuiaba,3/12/2021,4,6,0,1,10,4,11,1,7
2954,7615,2954.0,19,Sport,Flamengo,3/12/2021,2,3,0,0,5,2,5,0,3
2955,7616,2955.0,19,Bahia,Gremio,26/11/2021,3,3,0,0,6,3,6,0,3
2956,7617,2956.0,19,Bragantino,America-MG,27/11/2021,3,2,0,0,5,3,5,0,2
2957,7618,2957.0,19,Sao Paulo,Sport,27/11/2021,0,1,0,0,1,0,1,0,1
2958,7619,2958.0,19,Corinthians,Athletico-PR,28/11/2021,5,3,0,0,8,5,8,0,3
2959,7620,2959.0,19,Atletico-MG,Fluminense,28/11/2021,6,3,0,0,9,6,9,0,3
2960,7621,2960.0,19,Internacional,Santos,28/11/2021,1,2,0,0,3,1,3,0,2
2961,7622,2961.0,19,Flamengo,Ceara,30/11/2021,6,1,0,0,7,6,7,0,1
2962,7623,2962.0,19,Cuiaba,Palmeiras,30/11/2021,4,2,0,1,6,4,7,1,3
2963,7624,2963.0,19,Chapecoense,Atletico-GO,3/12/2021,2,3,0,0,5,2,5,0,3
2964,7625,2964.0,19,Fortaleza,Juventude,3/12/2021,2,0,0,0,2,2,2,0,0
2965,7626,2965.0,19,Bahia,Fluminense,5/12/2021,2,5,1,1,7,3,9,2,6
2966,7627,2966.0,19,Corinthians,Gremio,5/12/2021,1,3,0,0,4,1,4,0,3
2967,7628,2967.0,19,Atletico-MG,Bragantino,5/12/2021,1,2,0,0,3,1,3,0,2
2968,7629,2968.0,19,Ceara,America-MG,5/12/2021,0,2,0,0,2,0,2,0,2
2969,7630,2969.0,19,Sao Paulo,Juventude,6/12/2021,5,3,0,0,8,5,8,0,3
2970,7631,2970.0,19,Athletico-PR,Palmeiras,6/12/2021,1,1,0,0,2,1,2,0,1
2971,7632,2971.0,19,Cuiaba,Fortaleza,6/12/2021,1,3,0,0,4,1,4,0,3
2972,7633,2972.0,19,Internacional,Atletico-GO,6/12/2021,3,2,0,0,5,3,5,0,2
2973,7634,2973.0,19,Flamengo,Santos,6/12/2021,3,3,0,0,6,3,6,0,3
2974,7635,2974.0,19,Chapecoense,Sport,6/12/2021,3,4,1,0,7,4,8,1,4
2975,7636,2975.0,19,Fortaleza,Bahia,9/12/2021,4,2,0,0,6,4,6,0,2
2976,7637,2976.0,19,Atletico-GO,Flamengo,9/12/2021,4,2,0,0,6,4,6,0,2
2977,7638,2977.0,19,Palmeiras,Ceara,9/12/2021,2,0,0,0,2,2,2,0,0
2978,7639,2978.0,19,Fluminense,Chapecoense,9/12/2021,3,2,0,0,5,3,5,0,2
2979,7640,2979.0,19,America-MG,Sao Paulo,9/12/2021,2,2,0,0,4,2,4,0,2
2980,7641,2980.0,19,Bragantino,Internacional,9/12/2021,4,5,0,0,9,4,9,0,5
2981,7642,2981.0,19,Sport,Athletico-PR,9/12/2021,1,1,0,0,2,1,2,0,1
2982,7643,2982.0,19,Juventude,Corinthians,9/12/2021,1,2,0,1,3,1,4,1,3
2983,7644,2983.0,19,Gremio,Atletico-MG,9/12/2021,3,1,0,0,4,3,4,0,1
2984,7645,2984.0,19,Santos,Cuiaba,9/12/2021,1,2,0,0,3,1,3,0,2
2985,7646,2985.0,20,Fluminense,Santos,9/4/2022,1,0,0,0,1,1,1,0,0
2986,7647,2986.0,20,Atletico-GO,Flamengo,9/4/2022,3,2,0,0,5,3,5,0,2
2987,7648,2987.0,20,Palmeiras,Ceara,9/4/2022,4,9,0,1,13,4,14,1,10
2988,7649,2988.0,20,Coritiba,Goias,10/4/2022,2,4,0,0,6,2,6,0,4
2989,7650,2989.0,20,Botafogo-RJ,Corinthians,10/4/2022,1,4,0,0,5,1,5,0,4
2990,7651,2990.0,20,Atletico-MG,Internacional,10/4/2022,2,4,0,0,6,2,6,0,4
2991,7652,2991.0,20,Fortaleza,Cuiaba,10/4/2022,2,3,0,0,5,2,5,0,3
2992,7653,2992.0,20,Avai,America-MG,10/4/2022,3,3,0,2,6,3,8,2,5
2993,7654,2993.0,20,Sao Paulo,Athletico-PR,10/4/2022,1,3,0,0,4,1,4,0,3
2994,7655,2994.0,20,Juventude,Bragantino,11/4/2022,4,5,0,0,9,4,9,0,5
2995,7656,2995.0,20,Goias,Palmeiras,16/4/2022,4,0,0,0,4,4,4,0,0
2996,7657,2996.0,20,America-MG,Juventude,16/4/2022,3,0,0,1,3,3,4,1,1
2997,7658,2997.0,20,Corinthians,Avai,16/4/2022,1,1,0,0,2,1,2,0,1
2998,7659,2998.0,20,Cuiaba,Fluminense,16/4/2022,2,1,0,0,3,2,3,0,1
2999,7660,2999.0,20,Santos,Coritiba,17/4/2022,2,4,0,0,6,2,6,0,4
3000,7661,3000.0,20,Flamengo,Sao Paulo,17/4/2022,2,6,0,0,8,2,8,0,6
3001,7662,3001.0,20,Athletico-PR,Atletico-MG,17/4/2022,2,3,0,0,5,2,5,0,3
3002,7663,3002.0,20,Internacional,Fortaleza,17/4/2022,5,5,0,0,10,5,10,0,5
3003,7664,3003.0,20,Bragantino,Atletico-GO,17/4/2022,1,4,0,0,5,1,5,0,4
3004,7665,3004.0,20,Ceara,Botafogo-RJ,17/4/2022,1,4,1,0,5,2,6,1,4
3005,7666,3005.0,20,Flamengo,Palmeiras,20/4/2022,3,4,0,0,7,3,7,0,4
3006,7667,3006.0,20,Ceara,Bragantino,30/4/2022,1,5,0,1,6,1,7,1,6
3007,7668,3007.0,20,America-MG,Athletico-PR,30/4/2022,1,0,0,0,1,1,1,0,0
3008,7669,3008.0,20,Goias,Atletico-MG,30/4/2022,5,4,0,0,9,5,9,0,4
3009,7670,3009.0,20,Cuiaba,Atletico-GO,30/4/2022,2,0,0,0,2,2,2,0,0
3010,7671,3010.0,20,Botafogo-RJ,Juventude,1/5/2022,2,5,0,0,7,2,7,0,5
3011,7672,3011.0,20,Corinthians,Fortaleza,1/5/2022,1,3,0,0,4,1,4,0,3
3012,7673,3012.0,20,Coritiba,Fluminense,1/5/2022,0,3,0,1,3,0,4,1,4
3013,7674,3013.0,20,Internacional,Avai,1/5/2022,2,4,0,0,6,2,6,0,4
3014,7675,3014.0,20,Sao Paulo,Santos,2/5/2022,2,4,0,0,6,2,6,0,4
3015,7676,3015.0,20,Bragantino,Sao Paulo,23/4/2022,5,2,0,0,7,5,7,0,2
3016,7677,3016.0,20,Athletico-PR,Flamengo,23/4/2022,4,2,0,0,6,4,6,0,2
3017,7678,3017.0,20,Palmeiras,Corinthians,23/4/2022,1,2,0,0,3,1,3,0,2
3018,7679,3018.0,20,Fluminense,Internacional,23/4/2022,5,3,0,0,8,5,8,0,3
3019,7680,3019.0,20,Atletico-MG,Coritiba,23/4/2022,2,1,0,0,3,2,3,0,1
3020,7681,3020.0,20,Santos,America-MG,24/4/2022,2,0,0,0,2,2,2,0,0
3021,7682,3021.0,20,Juventude,Cuiaba,24/4/2022,2,4,1,0,6,3,7,1,4
3022,7683,3022.0,20,Atletico-GO,Botafogo-RJ,24/4/2022,2,1,0,0,3,2,3,0,1
3023,7684,3023.0,20,Avai,Goias,25/4/2022,5,5,1,0,10,6,11,1,5
3024,7685,3024.0,20,Fortaleza,Ceara,1/6/2022,5,4,1,0,9,6,10,1,4
3025,7686,3025.0,20,Atletico-MG,America-MG,7/5/2022,4,4,0,1,8,4,9,1,5
3026,7687,3026.0,20,Athletico-PR,Ceara,7/5/2022,5,4,0,0,9,5,9,0,4
3027,7688,3027.0,20,Flamengo,Botafogo-RJ,8/5/2022,1,3,0,0,4,1,4,0,3
3028,7689,3028.0,20,Palmeiras,Fluminense,8/5/2022,1,2,0,0,3,1,3,0,2
3029,7690,3029.0,20,Atletico-GO,Goias,8/5/2022,4,3,0,1,7,4,8,1,4
3030,7691,3030.0,20,Bragantino,Corinthians,8/5/2022,1,2,0,0,3,1,3,0,2
3031,7692,3031.0,20,Santos,Cuiaba,8/5/2022,1,2,0,0,3,1,3,0,2
3032,7693,3032.0,20,Juventude,Internacional,8/5/2022,5,5,0,0,10,5,10,0,5
3033,7694,3033.0,20,Fortaleza,Sao Paulo,8/5/2022,2,3,0,0,5,2,5,0,3
3034,7695,3034.0,20,Avai,Coritiba,9/5/2022,3,3,0,0,6,3,6,0,3
3035,7696,3035.0,20,Bragantino,Atletico-MG,11/5/2022,3,2,1,0,5,4,6,1,2
3036,7697,3036.0,20,Atletico-GO,Coritiba,21/5/2022,4,1,0,2,5,4,7,2,3
3037,7698,3037.0,20,Flamengo,Goias,21/5/2022,1,3,0,0,4,1,4,0,3
3038,7699,3038.0,20,Santos,Ceara,21/5/2022,1,5,0,1,6,1,7,1,6
3039,7700,3039.0,20,Juventude,Palmeiras,21/5/2022,3,0,0,0,3,3,3,0,0
3040,7701,3040.0,20,Cuiaba,Internacional,21/5/2022,2,7,2,0,9,4,11,2,7
3041,7702,3041.0,20,America-MG,Botafogo-RJ,21/5/2022,2,1,0,0,3,2,3,0,1
3042,7703,3042.0,20,Corinthians,Sao Paulo,22/5/2022,2,3,0,0,5,2,5,0,3
3043,7704,3043.0,20,Fortaleza,Fluminense,22/5/2022,1,1,0,0,2,1,2,0,1
3044,7705,3044.0,20,Athletico-PR,Avai,22/5/2022,2,6,0,0,8,2,8,0,6
3045,7706,3045.0,20,Palmeiras,Bragantino,14/5/2022,2,2,0,0,4,2,4,0,2
3046,7707,3046.0,20,Ceara,Flamengo,14/5/2022,5,5,0,0,10,5,10,0,5
3047,7708,3047.0,20,Internacional,Corinthians,14/5/2022,2,2,0,0,4,2,4,0,2
3048,7709,3048.0,20,Atletico-MG,Atletico-GO,14/5/2022,1,2,0,0,3,1,3,0,2
3049,7710,3049.0,20,Fluminense,Athletico-PR,14/5/2022,3,2,0,0,5,3,5,0,2
3050,7711,3050.0,20,Sao Paulo,Cuiaba,15/5/2022,2,1,0,1,3,2,4,1,2
3051,7712,3051.0,20,Coritiba,America-MG,15/5/2022,1,5,0,1,6,1,7,1,6
3052,7713,3052.0,20,Botafogo-RJ,Fortaleza,15/5/2022,3,1,0,1,4,3,5,1,2
3053,7714,3053.0,20,Avai,Juventude,15/5/2022,2,5,0,2,7,2,9,2,7
3054,7716,3054.0,20,Goias,Bragantino,28/5/2022,2,3,0,1,5,2,6,1,4
3055,7717,3055.0,20,Sao Paulo,Ceara,28/5/2022,3,5,1,0,8,4,9,1,5
3056,7718,3056.0,20,Fortaleza,Juventude,28/5/2022,2,3,0,0,5,2,5,0,3
3057,7719,3057.0,20,Coritiba,Botafogo-RJ,29/5/2022,5,3,0,0,8,5,8,0,3
3058,7720,3058.0,20,Santos,Palmeiras,29/5/2022,5,1,0,0,6,5,6,0,1
3059,7721,3059.0,20,Cuiaba,Athletico-PR,29/5/2022,5,0,0,0,5,5,5,0,0
3060,7722,3060.0,20,Corinthians,America-MG,29/5/2022,2,1,0,0,3,2,3,0,1
3061,7723,3061.0,20,Fluminense,Flamengo,29/5/2022,3,5,1,1,8,4,10,2,6
3062,7724,3062.0,20,Atletico-MG,Avai,29/5/2022,3,2,0,1,5,3,6,1,3
3063,7725,3063.0,20,Internacional,Atletico-GO,30/5/2022,1,2,0,0,3,1,3,0,2
3064,7726,3064.0,20,America-MG,Cuiaba,4/6/2022,0,1,0,0,1,0,1,0,1
3065,7727,3065.0,20,Athletico-PR,Santos,4/6/2022,5,3,0,0,8,5,8,0,3
3066,7728,3066.0,20,Ceara,Coritiba,4/6/2022,1,4,0,0,5,1,5,0,4
3067,7729,3067.0,20,Avai,Sao Paulo,4/6/2022,2,2,0,0,4,2,4,0,2
3068,7730,3068.0,20,Atletico-GO,Corinthians,4/6/2022,3,3,0,0,6,3,6,0,3
3069,7731,3069.0,20,Juventude,Fluminense,5/6/2022,3,4,0,1,7,3,8,1,5
3070,7732,3070.0,20,Flamengo,Fortaleza,5/6/2022,3,4,0,0,7,3,7,0,4
3071,7733,3071.0,20,Palmeiras,Atletico-MG,5/6/2022,1,3,0,0,4,1,4,0,3
3072,7734,3072.0,20,Bragantino,Internacional,5/6/2022,3,3,0,0,6,3,6,0,3
3073,7735,3073.0,20,Botafogo-RJ,Goias,6/6/2022,2,2,0,0,4,2,4,0,2
3074,7736,3074.0,20,Cuiaba,Corinthians,7/6/2022,1,2,1,0,3,2,4,1,2
3075,7737,3075.0,20,America-MG,Ceara,8/6/2022,2,3,0,0,5,2,5,0,3
3076,7738,3076.0,20,Juventude,Athletico-PR,8/6/2022,2,4,0,0,6,2,6,0,4
3077,7739,3077.0,20,Atletico-GO,Avai,8/6/2022,1,4,0,1,5,1,6,1,5
3078,7740,3078.0,20,Bragantino,Flamengo,8/6/2022,1,4,1,0,5,2,6,1,4
3079,7741,3079.0,20,Fluminense,Atletico-MG,8/6/2022,3,3,0,0,6,3,6,0,3
3080,7742,3080.0,20,Santos,Internacional,8/6/2022,2,1,0,0,3,2,3,0,1
3081,7743,3081.0,20,Palmeiras,Botafogo-RJ,9/6/2022,1,1,0,0,2,1,2,0,1
3082,7744,3082.0,20,Coritiba,Sao Paulo,9/6/2022,3,3,0,0,6,3,6,0,3
3083,7745,3083.0,20,Fortaleza,Goias,9/6/2022,1,2,0,0,3,1,3,0,2
3084,7746,3084.0,20,Corinthians,Juventude,11/6/2022,1,4,0,0,5,1,5,0,4
3085,7747,3085.0,20,Atletico-MG,Santos,11/6/2022,4,4,0,1,8,4,9,1,5
3086,7748,3086.0,20,Fluminense,Atletico-GO,11/6/2022,3,2,1,0,5,4,6,1,2
3087,7749,3087.0,20,Cuiaba,Bragantino,11/6/2022,1,3,0,0,4,1,4,0,3
3088,7750,3088.0,20,Internacional,Flamengo,11/6/2022,3,3,0,0,6,3,6,0,3
3089,7751,3089.0,20,Goias,Ceara,12/6/2022,6,2,0,1,8,6,9,1,3
3090,7752,3090.0,20,Sao Paulo,America-MG,12/6/2022,2,2,0,0,4,2,4,0,2
3091,7753,3091.0,20,Coritiba,Palmeiras,12/6/2022,1,2,1,0,3,2,4,1,2
3092,7754,3092.0,20,Fortaleza,Athletico-PR,12/6/2022,1,3,0,0,4,1,4,0,3
3093,7755,3093.0,20,Botafogo-RJ,Avai,13/6/2022,4,5,0,1,9,4,10,1,6
3094,7756,3094.0,20,Juventude,Santos,14/6/2022,1,2,1,0,3,2,4,1,2
3095,7757,3095.0,20,Ceara,Atletico-MG,15/6/2022,2,3,0,0,5,2,5,0,3
3096,7758,3096.0,20,Bragantino,Coritiba,15/6/2022,2,1,0,0,3,2,3,0,1
3097,7759,3097.0,20,Goias,Internacional,15/6/2022,4,3,0,0,7,4,7,0,3
3098,7760,3098.0,20,Flamengo,Cuiaba,15/6/2022,1,2,0,0,3,1,3,0,2
3099,7761,3099.0,20,Athletico-PR,Corinthians,15/6/2022,2,2,1,1,4,3,6,2,3
3100,7762,3100.0,20,America-MG,Fluminense,15/6/2022,3,1,1,0,4,4,5,1,1
3101,7763,3101.0,20,Botafogo-RJ,Sao Paulo,16/6/2022,6,3,0,0,9,6,9,0,3
3102,7764,3102.0,20,Palmeiras,Atletico-GO,16/6/2022,2,1,0,1,3,2,4,1,2
3103,7765,3103.0,20,Avai,Fortaleza,16/6/2022,1,3,0,0,4,1,4,0,3
3104,7766,3104.0,20,Cuiaba,Ceara,18/6/2022,0,2,0,0,2,0,2,0,2
3105,7767,3105.0,20,Santos,Bragantino,18/6/2022,4,3,0,0,7,4,7,0,3
3106,7768,3106.0,20,Atletico-MG,Flamengo,19/6/2022,4,1,0,0,5,4,5,0,1
3107,7769,3107.0,20,Coritiba,Athletico-PR,19/6/2022,5,6,2,0,11,7,13,2,6
3108,7770,3108.0,20,Corinthians,Goias,19/6/2022,1,4,0,0,5,1,5,0,4
3109,7771,3109.0,20,Internacional,Botafogo-RJ,19/6/2022,5,6,2,2,11,7,15,4,8
3110,7772,3110.0,20,Fortaleza,America-MG,19/6/2022,1,0,0,0,1,1,1,0,0
3111,7773,3111.0,20,Atletico-GO,Juventude,19/6/2022,3,4,0,1,7,3,8,1,5
3112,7774,3112.0,20,Fluminense,Avai,19/6/2022,0,3,0,0,3,0,3,0,3
3113,7775,3113.0,20,Sao Paulo,Palmeiras,20/6/2022,3,1,0,0,4,3,4,0,1
3114,7776,3114.0,20,Internacional,Coritiba,24/6/2022,2,4,0,0,6,2,6,0,4
3115,7777,3115.0,20,Athletico-PR,Bragantino,25/6/2022,4,1,0,0,5,4,5,0,1
3116,7778,3116.0,20,Flamengo,America-MG,25/6/2022,1,2,0,0,3,1,3,0,2
3117,7779,3117.0,20,Corinthians,Santos,25/6/2022,3,3,0,0,6,3,6,0,3
3118,7780,3118.0,20,Atletico-MG,Fortaleza,25/6/2022,0,5,0,0,5,0,5,0,5
3119,7781,3119.0,20,Avai,Palmeiras,26/6/2022,4,1,0,0,5,4,5,0,1
3120,7782,3120.0,20,Botafogo-RJ,Fluminense,26/6/2022,3,2,0,0,5,3,5,0,2
3121,7783,3121.0,20,Goias,Cuiaba,26/6/2022,3,4,0,1,7,3,8,1,5
3122,7784,3122.0,20,Ceara,Atletico-GO,26/6/2022,2,2,0,0,4,2,4,0,2
3123,7785,3123.0,20,Sao Paulo,Juventude,26/6/2022,3,4,0,0,7,3,7,0,4
3124,7786,3124.0,20,Juventude,Atletico-MG,2/7/2022,2,1,0,0,3,2,3,0,1
3125,7787,3125.0,20,Fluminense,Corinthians,2/7/2022,0,3,0,0,3,0,3,0,3
3126,7788,3126.0,20,Santos,Flamengo,2/7/2022,4,2,0,0,6,4,6,0,2
3127,7789,3127.0,20,Ceara,Internacional,2/7/2022,4,3,0,1,7,4,8,1,4
3128,7790,3128.0,20,Palmeiras,Athletico-PR,2/7/2022,1,2,1,0,3,2,4,1,2
3129,7792,3129.0,20,Atletico-GO,Sao Paulo,3/7/2022,5,7,0,0,12,5,12,0,7
3130,7793,3130.0,20,America-MG,Goias,3/7/2022,2,2,0,0,4,2,4,0,2
3131,7794,3131.0,20,Coritiba,Fortaleza,3/7/2022,2,3,1,0,5,3,6,1,3
3132,7795,3132.0,20,Bragantino,Botafogo-RJ,4/7/2022,1,4,1,0,5,2,6,1,4
3133,7796,3133.0,20,Bragantino,Avai,9/7/2022,1,3,0,0,4,1,4,0,3
3134,7797,3134.0,20,Fluminense,Ceara,9/7/2022,2,3,0,0,5,2,5,0,3
3135,7798,3135.0,20,Goias,Athletico-PR,9/7/2022,2,1,0,0,3,2,3,0,1
3136,7799,3136.0,20,Coritiba,Juventude,10/7/2022,1,2,0,0,3,1,3,0,2
3137,7800,3137.0,20,Corinthians,Flamengo,10/7/2022,2,4,0,0,6,2,6,0,4
3138,7801,3138.0,20,Santos,Atletico-GO,10/7/2022,5,4,0,0,9,5,9,0,4
3139,7802,3139.0,20,Fortaleza,Palmeiras,10/7/2022,0,1,0,0,1,0,1,0,1
3140,7803,3140.0,20,Atletico-MG,Sao Paulo,10/7/2022,1,1,0,0,2,1,2,0,1
3141,7804,3141.0,20,Cuiaba,Botafogo-RJ,10/7/2022,1,2,0,2,3,1,5,2,4
3142,7805,3142.0,20,Internacional,America-MG,11/7/2022,0,5,0,0,5,0,5,0,5
3143,7806,3143.0,20,Athletico-PR,Internacional,16/7/2022,1,2,0,0,3,1,3,0,2
3144,7807,3144.0,20,Flamengo,Coritiba,16/7/2022,0,1,0,0,1,0,1,0,1
3145,7808,3145.0,20,Avai,Santos,16/7/2022,5,3,0,0,8,5,8,0,3
3146,7809,3146.0,20,Ceara,Corinthians,16/7/2022,1,1,0,0,2,1,2,0,1
3147,7810,3147.0,20,Juventude,Goias,17/7/2022,2,3,0,0,5,2,5,0,3
3148,7811,3148.0,20,Sao Paulo,Fluminense,17/7/2022,4,2,0,0,6,4,6,0,2
3149,7812,3149.0,20,Botafogo-RJ,Atletico-MG,17/7/2022,4,3,0,0,7,4,7,0,3
3150,7813,3150.0,20,Atletico-GO,Fortaleza,17/7/2022,1,0,0,0,1,1,1,0,0
3151,7814,3151.0,20,America-MG,Bragantino,17/7/2022,3,1,0,0,4,3,4,0,1
3152,7815,3152.0,20,Palmeiras,Cuiaba,18/7/2022,3,1,0,0,4,3,4,0,1
3153,7816,3153.0,20,Ceara,Avai,19/7/2022,0,2,0,0,2,0,2,0,2
3154,7817,3154.0,20,Bragantino,Fortaleza,20/7/2022,4,3,0,0,7,4,7,0,3
3155,7818,3155.0,20,Goias,Fluminense,20/7/2022,2,0,0,0,2,2,2,0,0
3156,7819,3156.0,20,Athletico-PR,Atletico-GO,20/7/2022,3,0,0,0,3,3,3,0,0
3157,7820,3157.0,20,Flamengo,Juventude,20/7/2022,3,3,0,1,6,3,7,1,4
3158,7821,3158.0,20,Internacional,Sao Paulo,20/7/2022,4,5,0,0,9,4,9,0,5
3159,7822,3159.0,20,Santos,Botafogo-RJ,20/7/2022,2,2,0,0,4,2,4,0,2
3160,7823,3160.0,20,Corinthians,Coritiba,20/7/2022,1,3,0,0,4,1,4,0,3
3161,7824,3161.0,20,Cuiaba,Atletico-MG,21/7/2022,1,1,0,0,2,1,2,0,1
3162,7825,3162.0,20,America-MG,Palmeiras,21/7/2022,5,3,0,0,8,5,8,0,3
3163,7826,3163.0,20,Sao Paulo,Goias,23/7/2022,2,5,0,0,7,2,7,0,5
3164,7827,3164.0,20,Botafogo-RJ,Athletico-PR,23/7/2022,0,2,0,0,2,0,2,0,2
3165,7828,3165.0,20,Avai,Flamengo,24/7/2022,1,1,0,0,2,1,2,0,1
3166,7829,3166.0,20,Fluminense,Bragantino,24/7/2022,5,2,1,0,7,6,8,1,2
3167,7830,3167.0,20,Palmeiras,Internacional,24/7/2022,0,1,0,0,1,0,1,0,1
3168,7831,3168.0,20,Juventude,Ceara,24/7/2022,1,3,0,0,4,1,4,0,3
3169,7832,3169.0,20,Atletico-MG,Corinthians,24/7/2022,2,1,0,0,3,2,3,0,1
3170,7833,3170.0,20,Atletico-GO,America-MG,24/7/2022,0,1,0,0,1,0,1,0,1
3171,7834,3171.0,20,Fortaleza,Santos,24/7/2022,4,4,0,0,8,4,8,0,4
3172,7835,3172.0,20,Coritiba,Cuiaba,25/7/2022,5,3,1,0,8,6,9,1,3
3173,7836,3173.0,20,Goias,Coritiba,30/7/2022,1,2,0,1,3,1,4,1,3
3174,7837,3174.0,20,Ceara,Palmeiras,30/7/2022,3,3,1,0,6,4,7,1,3
3175,7839,3175.0,20,Flamengo,Atletico-GO,30/7/2022,0,7,0,1,7,0,8,1,8
3176,7840,3176.0,20,Athletico-PR,Sao Paulo,31/7/2022,3,4,0,0,7,3,7,0,4
3177,7841,3177.0,20,Internacional,Atletico-MG,31/7/2022,1,1,0,0,2,1,2,0,1
3178,7842,3178.0,20,Cuiaba,Fortaleza,31/7/2022,2,4,0,0,6,2,6,0,4
3179,7843,3179.0,20,America-MG,Avai,31/7/2022,1,0,0,0,1,1,1,0,0
3180,7844,3180.0,20,Bragantino,Juventude,31/7/2022,1,1,0,0,2,1,2,0,1
3181,7845,3181.0,20,Santos,Fluminense,1/8/2022,2,5,0,0,7,2,7,0,5
3182,7846,3182.0,20,Juventude,America-MG,6/8/2022,1,2,0,0,3,1,3,0,2
3183,7847,3183.0,20,Botafogo-RJ,Ceara,6/8/2022,3,4,0,0,7,3,7,0,4
3184,7848,3184.0,20,Avai,Corinthians,6/8/2022,2,1,0,0,3,2,3,0,1
3185,7849,3185.0,20,Atletico-GO,Bragantino,6/8/2022,2,1,0,0,3,2,3,0,1
3186,7850,3186.0,20,Sao Paulo,Flamengo,6/8/2022,2,2,0,0,4,2,4,0,2
3187,7851,3187.0,20,Fluminense,Cuiaba,7/8/2022,2,1,0,0,3,2,3,0,1
3188,7852,3188.0,20,Palmeiras,Goias,7/8/2022,2,3,0,0,5,2,5,0,3
3189,7853,3189.0,20,Fortaleza,Internacional,7/8/2022,1,5,1,0,6,2,7,1,5
3190,7854,3190.0,20,Atletico-MG,Athletico-PR,7/8/2022,1,2,0,0,3,1,3,0,2
3191,7855,3191.0,20,Coritiba,Santos,8/8/2022,3,3,0,0,6,3,6,0,3
3192,7856,3192.0,20,Goias,Avai,13/8/2022,1,2,1,0,3,2,4,1,2
3193,7857,3193.0,20,Corinthians,Palmeiras,13/8/2022,2,2,0,0,4,2,4,0,2
3194,7858,3194.0,20,Cuiaba,Juventude,13/8/2022,4,5,0,1,9,4,10,1,6
3195,7859,3195.0,20,Botafogo-RJ,Atletico-GO,13/8/2022,1,3,1,0,4,2,5,1,3
3196,7860,3196.0,20,Coritiba,Atletico-MG,14/8/2022,3,0,0,0,3,3,3,0,0
3197,7861,3197.0,20,Ceara,Fortaleza,14/8/2022,3,4,0,0,7,3,7,0,4
3198,7862,3198.0,20,Flamengo,Athletico-PR,14/8/2022,3,2,0,0,5,3,5,0,2
3199,7863,3199.0,20,Sao Paulo,Bragantino,14/8/2022,1,0,0,0,1,1,1,0,0
3200,7864,3200.0,20,America-MG,Santos,14/8/2022,1,0,0,0,1,1,1,0,0
3201,7865,3201.0,20,Internacional,Fluminense,14/8/2022,1,1,0,0,2,1,2,0,1
3202,7867,3202.0,20,Fluminense,Coritiba,20/8/2022,1,2,0,0,3,1,3,0,2
3203,7868,3203.0,20,Juventude,Botafogo-RJ,21/8/2022,2,2,0,0,4,2,4,0,2
3204,7869,3204.0,20,Palmeiras,Flamengo,21/8/2022,0,2,0,0,2,0,2,0,2
3205,7871,3205.0,20,Atletico-GO,Cuiaba,21/8/2022,2,2,1,0,4,3,5,1,2
3206,7872,3206.0,20,Fortaleza,Corinthians,21/8/2022,1,2,0,0,3,1,3,0,2
3207,7873,3207.0,20,Bragantino,Ceara,21/8/2022,3,4,0,0,7,3,7,0,4
3208,7874,3208.0,20,Santos,Sao Paulo,21/8/2022,4,2,0,0,6,4,6,0,2
3209,7875,3209.0,20,Avai,Internacional,22/8/2022,5,1,0,0,6,5,6,0,1
3210,7876,3210.0,20,Goias,Atletico-GO,27/8/2022,2,2,1,1,4,3,6,2,3
3211,7877,3211.0,20,Coritiba,Avai,27/8/2022,4,3,0,0,7,4,7,0,3
3212,7878,3212.0,20,Fluminense,Palmeiras,27/8/2022,3,3,0,0,6,3,6,0,3
3213,7879,3213.0,20,Ceara,Athletico-PR,27/8/2022,0,1,0,0,1,0,1,0,1
3214,7880,3214.0,20,Sao Paulo,Fortaleza,28/8/2022,2,2,0,0,4,2,4,0,2
3215,7881,3215.0,20,America-MG,Atletico-MG,28/8/2022,4,4,0,0,8,4,8,0,4
3216,7882,3216.0,20,Botafogo-RJ,Flamengo,28/8/2022,3,2,0,0,5,3,5,0,2
3217,7884,3217.0,20,Internacional,Juventude,29/8/2022,0,3,0,0,3,0,3,0,3
3218,7885,3218.0,20,Corinthians,Bragantino,29/8/2022,1,1,0,0,2,1,2,0,1
3219,7886,3219.0,20,Juventude,Avai,3/9/2022,6,6,0,0,12,6,12,0,6
3220,7887,3220.0,20,Bragantino,Palmeiras,3/9/2022,4,4,0,0,8,4,8,0,4
3221,7888,3221.0,20,Athletico-PR,Fluminense,3/9/2022,2,0,0,0,2,2,2,0,0
3222,7889,3222.0,20,America-MG,Coritiba,3/9/2022,2,3,0,0,5,2,5,0,3
3223,7890,3223.0,20,Flamengo,Ceara,4/9/2022,4,6,1,1,10,5,12,2,7
3224,7891,3224.0,20,Corinthians,Internacional,4/9/2022,2,2,0,0,4,2,4,0,2
3225,7892,3225.0,20,Fortaleza,Botafogo-RJ,4/9/2022,1,2,0,0,3,1,3,0,2
3226,7893,3226.0,20,Atletico-GO,Atletico-MG,4/9/2022,1,2,0,0,3,1,3,0,2
3227,7894,3227.0,20,Cuiaba,Sao Paulo,4/9/2022,3,2,0,1,5,3,6,1,3
3228,7895,3228.0,20,Santos,Goias,5/9/2022,1,2,0,0,3,1,3,0,2
3229,7896,3229.0,20,Atletico-MG,Bragantino,7/9/2022,1,2,0,0,3,1,3,0,2
3230,7897,3230.0,20,Internacional,Cuiaba,10/9/2022,1,3,0,0,4,1,4,0,3
3231,7898,3231.0,20,Ceara,Santos,10/9/2022,4,3,0,0,7,4,7,0,3
3232,7899,3232.0,20,Fluminense,Fortaleza,10/9/2022,1,2,0,0,3,1,3,0,2
3233,7900,3233.0,20,Palmeiras,Juventude,10/9/2022,0,3,0,0,3,0,3,0,3
3234,7901,3234.0,20,Avai,Athletico-PR,11/9/2022,3,4,0,1,7,3,8,1,5
3235,7902,3235.0,20,Botafogo-RJ,America-MG,11/9/2022,1,5,0,0,6,1,6,0,5
3236,7903,3236.0,20,Sao Paulo,Corinthians,11/9/2022,3,1,0,0,4,3,4,0,1
3237,7904,3237.0,20,Coritiba,Atletico-GO,11/9/2022,6,3,0,1,9,6,10,1,4
3238,7905,3238.0,20,Goias,Flamengo,11/9/2022,3,1,0,0,4,3,4,0,1
3239,7906,3239.0,20,Avai,Atletico-MG,17/9/2022,4,3,0,0,7,4,7,0,3
3240,7907,3240.0,20,Botafogo-RJ,Coritiba,17/9/2022,2,4,0,0,6,2,6,0,4
3241,7908,3241.0,20,Bragantino,Goias,18/9/2022,0,5,0,0,5,0,5,0,5
3242,7909,3242.0,20,Flamengo,Fluminense,18/9/2022,1,5,2,3,6,3,11,5,8
3243,7910,3243.0,20,Ceara,Sao Paulo,18/9/2022,5,2,2,0,7,7,9,2,2
3244,7911,3244.0,20,America-MG,Corinthians,18/9/2022,1,3,0,0,4,1,4,0,3
3245,7912,3245.0,20,Juventude,Fortaleza,18/9/2022,2,3,0,0,5,2,5,0,3
3246,7913,3246.0,20,Palmeiras,Santos,18/9/2022,3,4,1,0,7,4,8,1,4
3247,7914,3247.0,20,Athletico-PR,Cuiaba,18/9/2022,3,2,0,1,5,3,6,1,3
3248,7915,3248.0,20,Atletico-GO,Internacional,19/9/2022,3,2,0,0,5,3,5,0,2
3249,7916,3249.0,20,Sao Paulo,Avai,25/9/2022,2,4,0,0,6,2,6,0,4
3250,7917,3250.0,20,Santos,Athletico-PR,27/9/2022,3,3,0,0,6,3,6,0,3
3251,7918,3251.0,20,Coritiba,Ceara,28/9/2022,2,4,0,0,6,2,6,0,4
3252,7919,3252.0,20,Corinthians,Atletico-GO,28/9/2022,0,3,0,0,3,0,3,0,3
3253,7920,3253.0,20,Fluminense,Juventude,28/9/2022,1,1,0,0,2,1,2,0,1
3254,7921,3254.0,20,Fortaleza,Flamengo,28/9/2022,2,5,0,0,7,2,7,0,5
3255,7922,3255.0,20,Cuiaba,America-MG,28/9/2022,1,6,0,0,7,1,7,0,6
3256,7923,3256.0,20,Internacional,Bragantino,28/9/2022,1,2,0,0,3,1,3,0,2
3257,7924,3257.0,20,Atletico-MG,Palmeiras,28/9/2022,3,3,0,0,6,3,6,0,3
3258,7925,3258.0,20,Goias,Botafogo-RJ,28/9/2022,4,4,0,0,8,4,8,0,4
3259,7926,3259.0,20,Atletico-MG,Fluminense,1/10/2022,2,3,0,1,5,2,6,1,4
3260,7927,3260.0,20,Internacional,Santos,1/10/2022,1,4,0,0,5,1,5,0,4
3261,7928,3261.0,20,Ceara,America-MG,1/10/2022,3,4,0,0,7,3,7,0,4
3262,7929,3262.0,20,Avai,Atletico-GO,1/10/2022,2,4,0,0,6,2,6,0,4
3263,7930,3263.0,20,Athletico-PR,Juventude,1/10/2022,3,5,0,0,8,3,8,0,5
3264,7931,3264.0,20,Flamengo,Bragantino,1/10/2022,1,0,0,1,1,1,2,1,1
3265,7932,3265.0,20,Goias,Fortaleza,1/10/2022,3,2,0,0,5,3,5,0,2
3266,7933,3266.0,20,Corinthians,Cuiaba,1/10/2022,1,0,0,0,1,1,1,0,0
3267,7934,3267.0,20,Botafogo-RJ,Palmeiras,3/10/2022,4,2,0,1,6,4,7,1,3
3268,7935,3268.0,20,Sao Paulo,Coritiba,20/10/2022,2,6,0,0,8,2,8,0,6
3269,7936,3269.0,20,Juventude,Corinthians,4/10/2022,1,2,0,0,3,1,3,0,2
3270,7937,3270.0,20,Atletico-GO,Fluminense,5/10/2022,4,0,0,0,4,4,4,0,0
3271,7938,3271.0,20,Ceara,Goias,5/10/2022,4,4,1,0,8,5,9,1,4
3272,7939,3272.0,20,Bragantino,Cuiaba,5/10/2022,2,3,0,0,5,2,5,0,3
3273,7940,3273.0,20,Athletico-PR,Fortaleza,5/10/2022,2,1,0,0,3,2,3,0,1
3274,7941,3274.0,20,Flamengo,Internacional,5/10/2022,3,2,0,0,5,3,5,0,2
3275,7942,3275.0,20,Santos,Atletico-MG,5/10/2022,2,4,1,0,6,3,7,1,4
3276,7943,3276.0,20,Palmeiras,Coritiba,6/10/2022,1,2,0,0,3,1,3,0,2
3277,7944,3277.0,20,America-MG,Sao Paulo,6/10/2022,2,4,0,0,6,2,6,0,4
3278,7945,3278.0,20,Avai,Botafogo-RJ,6/10/2022,2,4,0,0,6,2,6,0,4
3279,7946,3279.0,20,Cuiaba,Flamengo,8/10/2022,2,2,0,0,4,2,4,0,2
3280,7947,3280.0,20,Corinthians,Athletico-PR,8/10/2022,1,0,0,0,1,1,1,0,0
3281,7948,3281.0,20,Internacional,Goias,9/10/2022,1,7,0,0,8,1,8,0,7
3282,7949,3282.0,20,Sao Paulo,Botafogo-RJ,9/10/2022,3,2,1,0,5,4,6,1,2
3283,7950,3283.0,20,Fortaleza,Avai,9/10/2022,1,1,0,0,2,1,2,0,1
3284,7951,3284.0,20,Coritiba,Bragantino,9/10/2022,0,3,1,0,3,1,4,1,3
3285,7952,3285.0,20,Atletico-MG,Ceara,9/10/2022,3,5,0,0,8,3,8,0,5
3286,7953,3286.0,20,Fluminense,America-MG,9/10/2022,1,3,0,0,4,1,4,0,3
3287,7954,3287.0,20,Atletico-GO,Palmeiras,10/10/2022,4,2,0,0,6,4,6,0,2
3288,7955,3288.0,20,Santos,Juventude,10/10/2022,2,0,0,0,2,2,2,0,0
3289,7956,3289.0,20,Flamengo,Atletico-MG,15/10/2022,4,0,0,0,4,4,4,0,0
3290,7957,3290.0,20,America-MG,Fortaleza,15/10/2022,1,3,0,1,4,1,5,1,4
3291,7958,3291.0,20,Ceara,Cuiaba,16/10/2022,4,5,0,1,9,4,10,1,6
3292,7959,3292.0,20,Palmeiras,Sao Paulo,16/10/2022,3,3,0,2,6,3,8,2,5
3293,7960,3293.0,20,Juventude,Atletico-GO,16/10/2022,2,1,0,0,3,2,3,0,1
3294,7961,3294.0,20,Botafogo-RJ,Internacional,16/10/2022,3,5,0,0,8,3,8,0,5
3295,7962,3295.0,20,Avai,Fluminense,16/10/2022,2,0,0,0,2,2,2,0,0
3296,7963,3296.0,20,Athletico-PR,Coritiba,16/10/2022,3,2,0,0,5,3,5,0,2
3297,7964,3297.0,20,Bragantino,Santos,17/10/2022,3,4,1,0,7,4,8,1,4
3298,7965,3298.0,20,Goias,Corinthians,29/10/2022,2,3,0,0,5,2,5,0,3
3299,7966,3299.0,20,Bragantino,Athletico-PR,22/10/2022,0,3,0,0,3,0,3,0,3
3300,7967,3300.0,20,America-MG,Flamengo,22/10/2022,1,1,0,0,2,1,2,0,1
3301,7968,3301.0,20,Santos,Corinthians,22/10/2022,2,4,1,1,6,3,8,2,5
3302,7969,3302.0,20,Palmeiras,Avai,22/10/2022,2,2,0,0,4,2,4,0,2
3303,7970,3303.0,20,Fluminense,Botafogo-RJ,23/10/2022,3,2,0,0,5,3,5,0,2
3304,7971,3304.0,20,Juventude,Sao Paulo,23/10/2022,2,2,0,0,4,2,4,0,2
3305,7972,3305.0,20,Coritiba,Internacional,23/10/2022,3,1,0,0,4,3,4,0,1
3306,7973,3306.0,20,Atletico-GO,Ceara,23/10/2022,3,2,0,0,5,3,5,0,2
3307,7974,3307.0,20,Cuiaba,Goias,23/10/2022,3,4,0,0,7,3,7,0,4
3308,7975,3308.0,20,Fortaleza,Atletico-MG,24/10/2022,4,1,0,0,5,4,5,0,1
3309,7976,3309.0,20,Flamengo,Santos,25/10/2022,3,4,0,0,7,3,7,0,4
3310,7977,3310.0,20,Athletico-PR,Palmeiras,25/10/2022,3,5,1,0,8,4,9,1,5
3311,7978,3311.0,20,Botafogo-RJ,Bragantino,26/10/2022,1,4,0,0,5,1,5,0,4
3312,7979,3312.0,20,Corinthians,Fluminense,26/10/2022,2,3,0,0,5,2,5,0,3
3313,7980,3313.0,20,Internacional,Ceara,26/10/2022,0,2,0,0,2,0,2,0,2
3314,7981,3314.0,20,Goias,America-MG,26/10/2022,2,3,0,0,5,2,5,0,3
3315,7982,3315.0,20,Fortaleza,Coritiba,27/10/2022,1,1,0,1,2,1,3,1,2
3316,7983,3316.0,20,Sao Paulo,Atletico-GO,27/10/2022,2,4,0,1,6,2,7,1,5
3317,7984,3317.0,20,Atletico-MG,Juventude,27/10/2022,2,1,0,0,3,2,3,0,1
3318,7985,3318.0,20,Cuiaba,Avai,27/10/2022,1,1,0,0,2,1,2,0,1
3319,7986,3319.0,20,Ceara,Fluminense,31/10/2022,2,2,1,0,4,3,5,1,2
3320,7987,3320.0,20,Botafogo-RJ,Cuiaba,1/11/2022,1,1,0,0,2,1,2,0,1
3321,7988,3321.0,20,Sao Paulo,Atletico-MG,1/11/2022,3,5,0,0,8,3,8,0,5
3322,7989,3322.0,20,Athletico-PR,Goias,2/11/2022,2,1,0,0,3,2,3,0,1
3323,7991,3323.0,20,Juventude,Coritiba,2/11/2022,3,4,0,0,7,3,7,0,4
3324,7992,3324.0,20,Avai,Bragantino,2/11/2022,2,1,0,0,3,2,3,0,1
3325,7993,3325.0,20,Atletico-GO,Santos,2/11/2022,3,2,0,0,5,3,5,0,2
3326,7994,3326.0,20,Palmeiras,Fortaleza,2/11/2022,3,1,0,0,4,3,4,0,1
3327,7995,3327.0,20,Flamengo,Corinthians,2/11/2022,0,1,0,0,1,0,1,0,1
3328,7996,3328.0,20,Santos,Avai,5/11/2022,3,0,0,0,3,3,3,0,0
3329,7997,3329.0,20,Fluminense,Sao Paulo,5/11/2022,1,1,0,1,2,1,3,1,2
3330,7998,3330.0,20,Bragantino,America-MG,5/11/2022,6,2,0,0,8,6,8,0,2
3331,7999,3331.0,20,Goias,Juventude,5/11/2022,4,6,0,0,10,4,10,0,6
3332,8000,3332.0,20,Corinthians,Ceara,5/11/2022,4,4,0,0,8,4,8,0,4
3333,8001,3333.0,20,Internacional,Athletico-PR,5/11/2022,0,1,0,1,1,0,2,1,2
3334,8002,3334.0,20,Fortaleza,Atletico-GO,6/11/2022,2,5,0,1,7,2,8,1,6
3335,8003,3335.0,20,Coritiba,Flamengo,6/11/2022,5,3,0,0,8,5,8,0,3
3336,8004,3336.0,20,Cuiaba,Palmeiras,6/11/2022,2,0,0,0,2,2,2,0,0
3337,8005,3337.0,20,Atletico-MG,Botafogo-RJ,7/11/2022,2,5,0,0,7,2,7,0,5
3338,8006,3338.0,20,Sao Paulo,Internacional,8/11/2022,4,5,0,0,9,4,9,0,5
3339,8007,3339.0,20,Coritiba,Corinthians,9/11/2022,4,5,0,1,9,4,10,1,6
3340,8008,3340.0,20,Fluminense,Goias,9/11/2022,3,2,0,2,5,3,7,2,4
3341,8009,3341.0,20,Avai,Ceara,9/11/2022,4,5,0,0,9,4,9,0,5
3342,8010,3342.0,20,Fortaleza,Bragantino,9/11/2022,1,4,0,0,5,1,5,0,4
3343,8011,3343.0,20,Juventude,Flamengo,9/11/2022,7,3,0,0,10,7,10,0,3
3344,8012,3344.0,20,Palmeiras,America-MG,9/11/2022,4,2,0,0,6,4,6,0,2
3345,8013,3345.0,20,Atletico-GO,Athletico-PR,9/11/2022,1,0,0,0,1,1,1,0,0
3346,8014,3346.0,20,Botafogo-RJ,Santos,10/11/2022,2,4,0,1,6,2,7,1,5
3347,8015,3347.0,20,Atletico-MG,Cuiaba,10/11/2022,1,4,0,0,5,1,5,0,4
3348,8016,3348.0,20,Flamengo,Avai,12/11/2022,0,1,0,0,1,0,1,0,1
3349,8017,3349.0,20,Athletico-PR,Botafogo-RJ,13/11/2022,1,1,0,0,2,1,2,0,1
3350,8018,3350.0,20,Ceara,Juventude,13/11/2022,4,4,0,0,8,4,8,0,4
3351,8019,3351.0,20,America-MG,Atletico-GO,13/11/2022,3,2,0,1,5,3,6,1,3
3352,8020,3352.0,20,Santos,Fortaleza,13/11/2022,1,3,0,0,4,1,4,0,3
3353,8021,3353.0,20,Cuiaba,Coritiba,13/11/2022,1,4,0,1,5,1,6,1,5
3354,8022,3354.0,20,Bragantino,Fluminense,13/11/2022,3,2,0,0,5,3,5,0,2
3355,8023,3355.0,20,Corinthians,Atletico-MG,13/11/2022,3,6,0,0,9,3,9,0,6
3356,8024,3356.0,20,Internacional,Palmeiras,13/11/2022,2,3,0,0,5,2,5,0,3
3357,8025,3357.0,20,Goias,Sao Paulo,13/11/2022,2,1,0,0,3,2,3,0,1
3358,4613,,12,Atletico-MG,Corinthians,20/4/2014,0,0,0,0,0,0,0,0,0
3359,4653,,12,Vitoria,Palmeiras,18/5/2014,0,0,0,0,0,0,0,0,0
3360,4659,,12,Cruzeiro,Sport,21/5/2014,0,0,0,0,0,0,0,0,0
3361,4681,,12,Goias,Vitoria,28/5/2014,0,0,0,0,0,0,0,0,0
3362,4739,,12,Vitoria,Gremio,2/8/2014,0,0,0,0,0,0,0,0,0
3363,4795,,12,Goias,Athletico-PR,31/8/2014,0,0,0,0,0,0,0,0,0
3364,4812,,12,Goias,Flamengo,10/9/2014,0,0,0,0,0,0,0,0,0
3365,4853,,12,Fluminense,Gremio,24/9/2014,0,0,0,0,0,0,0,0,0
3366,4919,,12,Corinthians,Coritiba,1/11/2014,0,0,0,0,0,0,0,0,0
3367,5037,,13,Atletico-MG,Cruzeiro,6/6/2015,0,0,0,0,0,0,0,0,0
3368,5128,,13,Gremio,Sport,25/7/2015,0,0,0,0,0,0,0,0,0
3369,5149,,13,Athletico-PR,Sport,9/8/2015,0,0,0,0,0,0,0,0,0
3370,5174,,13,Sport,Ponte Preta,16/8/2015,0,0,0,0,0,0,0,0,0
3371,5207,,13,Sao Paulo,Internacional,5/9/2015,0,0,0,0,0,0,0,0,0
3372,5334,,13,Sao Paulo,Atletico-MG,19/11/2015,0,0,0,0,0,0,0,0,0
3373,5364,,13,Atletico-MG,Chapecoense,6/12/2015,0,0,0,0,0,0,0,0,0
3374,5375,,14,America-MG,Fluminense,15/5/2016,0,0,0,0,0,0,0,0,0
3375,5444,,14,Cruzeiro,Flamengo,15/6/2016,0,0,0,0,0,0,0,0,0
3376,5486,,14,Atletico-MG,Botafogo-RJ,30/6/2016,0,0,0,0,0,0,0,0,0
3377,5650,,14,Santos,Fluminense,5/10/2016,0,0,0,0,0,0,0,0,0
3378,5663,,14,Atletico-MG,America-MG,13/10/2016,0,0,0,0,0,0,0,0,0
3379,5686,,14,America-MG,Athletico-PR,24/10/2016,0,0,0,0,0,0,0,0,0
3380,5702,,14,Palmeiras,Internacional,6/11/2016,0,0,0,0,0,0,0,0,0
3381,5824,,15,Sport,Vitoria,18/6/2017,0,0,0,0,0,0,0,0,0
3382,5876,,15,Corinthians,Athletico-PR,15/7/2017,0,0,0,0,0,0,0,0,0
3383,5931,,15,Coritiba,Chapecoense,6/8/2017,0,0,0,0,0,0,0,0,0
3384,5974,,15,Botafogo-RJ,Flamengo,10/9/2017,0,0,0,0,0,0,0,0,0
3385,6019,,15,Gremio,Cruzeiro,11/10/2017,0,0,0,0,0,0,0,0,0
3386,6062,,15,Gremio,Flamengo,5/11/2017,0,0,0,0,0,0,0,0,0
3387,6132,,16,Corinthians,Fluminense,15/4/2018,0,0,0,0,0,0,0,0,0
3388,6246,,16,Ceara,Sport,18/7/2018,0,0,0,0,0,0,0,0,0
3389,6416,,16,America-MG,Gremio,20/10/2018,0,0,0,0,0,0,0,0,0
3390,6517,,17,CSA,Palmeiras,1/5/2019,0,0,0,0,0,0,0,0,0
3391,6522,,17,Vasco,Atletico-MG,1/5/2019,0,0,0,0,0,0,0,0,0
3392,6574,,17,Internacional,Avai,2/6/2019,0,0,0,0,0,0,0,0,0
3393,6603,,17,Cruzeiro,Botafogo-RJ,14/7/2019,0,0,0,0,0,0,0,0,0
3394,6650,,17,Gremio,Palmeiras,17/8/2019,0,0,0,0,0,0,0,0,0
3395,6783,,17,Sao Paulo,Atletico-MG,27/10/2019,0,0,0,0,0,0,0,0,0
3396,6786,,17,Palmeiras,Sao Paulo,30/10/2019,0,0,0,0,0,0,0,0,0
3397,6864,,17,Gremio,Sao Paulo,1/12/2019,0,0,0,0,0,0,0,0,0
3398,6965,,18,Atletico-MG,Sao Paulo,3/9/2020,0,0,0,0,0,0,0,0,0
3399,7146,,18,Atletico-MG,Coritiba,26/12/2020,0,0,0,0,0,0,0,0,0
3400,7191,,18,Bragantino,Vasco,20/1/2021,0,0,0,0,0,0,0,0,0
3401,7218,,18,Corinthians,Ceara,3/2/2021,0,0,0,0,0,0,0,0,0
3402,7229,,18,Botafogo-RJ,Gremio,8/2/2021,0,0,0,0,0,0,0,0,0
3403,7215,,18,Santos,Corinthians,17/2/2021,0,0,0,0,0,0,0,0,0
3404,7257,,18,Bahia,Santos,25/2/2021,0,0,0,0,0,0,0,0,0
3405,7265,,18,Fluminense,Fortaleza,25/2/2021,0,0,0,0,0,0,0,0,0
3406,7290,,19,Flamengo,America-MG,13/6/2021,0,0,0,0,0,0,0,0,0
3407,7401,,19,Chapecoense,Santos,1/8/2021,2,1,2,0,3,4,5,2,1
3408,7450,,19,Chapecoense,Fluminense,7/9/2021,0,0,0,0,0,0,0,0,0
3409,7460,,19,Gremio,Ceara,12/9/2021,0,0,0,0,0,0,0,0,0
3410,7488,,19,Bragantino,Corinthians,2/10/2021,0,0,0,0,0,0,0,0,0
3411,7541,,19,Atletico-MG,Cuiaba,24/10/2021,0,0,0,0,0,0,0,0,0
3412,7715,,20,Goias,Santos,15/5/2022,0,0,0,0,0,0,0,0,0
3413,7791,,20,Avai,Cuiaba,3/7/2022,0,0,0,0,0,0,0,0,0
3414,7838,,20,Corinthians,Botafogo-RJ,30/7/2022,0,0,0,0,0,0,0,0,0
3415,7866,,20,Atletico-MG,Goias,20/8/2022,0,0,0,0,0,0,0,0,0
3416,7870,,20,Athletico-PR,America-MG,21/8/2022,0,0,0,0,0,0,0,0,0
3417,7883,,20,Cuiaba,Santos,28/8/2022,0,0,0,0,0,0,0,0,0
3418,7990,,20,America-MG,Internacional,2/11/2022,0,0,0,0,0,0,0,0,0
