,Unnamed: 0,ID,campeonato,rodata,data,clube_mandante,clube_visitante,qtd_cartao_amarelo_mandante,qtd_cartao_amarelo_visitante,qtd_cartao_vermelho_mandante,qtd_cartao_vermelho_visitante,total_cartoes_mandante,total_cartoes_visitante,total_cartoes_vermelhos,total_cartoes_amarelos,total_cartoes_partida,faltas_mandante,faltas_visitante,total_faltas_partida,chave_classico,classico_regional
0,0,4987,2015,1,9/5/2015,Chapecoense,Coritiba,2,2,0,0,2,2,0,4,4,20,21,41,ChapecoenseCoritiba,0
1,1,4988,2015,1,9/5/2015,Palmeiras,Atletico-MG,2,4,0,0,2,4,0,6,6,20,14,34,PalmeirasAtletico-MG,0
2,2,4989,2015,1,9/5/2015,Fluminense,Joinville,2,1,0,1,2,2,1,3,4,9,14,23,FluminenseJoinville,0
3,3,4990,2015,1,10/5/2015,Gremio,Ponte Preta,3,5,0,1,3,6,1,8,9,17,21,38,GremioPonte Preta,0
4,4,4991,2015,1,10/5/2015,Athletico-PR,Internacional,1,2,0,0,1,2,0,3,3,17,17,34,Athletico-PRInternacional,0
5,5,4992,2015,1,10/5/2015,Sao Paulo,Flamengo,2,1,0,0,2,1,0,3,3,17,12,29,Sao PauloFlamengo,0
6,6,4993,2015,1,10/5/2015,Cruzeiro,Corinthians,3,1,0,0,3,1,0,4,4,17,15,32,CruzeiroCorinthians,0
7,7,4994,2015,1,10/5/2015,Sport,Figueirense,1,3,0,1,1,4,1,4,5,17,14,31,SportFigueirense,0
8,8,4995,2015,1,10/5/2015,Avai,Santos,2,2,0,1,2,3,1,4,5,10,11,21,AvaiSantos,0
9,9,4996,2015,1,10/5/2015,Vasco,Goias,3,5,0,0,3,5,0,8,8,16,27,43,VascoGoias,0
10,10,4997,2015,2,16/5/2015,Goias,Athletico-PR,2,1,0,1,2,2,1,3,4,14,18,32,GoiasAthletico-PR,0
11,11,4998,2015,2,16/5/2015,Coritiba,Gremio,2,3,0,0,2,3,0,5,5,22,13,35,CoritibaGremio,0
12,12,4999,2015,2,16/5/2015,Corinthians,Chapecoense,2,4,0,0,2,4,0,6,6,16,13,29,CorinthiansChapecoense,0
13,13,5000,2015,2,17/5/2015,Figueirense,Vasco,2,6,0,0,2,6,0,8,8,18,13,31,FigueirenseVasco,0
14,14,5001,2015,2,17/5/2015,Atletico-MG,Fluminense,2,1,0,0,2,1,0,3,3,17,9,26,Atletico-MGFluminense,0
15,15,5002,2015,2,17/5/2015,Flamengo,Sport,2,3,0,0,2,3,0,5,5,10,7,17,FlamengoSport,0
16,16,5003,2015,2,17/5/2015,Santos,Cruzeiro,1,4,0,0,1,4,0,5,5,18,13,31,SantosCruzeiro,0
17,17,5004,2015,2,17/5/2015,Joinville,Palmeiras,3,1,0,0,3,1,0,4,4,17,12,29,JoinvillePalmeiras,0
18,18,5005,2015,2,17/5/2015,Ponte Preta,Sao Paulo,1,3,0,0,1,3,0,4,4,15,14,29,Ponte PretaSao Paulo,1
19,19,5006,2015,2,17/5/2015,Internacional,Avai,3,7,0,0,3,7,0,10,10,17,26,43,InternacionalAvai,0
20,20,5007,2015,3,23/5/2015,Sao Paulo,Joinville,2,0,0,0,2,0,0,2,2,12,11,23,Sao PauloJoinville,0
21,21,5008,2015,3,23/5/2015,Vasco,Internacional,6,3,0,1,6,4,1,9,10,15,16,31,VascoInternacional,0
22,22,5009,2015,3,23/5/2015,Gremio,Figueirense,6,5,0,0,6,5,0,11,11,16,24,40,GremioFigueirense,0
23,23,5010,2015,3,24/5/2015,Palmeiras,Goias,6,5,1,1,7,6,2,11,13,13,24,37,PalmeirasGoias,0
24,24,5011,2015,3,24/5/2015,Chapecoense,Santos,5,6,0,0,5,6,0,11,11,13,20,33,ChapecoenseSantos,0
25,25,5012,2015,3,24/5/2015,Athletico-PR,Atletico-MG,4,0,1,0,5,0,1,4,5,7,8,15,Athletico-PRAtletico-MG,0
26,26,5013,2015,3,24/5/2015,Fluminense,Corinthians,2,2,0,0,2,2,0,4,4,19,6,25,FluminenseCorinthians,0
27,27,5014,2015,3,24/5/2015,Avai,Flamengo,5,6,0,0,5,6,0,11,11,15,17,32,AvaiFlamengo,0
28,28,5015,2015,3,24/5/2015,Cruzeiro,Ponte Preta,2,2,0,0,2,2,0,4,4,17,11,28,CruzeiroPonte Preta,0
29,29,5016,2015,3,24/5/2015,Sport,Coritiba,1,4,0,0,1,4,0,5,5,13,17,30,SportCoritiba,0
30,30,5017,2015,4,30/5/2015,Ponte Preta,Chapecoense,4,2,0,1,4,3,1,6,7,20,15,35,Ponte PretaChapecoense,0
31,31,5018,2015,4,30/5/2015,Coritiba,Avai,4,4,0,0,4,4,0,8,8,17,21,38,CoritibaAvai,0
32,32,5019,2015,4,30/5/2015,Joinville,Athletico-PR,0,4,0,0,0,4,0,4,4,12,13,25,JoinvilleAthletico-PR,0
33,33,5020,2015,4,31/5/2015,Santos,Sport,1,2,0,0,1,2,0,3,3,9,11,20,SantosSport,0
34,34,5021,2015,4,31/5/2015,Goias,Gremio,1,1,0,0,1,1,0,2,2,14,14,28,GoiasGremio,0
35,35,5022,2015,4,31/5/2015,Atletico-MG,Vasco,0,3,0,0,0,3,0,3,3,16,12,28,Atletico-MGVasco,0
36,36,5023,2015,4,31/5/2015,Corinthians,Palmeiras,5,5,0,0,5,5,0,10,10,21,21,42,CorinthiansPalmeiras,1
37,37,5024,2015,4,31/5/2015,Internacional,Sao Paulo,3,1,0,1,3,2,1,4,5,19,17,36,InternacionalSao Paulo,0
38,38,5025,2015,4,31/5/2015,Flamengo,Fluminense,6,3,1,1,7,4,2,9,11,24,23,47,FlamengoFluminense,0
39,39,5026,2015,4,31/5/2015,Figueirense,Cruzeiro,3,6,0,1,3,7,1,9,10,17,11,28,FigueirenseCruzeiro,0
40,40,5027,2015,5,3/6/2015,Athletico-PR,Figueirense,1,4,0,0,1,4,0,5,5,12,8,20,Athletico-PRFigueirense,0
41,41,5028,2015,5,3/6/2015,Vasco,Ponte Preta,2,3,2,0,4,3,2,5,7,15,18,33,VascoPonte Preta,0
42,42,5029,2015,5,3/6/2015,Chapecoense,Joinville,3,5,0,0,3,5,0,8,8,16,12,28,ChapecoenseJoinville,1
43,43,5030,2015,5,3/6/2015,Sao Paulo,Santos,5,3,0,1,5,4,1,8,9,14,15,29,Sao PauloSantos,1
44,44,5031,2015,5,3/6/2015,Cruzeiro,Flamengo,2,3,0,0,2,3,0,5,5,16,17,33,CruzeiroFlamengo,0
45,45,5032,2015,5,3/6/2015,Avai,Atletico-MG,3,3,0,0,3,3,0,6,6,12,15,27,AvaiAtletico-MG,0
46,46,5033,2015,5,3/6/2015,Gremio,Corinthians,2,3,0,0,2,3,0,5,5,22,10,32,GremioCorinthians,0
47,47,5034,2015,5,4/6/2015,Fluminense,Coritiba,1,4,0,0,1,4,0,5,5,13,24,37,FluminenseCoritiba,0
48,48,5035,2015,5,4/6/2015,Sport,Goias,2,4,0,0,2,4,0,6,6,11,13,24,SportGoias,0
49,49,5036,2015,5,4/6/2015,Palmeiras,Internacional,1,4,0,0,1,4,0,5,5,15,13,28,PalmeirasInternacional,0
2987,2987,5037,2015,6,6/6/2015,Atletico-MG,Cruzeiro,0,0,0,0,0,0,0,0,0,12,13,25,Atletico-MGCruzeiro,1
50,50,5038,2015,6,6/6/2015,Flamengo,Chapecoense,1,0,0,1,1,1,1,1,2,13,12,25,FlamengoChapecoense,0
51,51,5039,2015,6,6/6/2015,Santos,Ponte Preta,2,2,0,0,2,2,0,4,4,17,15,32,SantosPonte Preta,1
52,52,5040,2015,6,6/6/2015,Athletico-PR,Vasco,4,3,0,0,4,3,0,7,7,15,7,22,Athletico-PRVasco,0
53,53,5041,2015,6,6/6/2015,Joinville,Corinthians,1,1,0,0,1,1,0,2,2,8,9,17,JoinvilleCorinthians,0
54,54,5042,2015,6,6/6/2015,Sao Paulo,Gremio,3,2,0,0,3,2,0,5,5,19,14,33,Sao PauloGremio,0
55,55,5043,2015,6,7/6/2015,Internacional,Coritiba,4,5,1,0,5,5,1,9,10,5,16,21,InternacionalCoritiba,0
56,56,5044,2015,6,7/6/2015,Figueirense,Palmeiras,3,3,0,0,3,3,0,6,6,22,14,36,FigueirensePalmeiras,0
57,57,5045,2015,6,7/6/2015,Goias,Avai,2,4,0,0,2,4,0,6,6,15,17,32,GoiasAvai,0
58,58,5046,2015,6,7/6/2015,Fluminense,Sport,3,2,0,0,3,2,0,5,5,12,10,22,FluminenseSport,0
59,59,5047,2015,7,10/6/2015,Atletico-MG,Santos,1,4,0,0,1,4,0,5,5,8,15,23,Atletico-MGSantos,0
60,60,5048,2015,7,13/6/2015,Coritiba,Flamengo,2,4,0,1,2,5,1,6,7,17,14,31,CoritibaFlamengo,0
61,61,5049,2015,7,13/6/2015,Chapecoense,Sao Paulo,2,4,0,0,2,4,0,6,6,5,29,34,ChapecoenseSao Paulo,0
62,62,5050,2015,7,13/6/2015,Corinthians,Internacional,0,2,0,0,0,2,0,2,2,10,9,19,CorinthiansInternacional,0
63,63,5051,2015,7,13/6/2015,Sport,Joinville,0,4,0,0,0,4,0,4,4,10,13,23,SportJoinville,0
64,64,5052,2015,7,13/6/2015,Vasco,Cruzeiro,2,4,0,0,2,4,0,6,6,13,25,38,VascoCruzeiro,0
65,65,5053,2015,7,14/6/2015,Ponte Preta,Goias,3,3,0,0,3,3,0,6,6,24,19,43,Ponte PretaGoias,0
66,66,5054,2015,7,14/6/2015,Avai,Figueirense,4,3,0,0,4,3,0,7,7,14,26,40,AvaiFigueirense,1
67,67,5055,2015,7,14/6/2015,Palmeiras,Fluminense,0,7,0,2,0,9,2,7,9,6,13,19,PalmeirasFluminense,0
68,68,5056,2015,7,14/6/2015,Gremio,Athletico-PR,1,4,0,0,1,4,0,5,5,8,22,30,GremioAthletico-PR,0
69,69,5057,2015,8,18/6/2015,Figueirense,Internacional,4,2,0,0,4,2,0,6,6,16,18,34,FigueirenseInternacional,0
70,70,5058,2015,8,20/6/2015,Sport,Vasco,2,3,0,0,2,3,0,5,5,10,12,22,SportVasco,0
71,71,5059,2015,8,20/6/2015,Flamengo,Atletico-MG,0,1,0,1,0,2,1,1,2,8,14,22,FlamengoAtletico-MG,0
72,72,5060,2015,8,20/6/2015,Santos,Corinthians,5,4,1,1,6,5,2,9,11,19,17,36,SantosCorinthians,1
73,73,5061,2015,8,20/6/2015,Gremio,Palmeiras,4,3,0,0,4,3,0,7,7,11,9,20,GremioPalmeiras,0
74,74,5062,2015,8,21/6/2015,Cruzeiro,Chapecoense,4,3,0,0,4,3,0,7,7,9,16,25,CruzeiroChapecoense,0
75,75,5063,2015,8,21/6/2015,Joinville,Goias,4,5,1,1,5,6,2,9,11,13,12,25,JoinvilleGoias,0
76,76,5064,2015,8,21/6/2015,Athletico-PR,Coritiba,2,5,0,2,2,7,2,7,9,10,20,30,Athletico-PRCoritiba,1
77,77,5065,2015,8,21/6/2015,Sao Paulo,Avai,1,5,0,0,1,5,0,6,6,14,13,27,Sao PauloAvai,0
78,78,5066,2015,8,24/6/2015,Fluminense,Ponte Preta,2,3,0,0,2,3,0,5,5,16,18,34,FluminensePonte Preta,0
79,79,5067,2015,9,27/6/2015,Avai,Gremio,3,3,0,0,3,3,0,6,6,14,16,30,AvaiGremio,0
80,80,5068,2015,9,27/6/2015,Chapecoense,Sport,1,6,0,0,1,6,0,7,7,7,16,23,ChapecoenseSport,0
81,81,5069,2015,9,27/6/2015,Corinthians,Figueirense,0,2,0,0,0,2,0,2,2,10,11,21,CorinthiansFigueirense,0
82,82,5070,2015,9,28/6/2015,Atletico-MG,Joinville,2,1,0,0,2,1,0,3,3,11,13,24,Atletico-MGJoinville,0
83,83,5071,2015,9,28/6/2015,Palmeiras,Sao Paulo,1,3,0,0,1,3,0,4,4,18,14,32,PalmeirasSao Paulo,1
84,84,5072,2015,9,28/6/2015,Goias,Fluminense,2,2,0,1,2,3,1,4,5,15,12,27,GoiasFluminense,0
85,85,5073,2015,9,28/6/2015,Ponte Preta,Athletico-PR,1,2,0,0,1,2,0,3,3,16,27,43,Ponte PretaAthletico-PR,0
86,86,5074,2015,9,28/6/2015,Coritiba,Cruzeiro,5,5,0,0,5,5,0,10,10,22,15,37,CoritibaCruzeiro,0
87,87,5075,2015,9,28/6/2015,Vasco,Flamengo,4,0,0,0,4,0,0,4,4,18,10,28,VascoFlamengo,1
88,88,5076,2015,9,28/6/2015,Internacional,Santos,3,3,0,1,3,4,1,6,7,4,12,16,InternacionalSantos,0
89,89,5077,2015,10,1/7/2015,Sport,Internacional,2,2,0,1,2,3,1,4,5,13,8,21,SportInternacional,0
90,90,5078,2015,10,1/7/2015,Vasco,Avai,3,2,1,1,4,3,2,5,7,16,11,27,VascoAvai,0
91,91,5079,2015,10,1/7/2015,Palmeiras,Chapecoense,0,3,0,0,0,3,0,3,3,15,17,32,PalmeirasChapecoense,0
92,92,5080,2015,10,1/7/2015,Atletico-MG,Coritiba,3,5,0,0,3,5,0,8,8,8,11,19,Atletico-MGCoritiba,0
93,93,5081,2015,10,1/7/2015,Joinville,Flamengo,3,2,0,0,3,2,0,5,5,14,11,25,JoinvilleFlamengo,0
94,94,5082,2015,10,1/7/2015,Gremio,Cruzeiro,5,6,0,0,5,6,0,11,11,21,21,42,GremioCruzeiro,0
95,95,5083,2015,10,1/7/2015,Athletico-PR,Sao Paulo,2,0,0,0,2,0,0,2,2,17,8,25,Athletico-PRSao Paulo,0
96,96,5084,2015,10,2/7/2015,Corinthians,Ponte Preta,1,2,0,0,1,2,0,3,3,5,12,17,CorinthiansPonte Preta,1
97,97,5085,2015,10,2/7/2015,Figueirense,Goias,2,2,1,0,3,2,1,4,5,17,20,37,FigueirenseGoias,0
98,98,5086,2015,10,2/7/2015,Fluminense,Santos,2,3,0,0,2,3,0,5,5,7,21,28,FluminenseSantos,0
99,99,5087,2015,11,4/7/2015,Coritiba,Joinville,1,2,0,0,1,2,0,3,3,22,17,39,CoritibaJoinville,0
100,100,5088,2015,11,4/7/2015,Chapecoense,Vasco,1,2,0,2,1,4,2,3,5,12,12,24,ChapecoenseVasco,0
101,101,5089,2015,11,4/7/2015,Cruzeiro,Athletico-PR,0,2,0,1,0,3,1,2,3,10,18,28,CruzeiroAthletico-PR,0
102,102,5090,2015,11,5/7/2015,Avai,Sport,6,2,1,0,7,2,1,8,9,16,14,30,AvaiSport,0
103,103,5091,2015,11,5/7/2015,Goias,Corinthians,2,2,0,0,2,2,0,4,4,12,12,24,GoiasCorinthians,0
104,104,5092,2015,11,5/7/2015,Sao Paulo,Fluminense,1,2,0,0,1,2,0,3,3,18,16,34,Sao PauloFluminense,0
105,105,5093,2015,11,5/7/2015,Santos,Gremio,4,1,1,0,5,1,1,5,6,13,12,25,SantosGremio,0
106,106,5094,2015,11,5/7/2015,Ponte Preta,Palmeiras,3,3,0,0,3,3,0,6,6,12,22,34,Ponte PretaPalmeiras,1
107,107,5095,2015,11,5/7/2015,Flamengo,Figueirense,3,2,0,0,3,2,0,5,5,9,20,29,FlamengoFigueirense,0
108,108,5096,2015,11,5/7/2015,Internacional,Atletico-MG,1,3,1,0,2,3,1,4,5,5,11,16,InternacionalAtletico-MG,0
109,109,5097,2015,12,8/7/2015,Chapecoense,Gremio,1,2,0,0,1,2,0,3,3,8,7,15,ChapecoenseGremio,0
110,110,5098,2015,12,8/7/2015,Goias,Santos,0,3,0,0,0,3,0,3,3,7,8,15,GoiasSantos,0
111,111,5099,2015,12,8/7/2015,Coritiba,Ponte Preta,4,6,0,0,4,6,0,10,10,18,17,35,CoritibaPonte Preta,0
112,112,5100,2015,12,8/7/2015,Figueirense,Joinville,1,2,0,0,1,2,0,3,3,11,21,32,FigueirenseJoinville,1
113,113,5101,2015,12,8/7/2015,Palmeiras,Avai,2,6,0,0,2,6,0,8,8,12,11,23,PalmeirasAvai,0
114,114,5102,2015,12,8/7/2015,Atletico-MG,Sport,2,2,0,0,2,2,0,4,4,17,12,29,Atletico-MGSport,0
115,115,5103,2015,12,8/7/2015,Internacional,Flamengo,3,2,0,0,3,2,0,5,5,17,19,36,InternacionalFlamengo,0
116,116,5104,2015,12,8/7/2015,Vasco,Sao Paulo,3,0,0,0,3,0,0,3,3,12,10,22,VascoSao Paulo,0
117,117,5105,2015,12,9/7/2015,Corinthians,Athletico-PR,1,2,0,0,1,2,0,3,3,6,13,19,CorinthiansAthletico-PR,0
118,118,5106,2015,12,9/7/2015,Fluminense,Cruzeiro,2,2,0,0,2,2,0,4,4,10,15,25,FluminenseCruzeiro,0
119,119,5107,2015,13,11/7/2015,Santos,Figueirense,1,5,0,0,1,5,0,6,6,12,12,24,SantosFigueirense,0
120,120,5108,2015,13,11/7/2015,Gremio,Vasco,1,3,0,0,1,3,0,4,4,16,12,28,GremioVasco,0
121,121,5109,2015,13,11/7/2015,Ponte Preta,Atletico-MG,1,3,0,0,1,3,0,4,4,13,19,32,Ponte PretaAtletico-MG,0
122,122,5110,2015,13,12/7/2015,Sao Paulo,Coritiba,1,3,0,0,1,3,0,4,4,18,14,32,Sao PauloCoritiba,0
123,123,5111,2015,13,12/7/2015,Joinville,Internacional,4,3,0,0,4,3,0,7,7,17,19,36,JoinvilleInternacional,0
124,124,5112,2015,13,12/7/2015,Flamengo,Corinthians,0,2,0,0,0,2,0,2,2,7,15,22,FlamengoCorinthians,0
125,125,5113,2015,13,12/7/2015,Athletico-PR,Fluminense,1,2,0,0,1,2,0,3,3,12,11,23,Athletico-PRFluminense,0
126,126,5114,2015,13,12/7/2015,Cruzeiro,Goias,2,1,0,0,2,1,0,3,3,17,13,30,CruzeiroGoias,0
127,127,5115,2015,13,12/7/2015,Sport,Palmeiras,2,1,0,0,2,1,0,3,3,10,17,27,SportPalmeiras,0
128,128,5116,2015,13,12/7/2015,Avai,Chapecoense,4,2,0,0,4,2,0,6,6,15,14,29,AvaiChapecoense,1
129,129,5117,2015,14,18/7/2015,Internacional,Goias,1,1,0,0,1,1,0,2,2,18,12,30,InternacionalGoias,0
130,130,5118,2015,14,18/7/2015,Flamengo,Gremio,1,5,0,0,1,5,0,6,6,12,11,23,FlamengoGremio,0
131,131,5119,2015,14,18/7/2015,Corinthians,Atletico-MG,1,1,0,0,1,1,0,2,2,12,15,27,CorinthiansAtletico-MG,0
132,132,5120,2015,14,19/7/2015,Athletico-PR,Chapecoense,2,3,0,0,2,3,0,5,5,14,13,27,Athletico-PRChapecoense,0
133,133,5121,2015,14,19/7/2015,Figueirense,Coritiba,1,2,0,0,1,2,0,3,3,20,18,38,FigueirenseCoritiba,0
134,134,5122,2015,14,19/7/2015,Sport,Sao Paulo,1,2,0,2,1,4,2,3,5,9,12,21,SportSao Paulo,0
135,135,5123,2015,14,19/7/2015,Fluminense,Vasco,2,6,0,0,2,6,0,8,8,15,17,32,FluminenseVasco,1
136,136,5124,2015,14,19/7/2015,Palmeiras,Santos,3,3,0,0,3,3,0,6,6,24,10,34,PalmeirasSantos,1
137,137,5125,2015,14,19/7/2015,Cruzeiro,Avai,1,3,0,0,1,3,0,4,4,7,16,23,CruzeiroAvai,0
138,138,5126,2015,14,19/7/2015,Joinville,Ponte Preta,2,5,0,0,2,5,0,7,7,11,14,25,JoinvillePonte Preta,0
139,139,5127,2015,15,25/7/2015,Avai,Athletico-PR,3,3,0,0,3,3,0,6,6,5,17,22,AvaiAthletico-PR,0
2988,2988,5128,2015,15,25/7/2015,Gremio,Sport,0,0,0,0,0,0,0,0,0,6,8,14,GremioSport,0
140,140,5129,2015,15,25/7/2015,Atletico-MG,Figueirense,2,4,0,0,2,4,0,6,6,16,19,35,Atletico-MGFigueirense,0
141,141,5130,2015,15,26/7/2015,Chapecoense,Fluminense,2,3,0,1,2,4,1,5,6,15,16,31,ChapecoenseFluminense,0
142,142,5131,2015,15,26/7/2015,Santos,Joinville,2,2,0,0,2,2,0,4,4,4,12,16,SantosJoinville,0
143,143,5132,2015,15,26/7/2015,Ponte Preta,Internacional,2,2,0,0,2,2,0,4,4,10,19,29,Ponte PretaInternacional,0
144,144,5133,2015,15,26/7/2015,Coritiba,Corinthians,3,3,0,0,3,3,0,6,6,7,18,25,CoritibaCorinthians,0
145,145,5134,2015,15,26/7/2015,Sao Paulo,Cruzeiro,0,1,0,0,0,1,0,1,1,16,14,30,Sao PauloCruzeiro,0
146,146,5135,2015,15,26/7/2015,Goias,Flamengo,2,1,0,0,2,1,0,3,3,11,6,17,GoiasFlamengo,0
147,147,5136,2015,15,26/7/2015,Vasco,Palmeiras,3,1,0,0,3,1,0,4,4,14,21,35,VascoPalmeiras,0
148,148,5137,2015,16,29/7/2015,Corinthians,Vasco,0,3,0,0,0,3,0,3,3,7,15,22,CorinthiansVasco,0
149,149,5138,2015,16,29/7/2015,Atletico-MG,Sao Paulo,0,1,0,0,0,1,0,1,1,6,6,12,Atletico-MGSao Paulo,0
150,150,5139,2015,16,1/8/2015,Fluminense,Gremio,3,2,0,1,3,3,1,5,6,16,13,29,FluminenseGremio,0
151,151,5140,2015,16,2/8/2015,Coritiba,Goias,4,4,0,0,4,4,0,8,8,11,19,30,CoritibaGoias,0
152,152,5141,2015,16,2/8/2015,Palmeiras,Athletico-PR,1,2,0,0,1,2,0,3,3,13,18,31,PalmeirasAthletico-PR,0
153,153,5142,2015,16,2/8/2015,Joinville,Avai,2,1,0,0,2,1,0,3,3,22,9,31,JoinvilleAvai,1
154,154,5143,2015,16,2/8/2015,Internacional,Chapecoense,3,2,0,0,3,2,0,5,5,4,13,17,InternacionalChapecoense,0
155,155,5144,2015,16,2/8/2015,Figueirense,Ponte Preta,2,3,0,0,2,3,0,5,5,19,18,37,FigueirensePonte Preta,0
156,156,5145,2015,16,2/8/2015,Flamengo,Santos,4,2,0,0,4,2,0,6,6,17,14,31,FlamengoSantos,0
157,157,5146,2015,16,2/8/2015,Sport,Cruzeiro,1,2,0,0,1,2,0,3,3,15,17,32,SportCruzeiro,0
158,158,5147,2015,17,8/8/2015,Avai,Fluminense,2,2,0,0,2,2,0,4,4,14,12,26,AvaiFluminense,0
159,159,5148,2015,17,8/8/2015,Santos,Coritiba,1,4,0,0,1,4,0,5,5,12,15,27,SantosCoritiba,0
2989,2989,5149,2015,17,9/8/2015,Athletico-PR,Sport,0,0,0,0,0,0,0,0,0,6,11,17,Athletico-PRSport,0
160,160,5150,2015,17,9/8/2015,Vasco,Joinville,2,4,0,0,2,4,0,6,6,17,21,38,VascoJoinville,0
161,161,5151,2015,17,9/8/2015,Sao Paulo,Corinthians,4,2,0,1,4,3,1,6,7,13,16,29,Sao PauloCorinthians,1
162,162,5152,2015,17,9/8/2015,Cruzeiro,Palmeiras,4,3,0,0,4,3,0,7,7,21,18,39,CruzeiroPalmeiras,0
163,163,5153,2015,17,9/8/2015,Ponte Preta,Flamengo,2,4,0,0,2,4,0,6,6,17,16,33,Ponte PretaFlamengo,0
164,164,5154,2015,17,9/8/2015,Goias,Atletico-MG,2,2,0,0,2,2,0,4,4,8,11,19,GoiasAtletico-MG,0
165,165,5155,2015,17,9/8/2015,Gremio,Internacional,2,4,0,0,2,4,0,6,6,16,12,28,GremioInternacional,1
166,166,5156,2015,17,9/8/2015,Chapecoense,Figueirense,1,1,0,0,1,1,0,2,2,20,13,33,ChapecoenseFigueirense,1
167,167,5157,2015,18,12/8/2015,Coritiba,Palmeiras,3,1,0,0,3,1,0,4,4,14,11,25,CoritibaPalmeiras,0
168,168,5158,2015,18,12/8/2015,Flamengo,Athletico-PR,2,4,0,1,2,5,1,6,7,10,16,26,FlamengoAthletico-PR,0
169,169,5159,2015,18,12/8/2015,Santos,Vasco,3,5,0,1,3,6,1,8,9,12,22,34,SantosVasco,0
170,170,5160,2015,18,12/8/2015,Goias,Chapecoense,1,3,0,0,1,3,0,4,4,6,16,22,GoiasChapecoense,0
171,171,5161,2015,18,12/8/2015,Figueirense,Sao Paulo,3,4,0,1,3,5,1,7,8,18,18,36,FigueirenseSao Paulo,0
172,172,5162,2015,18,12/8/2015,Internacional,Fluminense,6,4,0,2,6,6,2,10,12,20,14,34,InternacionalFluminense,0
173,173,5163,2015,18,12/8/2015,Corinthians,Sport,2,1,0,0,2,1,0,3,3,11,8,19,CorinthiansSport,0
174,174,5164,2015,18,13/8/2015,Ponte Preta,Avai,1,1,0,0,1,1,0,2,2,13,6,19,Ponte PretaAvai,0
175,175,5165,2015,18,13/8/2015,Joinville,Cruzeiro,1,2,0,0,1,2,0,3,3,10,10,20,JoinvilleCruzeiro,0
176,176,5166,2015,18,13/8/2015,Atletico-MG,Gremio,2,3,0,0,2,3,0,5,5,10,12,22,Atletico-MGGremio,0
177,177,5167,2015,19,15/8/2015,Vasco,Coritiba,3,1,0,0,3,1,0,4,4,12,19,31,VascoCoritiba,0
178,178,5168,2015,19,15/8/2015,Athletico-PR,Santos,2,1,1,0,3,1,1,3,4,10,13,23,Athletico-PRSantos,0
179,179,5169,2015,19,15/8/2015,Sao Paulo,Goias,1,0,0,0,1,0,0,1,1,4,4,8,Sao PauloGoias,0
180,180,5170,2015,19,16/8/2015,Palmeiras,Flamengo,2,2,0,0,2,2,0,4,4,18,15,33,PalmeirasFlamengo,0
181,181,5171,2015,19,16/8/2015,Avai,Corinthians,0,1,0,0,0,1,0,1,1,15,8,23,AvaiCorinthians,0
182,182,5172,2015,19,16/8/2015,Fluminense,Figueirense,1,2,0,1,1,3,1,3,4,14,18,32,FluminenseFigueirense,0
183,183,5173,2015,19,16/8/2015,Cruzeiro,Internacional,2,2,0,0,2,2,0,4,4,14,22,36,CruzeiroInternacional,0
2990,2990,5174,2015,19,16/8/2015,Sport,Ponte Preta,0,0,0,0,0,0,0,0,0,7,16,23,SportPonte Preta,0
184,184,5175,2015,19,16/8/2015,Gremio,Joinville,1,0,0,0,1,0,0,1,1,10,18,28,GremioJoinville,0
185,185,5176,2015,19,16/8/2015,Chapecoense,Atletico-MG,4,3,0,1,4,4,1,7,8,12,8,20,ChapecoenseAtletico-MG,0
186,186,5177,2015,20,22/8/2015,Goias,Vasco,3,3,0,2,3,5,2,6,8,16,13,29,GoiasVasco,0
187,187,5178,2015,20,22/8/2015,Santos,Avai,1,3,0,0,1,3,0,4,4,14,12,26,SantosAvai,0
188,188,5179,2015,20,22/8/2015,Figueirense,Sport,1,3,0,0,1,3,0,4,4,19,13,32,FigueirenseSport,0
189,189,5180,2015,20,23/8/2015,Coritiba,Chapecoense,3,3,0,0,3,3,0,6,6,19,17,36,CoritibaChapecoense,0
190,190,5181,2015,20,23/8/2015,Ponte Preta,Gremio,1,1,0,0,1,1,0,2,2,12,13,25,Ponte PretaGremio,0
191,191,5182,2015,20,23/8/2015,Joinville,Fluminense,3,2,0,0,3,2,0,5,5,26,15,41,JoinvilleFluminense,0
192,192,5183,2015,20,23/8/2015,Internacional,Athletico-PR,1,3,0,0,1,3,0,4,4,10,12,22,InternacionalAthletico-PR,0
193,193,5184,2015,20,23/8/2015,Corinthians,Cruzeiro,2,1,0,0,2,1,0,3,3,12,7,19,CorinthiansCruzeiro,0
194,194,5185,2015,20,23/8/2015,Flamengo,Sao Paulo,4,2,0,0,4,2,0,6,6,25,15,40,FlamengoSao Paulo,0
195,195,5186,2015,20,23/8/2015,Atletico-MG,Palmeiras,1,3,0,0,1,3,0,4,4,13,12,25,Atletico-MGPalmeiras,0
196,196,5187,2015,21,29/8/2015,Vasco,Figueirense,2,4,0,0,2,4,0,6,6,11,19,30,VascoFigueirense,0
197,197,5188,2015,21,29/8/2015,Sao Paulo,Ponte Preta,4,0,0,0,4,0,0,4,4,16,11,27,Sao PauloPonte Preta,1
198,198,5189,2015,21,30/8/2015,Gremio,Coritiba,5,5,0,0,5,5,0,10,10,13,15,28,GremioCoritiba,0
199,199,5190,2015,21,30/8/2015,Avai,Internacional,2,2,0,0,2,2,0,4,4,14,12,26,AvaiInternacional,0
200,200,5191,2015,21,30/8/2015,Palmeiras,Joinville,0,3,0,0,0,3,0,3,3,9,18,27,PalmeirasJoinville,0
201,201,5192,2015,21,30/8/2015,Fluminense,Atletico-MG,3,4,0,0,3,4,0,7,7,23,16,39,FluminenseAtletico-MG,0
202,202,5193,2015,21,30/8/2015,Sport,Flamengo,1,5,1,0,2,5,1,6,7,6,19,25,SportFlamengo,0
203,203,5194,2015,21,30/8/2015,Chapecoense,Corinthians,2,3,0,0,2,3,0,5,5,14,11,25,ChapecoenseCorinthians,0
204,204,5195,2015,21,30/8/2015,Cruzeiro,Santos,3,2,1,0,4,2,1,5,6,17,12,29,CruzeiroSantos,0
205,205,5196,2015,21,30/8/2015,Athletico-PR,Goias,1,3,0,0,1,3,0,4,4,12,13,25,Athletico-PRGoias,0
206,206,5197,2015,22,2/9/2015,Joinville,Sao Paulo,4,5,0,0,4,5,0,9,9,23,14,37,JoinvilleSao Paulo,0
207,207,5198,2015,22,2/9/2015,Ponte Preta,Cruzeiro,2,5,1,0,3,5,1,7,8,19,22,41,Ponte PretaCruzeiro,0
208,208,5199,2015,22,2/9/2015,Internacional,Vasco,3,1,0,0,3,1,0,4,4,22,10,32,InternacionalVasco,0
209,209,5200,2015,22,2/9/2015,Flamengo,Avai,1,4,0,0,1,4,0,5,5,14,18,32,FlamengoAvai,0
210,210,5201,2015,22,2/9/2015,Atletico-MG,Athletico-PR,5,4,1,0,6,4,1,9,10,18,16,34,Atletico-MGAthletico-PR,0
211,211,5202,2015,22,2/9/2015,Coritiba,Sport,2,2,0,0,2,2,0,4,4,16,14,30,CoritibaSport,0
212,212,5203,2015,22,2/9/2015,Corinthians,Fluminense,0,3,0,0,0,3,0,3,3,12,11,23,CorinthiansFluminense,0
213,213,5204,2015,22,2/9/2015,Goias,Palmeiras,3,3,0,0,3,3,0,6,6,11,14,25,GoiasPalmeiras,0
214,214,5205,2015,22,3/9/2015,Santos,Chapecoense,0,1,0,0,0,1,0,1,1,16,12,28,SantosChapecoense,0
215,215,5206,2015,22,3/9/2015,Figueirense,Gremio,4,4,0,0,4,4,0,8,8,14,9,23,FigueirenseGremio,0
2991,2991,5207,2015,23,5/9/2015,Sao Paulo,Internacional,0,0,0,0,0,0,0,0,0,10,10,20,Sao PauloInternacional,0
216,216,5208,2015,23,5/9/2015,Vasco,Atletico-MG,3,2,1,0,4,2,1,5,6,19,16,35,VascoAtletico-MG,0
217,217,5209,2015,23,5/9/2015,Athletico-PR,Joinville,4,3,1,3,5,6,4,7,11,15,17,32,Athletico-PRJoinville,0
218,218,5210,2015,23,6/9/2015,Cruzeiro,Figueirense,0,4,0,0,0,4,0,4,4,15,15,30,CruzeiroFigueirense,0
219,219,5211,2015,23,6/9/2015,Chapecoense,Ponte Preta,1,2,0,0,1,2,0,3,3,9,17,26,ChapecoensePonte Preta,0
220,220,5212,2015,23,6/9/2015,Gremio,Goias,3,4,0,1,3,5,1,7,8,15,12,27,GremioGoias,0
221,221,5213,2015,23,6/9/2015,Palmeiras,Corinthians,6,3,0,0,6,3,0,9,9,20,14,34,PalmeirasCorinthians,1
222,222,5214,2015,23,6/9/2015,Avai,Coritiba,2,4,0,0,2,4,0,6,6,19,22,41,AvaiCoritiba,0
223,223,5215,2015,23,6/9/2015,Fluminense,Flamengo,6,6,0,1,6,7,1,12,13,13,24,37,FluminenseFlamengo,1
224,224,5216,2015,23,6/9/2015,Sport,Santos,1,0,0,0,1,0,0,1,1,9,9,18,SportSantos,0
225,225,5217,2015,24,9/9/2015,Ponte Preta,Vasco,3,1,1,0,4,1,1,4,5,20,23,43,Ponte PretaVasco,0
226,226,5218,2015,24,9/9/2015,Atletico-MG,Avai,3,3,0,0,3,3,0,6,6,17,16,33,Atletico-MGAvai,0
227,227,5219,2015,24,9/9/2015,Internacional,Palmeiras,5,3,1,1,6,4,2,8,10,21,23,44,InternacionalPalmeiras,0
228,228,5220,2015,24,9/9/2015,Figueirense,Athletico-PR,2,2,0,0,2,2,0,4,4,7,9,16,FigueirenseAthletico-PR,0
229,229,5221,2015,24,9/9/2015,Coritiba,Fluminense,1,4,0,0,1,4,0,5,5,11,24,35,CoritibaFluminense,0
230,230,5222,2015,24,9/9/2015,Santos,Sao Paulo,1,1,0,0,1,1,0,2,2,11,9,20,SantosSao Paulo,1
231,231,5223,2015,24,9/9/2015,Corinthians,Gremio,0,3,0,0,0,3,0,3,3,7,6,13,CorinthiansGremio,0
232,232,5224,2015,24,10/9/2015,Goias,Sport,3,1,0,0,3,1,0,4,4,8,6,14,GoiasSport,0
233,233,5225,2015,24,10/9/2015,Joinville,Chapecoense,4,2,0,0,4,2,0,6,6,13,10,23,JoinvilleChapecoense,1
234,234,5226,2015,24,10/9/2015,Flamengo,Cruzeiro,3,3,0,0,3,3,0,6,6,18,10,28,FlamengoCruzeiro,0
235,235,5227,2015,25,12/9/2015,Coritiba,Internacional,4,7,0,0,4,7,0,11,11,13,26,39,CoritibaInternacional,0
236,236,5228,2015,25,12/9/2015,Palmeiras,Figueirense,4,4,0,1,4,5,1,8,9,19,18,37,PalmeirasFigueirense,0
237,237,5229,2015,25,13/9/2015,Ponte Preta,Santos,5,2,0,0,5,2,0,7,7,22,15,37,Ponte PretaSantos,1
238,238,5230,2015,25,13/9/2015,Corinthians,Joinville,0,1,0,0,0,1,0,1,1,10,17,27,CorinthiansJoinville,0
239,239,5231,2015,25,13/9/2015,Cruzeiro,Atletico-MG,3,5,1,0,4,5,1,8,9,17,16,33,CruzeiroAtletico-MG,1
240,240,5232,2015,25,13/9/2015,Gremio,Sao Paulo,3,3,0,0,3,3,0,6,6,11,13,24,GremioSao Paulo,0
241,241,5233,2015,25,13/9/2015,Chapecoense,Flamengo,2,1,0,0,2,1,0,3,3,13,12,25,ChapecoenseFlamengo,0
242,242,5234,2015,25,13/9/2015,Vasco,Athletico-PR,2,2,0,0,2,2,0,4,4,18,20,38,VascoAthletico-PR,0
243,243,5235,2015,25,13/9/2015,Avai,Goias,2,2,0,0,2,2,0,4,4,18,19,37,AvaiGoias,0
244,244,5236,2015,25,13/9/2015,Sport,Fluminense,2,3,0,0,2,3,0,5,5,19,17,36,SportFluminense,0
245,245,5237,2015,26,16/9/2015,Joinville,Sport,4,3,0,0,4,3,0,7,7,19,11,30,JoinvilleSport,0
246,246,5238,2015,26,16/9/2015,Fluminense,Palmeiras,1,3,0,0,1,3,0,4,4,14,19,33,FluminensePalmeiras,0
247,247,5239,2015,26,16/9/2015,Goias,Ponte Preta,2,5,0,0,2,5,0,7,7,12,11,23,GoiasPonte Preta,0
248,248,5240,2015,26,16/9/2015,Figueirense,Avai,2,4,0,0,2,4,0,6,6,16,23,39,FigueirenseAvai,1
249,249,5241,2015,26,16/9/2015,Athletico-PR,Gremio,1,2,0,0,1,2,0,3,3,13,5,18,Athletico-PRGremio,0
250,250,5242,2015,26,16/9/2015,Santos,Atletico-MG,1,1,0,0,1,1,0,2,2,7,11,18,SantosAtletico-MG,0
251,251,5243,2015,26,16/9/2015,Internacional,Corinthians,2,1,0,0,2,1,0,3,3,15,12,27,InternacionalCorinthians,0
252,252,5244,2015,26,16/9/2015,Cruzeiro,Vasco,4,3,0,1,4,4,1,7,8,15,4,19,CruzeiroVasco,0
253,253,5245,2015,26,17/9/2015,Sao Paulo,Chapecoense,2,2,0,0,2,2,0,4,4,12,14,26,Sao PauloChapecoense,0
254,254,5246,2015,26,17/9/2015,Flamengo,Coritiba,2,3,0,0,2,3,0,5,5,12,21,33,FlamengoCoritiba,0
255,255,5247,2015,27,19/9/2015,Palmeiras,Gremio,2,4,0,0,2,4,0,6,6,22,17,39,PalmeirasGremio,0
256,256,5248,2015,27,19/9/2015,Internacional,Figueirense,1,5,0,0,1,5,0,6,6,22,22,44,InternacionalFigueirense,0
257,257,5249,2015,27,19/9/2015,Ponte Preta,Fluminense,3,4,0,0,3,4,0,7,7,14,14,28,Ponte PretaFluminense,0
258,258,5250,2015,27,20/9/2015,Goias,Joinville,0,1,0,0,0,1,0,1,1,6,12,18,GoiasJoinville,0
259,259,5251,2015,27,20/9/2015,Corinthians,Santos,2,5,0,2,2,7,2,7,9,8,10,18,CorinthiansSantos,1
260,260,5252,2015,27,20/9/2015,Vasco,Sport,2,2,0,0,2,2,0,4,4,13,10,23,VascoSport,0
261,261,5253,2015,27,20/9/2015,Atletico-MG,Flamengo,2,2,0,0,2,2,0,4,4,16,16,32,Atletico-MGFlamengo,0
262,262,5254,2015,27,20/9/2015,Avai,Sao Paulo,3,4,0,0,3,4,0,7,7,17,19,36,AvaiSao Paulo,0
263,263,5255,2015,27,20/9/2015,Chapecoense,Cruzeiro,2,1,0,1,2,2,1,3,4,15,12,27,ChapecoenseCruzeiro,0
264,264,5256,2015,27,20/9/2015,Coritiba,Athletico-PR,7,3,1,0,8,3,1,10,11,19,23,42,CoritibaAthletico-PR,1
265,265,5257,2015,28,26/9/2015,Fluminense,Goias,4,3,0,0,4,3,0,7,7,27,15,42,FluminenseGoias,0
266,266,5258,2015,28,26/9/2015,Gremio,Avai,1,3,0,0,1,3,0,4,4,13,12,25,GremioAvai,0
267,267,5259,2015,28,27/9/2015,Athletico-PR,Ponte Preta,2,4,0,0,2,4,0,6,6,16,18,34,Athletico-PRPonte Preta,0
268,268,5260,2015,28,27/9/2015,Santos,Internacional,1,4,0,0,1,4,0,5,5,8,17,25,SantosInternacional,0
269,269,5261,2015,28,27/9/2015,Flamengo,Vasco,5,6,0,0,5,6,0,11,11,26,21,47,FlamengoVasco,1
270,270,5262,2015,28,27/9/2015,Joinville,Atletico-MG,2,2,0,0,2,2,0,4,4,19,8,27,JoinvilleAtletico-MG,0
271,271,5263,2015,28,27/9/2015,Figueirense,Corinthians,3,3,0,0,3,3,0,6,6,21,14,35,FigueirenseCorinthians,0
272,272,5264,2015,28,27/9/2015,Sao Paulo,Palmeiras,1,2,0,0,1,2,0,3,3,13,17,30,Sao PauloPalmeiras,1
273,273,5265,2015,28,27/9/2015,Sport,Chapecoense,3,0,0,0,3,0,0,3,3,17,8,25,SportChapecoense,0
274,274,5266,2015,28,27/9/2015,Cruzeiro,Coritiba,0,1,1,1,1,2,2,1,3,13,13,26,CruzeiroCoritiba,0
275,275,5267,2015,29,3/10/2015,Internacional,Sport,2,2,0,1,2,3,1,4,5,16,11,27,InternacionalSport,0
276,276,5268,2015,29,3/10/2015,Coritiba,Atletico-MG,1,2,0,0,1,2,0,3,3,6,11,17,CoritibaAtletico-MG,0
277,277,5269,2015,29,3/10/2015,Sao Paulo,Athletico-PR,1,3,0,0,1,3,0,4,4,12,16,28,Sao PauloAthletico-PR,0
278,278,5270,2015,29,4/10/2015,Avai,Vasco,4,6,1,2,5,8,3,10,13,18,18,36,AvaiVasco,0
279,279,5271,2015,29,4/10/2015,Flamengo,Joinville,2,3,0,0,2,3,0,5,5,17,27,44,FlamengoJoinville,0
280,280,5272,2015,29,4/10/2015,Santos,Fluminense,3,2,0,0,3,2,0,5,5,24,12,36,SantosFluminense,0
281,281,5273,2015,29,4/10/2015,Cruzeiro,Gremio,3,3,0,0,3,3,0,6,6,9,15,24,CruzeiroGremio,0
282,282,5274,2015,29,4/10/2015,Goias,Figueirense,1,5,0,1,1,6,1,6,7,15,11,26,GoiasFigueirense,0
283,283,5275,2015,29,4/10/2015,Ponte Preta,Corinthians,2,4,1,0,3,4,1,6,7,17,15,32,Ponte PretaCorinthians,1
284,284,5276,2015,29,4/10/2015,Chapecoense,Palmeiras,0,5,0,0,0,5,0,5,5,17,17,34,ChapecoensePalmeiras,0
285,285,5277,2015,30,14/10/2015,Atletico-MG,Internacional,2,3,0,0,2,3,0,5,5,14,11,25,Atletico-MGInternacional,0
286,286,5278,2015,30,14/10/2015,Sport,Avai,2,5,0,0,2,5,0,7,7,8,16,24,SportAvai,0
287,287,5279,2015,30,14/10/2015,Joinville,Coritiba,6,1,0,0,6,1,0,7,7,23,16,39,JoinvilleCoritiba,0
288,288,5280,2015,30,14/10/2015,Figueirense,Flamengo,1,1,0,0,1,1,0,2,2,14,10,24,FigueirenseFlamengo,0
289,289,5281,2015,30,14/10/2015,Palmeiras,Ponte Preta,2,3,0,0,2,3,0,5,5,18,17,35,PalmeirasPonte Preta,1
290,290,5282,2015,30,14/10/2015,Fluminense,Sao Paulo,0,4,0,0,0,4,0,4,4,16,21,37,FluminenseSao Paulo,0
291,291,5283,2015,30,14/10/2015,Athletico-PR,Cruzeiro,5,2,0,0,5,2,0,7,7,20,7,27,Athletico-PRCruzeiro,0
292,292,5284,2015,30,15/10/2015,Vasco,Chapecoense,4,5,0,0,4,5,0,9,9,16,19,35,VascoChapecoense,0
293,293,5285,2015,30,15/10/2015,Corinthians,Goias,1,5,0,0,1,5,0,6,6,9,10,19,CorinthiansGoias,0
294,294,5286,2015,30,15/10/2015,Gremio,Santos,3,3,0,1,3,4,1,6,7,14,4,18,GremioSantos,0
295,295,5287,2015,31,17/10/2015,Avai,Palmeiras,3,4,0,0,3,4,0,7,7,14,29,43,AvaiPalmeiras,0
296,296,5288,2015,31,17/10/2015,Joinville,Figueirense,2,3,1,0,3,3,1,5,6,24,16,40,JoinvilleFigueirense,1
297,297,5289,2015,31,18/10/2015,Ponte Preta,Coritiba,3,3,0,0,3,3,0,6,6,30,27,57,Ponte PretaCoritiba,0
298,298,5290,2015,31,18/10/2015,Cruzeiro,Fluminense,2,1,0,0,2,1,0,3,3,13,14,27,CruzeiroFluminense,0
299,299,5291,2015,31,18/10/2015,Athletico-PR,Corinthians,2,1,0,0,2,1,0,3,3,11,12,23,Athletico-PRCorinthians,0
300,300,5292,2015,31,18/10/2015,Flamengo,Internacional,0,2,0,0,0,2,0,2,2,19,24,43,FlamengoInternacional,0
301,301,5293,2015,31,18/10/2015,Sao Paulo,Vasco,2,1,1,0,3,1,1,3,4,11,16,27,Sao PauloVasco,0
302,302,5294,2015,31,18/10/2015,Gremio,Chapecoense,3,2,0,1,3,3,1,5,6,17,13,30,GremioChapecoense,0
303,303,5295,2015,31,18/10/2015,Santos,Goias,0,1,0,0,0,1,0,1,1,9,8,17,SantosGoias,0
304,304,5296,2015,31,18/10/2015,Sport,Atletico-MG,0,1,0,1,0,2,1,1,2,13,8,21,SportAtletico-MG,0
305,305,5297,2015,32,24/10/2015,Fluminense,Athletico-PR,1,3,0,0,1,3,0,4,4,4,21,25,FluminenseAthletico-PR,0
306,306,5298,2015,32,24/10/2015,Internacional,Joinville,1,2,0,0,1,2,0,3,3,11,18,29,InternacionalJoinville,0
307,307,5299,2015,32,24/10/2015,Figueirense,Santos,5,2,0,0,5,2,0,7,7,24,20,44,FigueirenseSantos,0
308,308,5300,2015,32,24/10/2015,Palmeiras,Sport,2,1,0,0,2,1,0,3,3,15,9,24,PalmeirasSport,0
309,309,5301,2015,32,25/10/2015,Corinthians,Flamengo,3,2,0,1,3,3,1,5,6,19,20,39,CorinthiansFlamengo,0
310,310,5302,2015,32,25/10/2015,Coritiba,Sao Paulo,4,3,1,0,5,3,1,7,8,17,21,38,CoritibaSao Paulo,0
311,311,5303,2015,32,25/10/2015,Chapecoense,Avai,1,2,0,0,1,2,0,3,3,17,16,33,ChapecoenseAvai,1
312,312,5304,2015,32,25/10/2015,Vasco,Gremio,1,2,0,0,1,2,0,3,3,12,16,28,VascoGremio,0
313,313,5305,2015,32,25/10/2015,Goias,Cruzeiro,4,4,0,0,4,4,0,8,8,14,11,25,GoiasCruzeiro,0
314,314,5306,2015,32,25/10/2015,Atletico-MG,Ponte Preta,2,1,0,0,2,1,0,3,3,15,12,27,Atletico-MGPonte Preta,0
315,315,5307,2015,33,31/10/2015,Sao Paulo,Sport,1,2,0,0,1,2,0,3,3,10,15,25,Sao PauloSport,0
316,316,5308,2015,33,31/10/2015,Avai,Cruzeiro,3,3,0,0,3,3,0,6,6,16,16,32,AvaiCruzeiro,0
317,317,5309,2015,33,31/10/2015,Ponte Preta,Joinville,3,5,0,0,3,5,0,8,8,20,17,37,Ponte PretaJoinville,0
318,318,5310,2015,33,31/10/2015,Coritiba,Figueirense,2,5,0,0,2,5,0,7,7,13,29,42,CoritibaFigueirense,0
319,319,5311,2015,33,1/11/2015,Chapecoense,Athletico-PR,3,4,0,1,3,5,1,7,8,13,12,25,ChapecoenseAthletico-PR,0
320,320,5312,2015,33,1/11/2015,Santos,Palmeiras,3,3,0,1,3,4,1,6,7,15,18,33,SantosPalmeiras,1
321,321,5313,2015,33,1/11/2015,Gremio,Flamengo,0,1,0,1,0,2,1,1,2,12,12,24,GremioFlamengo,0
322,322,5314,2015,33,1/11/2015,Atletico-MG,Corinthians,1,0,0,0,1,0,0,1,1,11,15,26,Atletico-MGCorinthians,0
323,323,5315,2015,33,1/11/2015,Vasco,Fluminense,2,5,0,1,2,6,1,7,8,18,22,40,VascoFluminense,1
324,324,5316,2015,33,1/11/2015,Goias,Internacional,3,3,0,0,3,3,0,6,6,16,12,28,GoiasInternacional,0
325,325,5317,2015,34,7/11/2015,Internacional,Ponte Preta,2,4,0,0,2,4,0,6,6,20,20,40,InternacionalPonte Preta,0
326,326,5318,2015,34,7/11/2015,Corinthians,Coritiba,0,3,0,0,0,3,0,3,3,5,17,22,CorinthiansCoritiba,0
327,327,5319,2015,34,7/11/2015,Athletico-PR,Avai,1,2,0,0,1,2,0,3,3,21,10,31,Athletico-PRAvai,0
328,328,5320,2015,34,7/11/2015,Fluminense,Chapecoense,3,3,0,0,3,3,0,6,6,12,14,26,FluminenseChapecoense,0
329,329,5321,2015,34,8/11/2015,Palmeiras,Vasco,1,4,0,0,1,4,0,5,5,29,13,42,PalmeirasVasco,0
330,330,5322,2015,34,8/11/2015,Flamengo,Goias,1,0,0,0,1,0,0,1,1,16,14,30,FlamengoGoias,0
331,331,5323,2015,34,8/11/2015,Cruzeiro,Sao Paulo,1,2,0,0,1,2,0,3,3,5,12,17,CruzeiroSao Paulo,0
332,332,5324,2015,34,8/11/2015,Figueirense,Atletico-MG,2,4,0,0,2,4,0,6,6,14,13,27,FigueirenseAtletico-MG,0
333,333,5325,2015,34,8/11/2015,Joinville,Santos,3,2,1,0,4,2,1,5,6,22,19,41,JoinvilleSantos,0
334,334,5326,2015,34,8/11/2015,Sport,Gremio,2,3,0,1,2,4,1,5,6,8,16,24,SportGremio,0
335,335,5327,2015,35,15/11/2015,Cruzeiro,Sport,2,4,0,0,2,4,0,6,6,13,15,28,CruzeiroSport,0
336,336,5328,2015,35,18/11/2015,Goias,Coritiba,1,1,0,0,1,1,0,2,2,20,18,38,GoiasCoritiba,0
337,337,5329,2015,35,18/11/2015,Ponte Preta,Figueirense,4,4,0,0,4,4,0,8,8,18,24,42,Ponte PretaFigueirense,0
338,338,5330,2015,35,18/11/2015,Avai,Joinville,4,1,0,0,4,1,0,5,5,12,13,25,AvaiJoinville,1
339,339,5331,2015,35,18/11/2015,Athletico-PR,Palmeiras,2,4,0,2,2,6,2,6,8,13,15,28,Athletico-PRPalmeiras,0
340,340,5332,2015,35,19/11/2015,Gremio,Fluminense,3,4,0,1,3,5,1,7,8,20,21,41,GremioFluminense,0
341,341,5333,2015,35,19/11/2015,Chapecoense,Internacional,4,3,0,1,4,4,1,7,8,16,14,30,ChapecoenseInternacional,0
2992,2992,5334,2015,35,19/11/2015,Sao Paulo,Atletico-MG,0,0,0,0,0,0,0,0,0,7,9,16,Sao PauloAtletico-MG,0
342,342,5335,2015,35,19/11/2015,Santos,Flamengo,2,2,0,1,2,3,1,4,5,20,11,31,SantosFlamengo,0
343,343,5336,2015,35,19/11/2015,Vasco,Corinthians,2,3,1,0,3,3,1,5,6,12,15,27,VascoCorinthians,0
344,344,5337,2015,36,21/11/2015,Palmeiras,Cruzeiro,2,1,0,0,2,1,0,3,3,20,13,33,PalmeirasCruzeiro,0
345,345,5338,2015,36,22/11/2015,Joinville,Vasco,5,4,1,0,6,4,1,9,10,21,10,31,JoinvilleVasco,0
346,346,5339,2015,36,22/11/2015,Atletico-MG,Goias,3,3,0,0,3,3,0,6,6,16,12,28,Atletico-MGGoias,0
347,347,5340,2015,36,22/11/2015,Internacional,Gremio,4,2,0,0,4,2,0,6,6,21,13,34,InternacionalGremio,1
348,348,5341,2015,36,22/11/2015,Figueirense,Chapecoense,1,3,0,0,1,3,0,4,4,13,15,28,FigueirenseChapecoense,1
349,349,5342,2015,36,22/11/2015,Corinthians,Sao Paulo,2,2,0,0,2,2,0,4,4,10,10,20,CorinthiansSao Paulo,1
350,350,5343,2015,36,22/11/2015,Flamengo,Ponte Preta,3,3,0,0,3,3,0,6,6,19,23,42,FlamengoPonte Preta,0
351,351,5344,2015,36,22/11/2015,Fluminense,Avai,2,3,0,0,2,3,0,5,5,11,6,17,FluminenseAvai,0
352,352,5345,2015,36,22/11/2015,Coritiba,Santos,3,3,0,1,3,4,1,6,7,13,21,34,CoritibaSantos,0
353,353,5346,2015,36,22/11/2015,Sport,Athletico-PR,3,2,0,0,3,2,0,5,5,10,20,30,SportAthletico-PR,0
354,354,5347,2015,37,28/11/2015,Sao Paulo,Figueirense,1,4,0,0,1,4,0,5,5,16,26,42,Sao PauloFigueirense,0
355,355,5348,2015,37,28/11/2015,Fluminense,Internacional,3,4,1,0,4,4,1,7,8,13,20,33,FluminenseInternacional,0
356,356,5349,2015,37,28/11/2015,Avai,Ponte Preta,1,2,0,1,1,3,1,3,4,19,27,46,AvaiPonte Preta,0
357,357,5350,2015,37,29/11/2015,Sport,Corinthians,6,3,0,0,6,3,0,9,9,14,17,31,SportCorinthians,0
358,358,5351,2015,37,29/11/2015,Cruzeiro,Joinville,2,3,0,0,2,3,0,5,5,12,13,25,CruzeiroJoinville,0
359,359,5352,2015,37,29/11/2015,Gremio,Atletico-MG,3,5,0,0,3,5,0,8,8,10,11,21,GremioAtletico-MG,0
360,360,5353,2015,37,29/11/2015,Chapecoense,Goias,5,3,0,0,5,3,0,8,8,17,17,34,ChapecoenseGoias,0
361,361,5354,2015,37,29/11/2015,Vasco,Santos,3,2,0,0,3,2,0,5,5,14,12,26,VascoSantos,0
362,362,5355,2015,37,29/11/2015,Palmeiras,Coritiba,3,3,0,0,3,3,0,6,6,22,27,49,PalmeirasCoritiba,0
363,363,5356,2015,37,29/11/2015,Athletico-PR,Flamengo,1,3,0,0,1,3,0,4,4,16,14,30,Athletico-PRFlamengo,0
364,364,5357,2015,38,6/12/2015,Internacional,Cruzeiro,2,1,0,0,2,1,0,3,3,11,13,24,InternacionalCruzeiro,0
365,365,5358,2015,38,6/12/2015,Flamengo,Palmeiras,0,1,0,0,0,1,0,1,1,16,20,36,FlamengoPalmeiras,0
366,366,5359,2015,38,6/12/2015,Figueirense,Fluminense,4,4,0,0,4,4,0,8,8,16,18,34,FigueirenseFluminense,0
367,367,5360,2015,38,6/12/2015,Santos,Athletico-PR,0,1,0,0,0,1,0,1,1,10,10,20,SantosAthletico-PR,0
368,368,5361,2015,38,6/12/2015,Ponte Preta,Sport,4,2,0,0,4,2,0,6,6,21,12,33,Ponte PretaSport,0
369,369,5362,2015,38,6/12/2015,Goias,Sao Paulo,4,1,0,0,4,1,0,5,5,12,21,33,GoiasSao Paulo,0
370,370,5363,2015,38,6/12/2015,Corinthians,Avai,2,2,0,0,2,2,0,4,4,11,14,25,CorinthiansAvai,0
2993,2993,5364,2015,38,6/12/2015,Atletico-MG,Chapecoense,0,0,0,0,0,0,0,0,0,7,11,18,Atletico-MGChapecoense,0
371,371,5365,2015,38,6/12/2015,Joinville,Gremio,3,1,0,0,3,1,0,4,4,12,13,25,JoinvilleGremio,0
372,372,5366,2015,38,6/12/2015,Coritiba,Vasco,1,0,0,1,1,1,1,1,2,20,15,35,CoritibaVasco,0
373,373,5367,2016,1,14/5/2016,Palmeiras,Athletico-PR,1,4,0,1,1,5,1,5,6,14,17,31,PalmeirasAthletico-PR,0
374,374,5368,2016,1,14/5/2016,Flamengo,Sport,2,1,0,1,2,2,1,3,4,18,15,33,FlamengoSport,0
375,375,5369,2016,1,14/5/2016,Atletico-MG,Santos,2,2,0,0,2,2,0,4,4,18,12,30,Atletico-MGSantos,0
376,376,5370,2016,1,14/5/2016,Coritiba,Cruzeiro,1,3,0,2,1,5,2,4,6,19,23,42,CoritibaCruzeiro,0
377,377,5371,2016,1,15/5/2016,Santa Cruz,Vitoria,3,0,0,0,3,0,0,3,3,11,17,28,Santa CruzVitoria,0
378,378,5372,2016,1,15/5/2016,Botafogo-RJ,Sao Paulo,1,5,0,0,1,5,0,6,6,7,10,17,Botafogo-RJSao Paulo,0
379,379,5373,2016,1,15/5/2016,Figueirense,Ponte Preta,2,5,0,0,2,5,0,7,7,8,21,29,FigueirensePonte Preta,0
380,380,5374,2016,1,15/5/2016,Corinthians,Gremio,1,4,0,0,1,4,0,5,5,12,20,32,CorinthiansGremio,0
2994,2994,5375,2016,1,15/5/2016,America-MG,Fluminense,0,0,0,0,0,0,0,0,0,8,9,17,America-MGFluminense,0
381,381,5376,2016,1,15/5/2016,Internacional,Chapecoense,3,4,0,1,3,5,1,7,8,14,20,34,InternacionalChapecoense,0
382,382,5377,2016,2,21/5/2016,Ponte Preta,Palmeiras,3,4,0,0,3,4,0,7,7,21,16,37,Ponte PretaPalmeiras,1
383,383,5378,2016,2,21/5/2016,Fluminense,Santa Cruz,3,5,0,0,3,5,0,8,8,20,23,43,FluminenseSanta Cruz,0
384,384,5379,2016,2,21/5/2016,Cruzeiro,Figueirense,3,1,0,0,3,1,0,4,4,11,14,25,CruzeiroFigueirense,0
385,385,5380,2016,2,22/5/2016,Santos,Coritiba,5,2,0,0,5,2,0,7,7,12,15,27,SantosCoritiba,0
386,386,5381,2016,2,22/5/2016,Athletico-PR,Atletico-MG,3,1,0,0,3,1,0,4,4,18,7,25,Athletico-PRAtletico-MG,0
387,387,5382,2016,2,22/5/2016,Vitoria,Corinthians,5,4,1,0,6,4,1,9,10,20,24,44,VitoriaCorinthians,0
388,388,5383,2016,2,22/5/2016,Chapecoense,America-MG,0,4,0,0,0,4,0,4,4,12,26,38,ChapecoenseAmerica-MG,0
389,389,5384,2016,2,22/5/2016,Sao Paulo,Internacional,4,6,0,1,4,7,1,10,11,11,16,27,Sao PauloInternacional,0
390,390,5385,2016,2,22/5/2016,Gremio,Flamengo,3,2,0,0,3,2,0,5,5,17,8,25,GremioFlamengo,0
391,391,5386,2016,2,22/5/2016,Sport,Botafogo-RJ,3,2,0,0,3,2,0,5,5,14,10,24,SportBotafogo-RJ,0
392,392,5387,2016,3,25/5/2016,Figueirense,Santos,2,3,0,1,2,4,1,5,6,21,12,33,FigueirenseSantos,0
393,393,5388,2016,3,25/5/2016,Botafogo-RJ,Athletico-PR,2,2,0,0,2,2,0,4,4,8,12,20,Botafogo-RJAthletico-PR,0
394,394,5389,2016,3,25/5/2016,Flamengo,Chapecoense,4,1,1,0,5,1,1,5,6,10,24,34,FlamengoChapecoense,0
395,395,5390,2016,3,25/5/2016,America-MG,Vitoria,4,2,0,1,4,3,1,6,7,22,18,40,America-MGVitoria,0
396,396,5391,2016,3,25/5/2016,Santa Cruz,Cruzeiro,2,3,0,0,2,3,0,5,5,16,15,31,Santa CruzCruzeiro,0
397,397,5392,2016,3,25/5/2016,Palmeiras,Fluminense,1,0,0,0,1,0,0,1,1,20,12,32,PalmeirasFluminense,0
398,398,5393,2016,3,25/5/2016,Coritiba,Sao Paulo,2,2,0,0,2,2,0,4,4,18,12,30,CoritibaSao Paulo,0
399,399,5394,2016,3,26/5/2016,Corinthians,Ponte Preta,3,3,0,0,3,3,0,6,6,23,15,38,CorinthiansPonte Preta,1
400,400,5395,2016,3,26/5/2016,Internacional,Sport,3,1,0,0,3,1,0,4,4,14,13,27,InternacionalSport,0
401,401,5396,2016,3,26/5/2016,Atletico-MG,Gremio,1,5,0,0,1,5,0,6,6,8,14,22,Atletico-MGGremio,0
402,402,5397,2016,4,28/5/2016,Cruzeiro,America-MG,1,1,0,0,1,1,0,2,2,7,9,16,CruzeiroAmerica-MG,1
403,403,5398,2016,4,28/5/2016,Athletico-PR,Figueirense,2,1,0,0,2,1,0,3,3,17,17,34,Athletico-PRFigueirense,0
404,404,5399,2016,4,28/5/2016,Chapecoense,Santa Cruz,1,4,0,0,1,4,0,5,5,16,19,35,ChapecoenseSanta Cruz,0
405,405,5400,2016,4,29/5/2016,Ponte Preta,Flamengo,2,2,0,1,2,3,1,4,5,19,13,32,Ponte PretaFlamengo,0
406,406,5401,2016,4,29/5/2016,Sport,Corinthians,2,1,0,0,2,1,0,3,3,7,12,19,SportCorinthians,0
407,407,5402,2016,4,29/5/2016,Fluminense,Botafogo-RJ,1,1,0,0,1,1,0,2,2,16,17,33,FluminenseBotafogo-RJ,1
408,408,5403,2016,4,29/5/2016,Vitoria,Atletico-MG,4,6,0,0,4,6,0,10,10,21,18,39,VitoriaAtletico-MG,0
409,409,5404,2016,4,29/5/2016,Sao Paulo,Palmeiras,2,5,0,0,2,5,0,7,7,18,21,39,Sao PauloPalmeiras,1
410,410,5405,2016,4,29/5/2016,Gremio,Coritiba,0,3,0,0,0,3,0,3,3,19,18,37,GremioCoritiba,0
411,411,5406,2016,4,29/5/2016,Santos,Internacional,1,1,0,0,1,1,0,2,2,9,14,23,SantosInternacional,0
412,412,5407,2016,5,1/6/2016,Internacional,Athletico-PR,5,2,0,0,5,2,0,7,7,30,15,45,InternacionalAthletico-PR,0
413,413,5408,2016,5,1/6/2016,Corinthians,Santos,0,2,0,0,0,2,0,2,2,14,14,28,CorinthiansSantos,1
414,414,5409,2016,5,1/6/2016,Santa Cruz,Sport,6,2,1,0,7,2,1,8,9,25,15,40,Santa CruzSport,1
415,415,5410,2016,5,1/6/2016,Coritiba,Chapecoense,4,5,0,0,4,5,0,9,9,17,23,40,CoritibaChapecoense,0
416,416,5411,2016,5,1/6/2016,Atletico-MG,Fluminense,2,5,0,0,2,5,0,7,7,16,19,35,Atletico-MGFluminense,0
417,417,5412,2016,5,1/6/2016,Figueirense,Sao Paulo,2,1,0,0,2,1,0,3,3,16,19,35,FigueirenseSao Paulo,0
418,418,5413,2016,5,1/6/2016,Botafogo-RJ,Cruzeiro,1,3,0,0,1,3,0,4,4,11,23,34,Botafogo-RJCruzeiro,0
419,419,5414,2016,5,2/6/2016,America-MG,Ponte Preta,1,3,0,0,1,3,0,4,4,7,15,22,America-MGPonte Preta,0
420,420,5415,2016,5,2/6/2016,Palmeiras,Gremio,5,4,0,0,5,4,0,9,9,24,19,43,PalmeirasGremio,0
421,421,5416,2016,5,2/6/2016,Flamengo,Vitoria,2,3,0,0,2,3,0,5,5,14,18,32,FlamengoVitoria,0
422,422,5417,2016,6,4/6/2016,Athletico-PR,Santa Cruz,0,2,0,0,0,2,0,2,2,12,18,30,Athletico-PRSanta Cruz,0
423,423,5418,2016,6,4/6/2016,Chapecoense,Fluminense,3,0,0,0,3,0,0,3,3,12,11,23,ChapecoenseFluminense,0
424,424,5419,2016,6,4/6/2016,Corinthians,Coritiba,2,5,0,0,2,5,0,7,7,13,12,25,CorinthiansCoritiba,0
425,425,5420,2016,6,5/6/2016,America-MG,Figueirense,2,3,0,0,2,3,0,5,5,20,14,34,America-MGFigueirense,0
426,426,5421,2016,6,5/6/2016,Santos,Botafogo-RJ,1,1,0,0,1,1,0,2,2,12,12,24,SantosBotafogo-RJ,0
427,427,5422,2016,6,5/6/2016,Vitoria,Internacional,1,6,0,0,1,6,0,7,7,16,19,35,VitoriaInternacional,0
428,428,5423,2016,6,5/6/2016,Sport,Atletico-MG,1,3,0,0,1,3,0,4,4,10,17,27,SportAtletico-MG,0
429,429,5424,2016,6,5/6/2016,Flamengo,Palmeiras,1,2,1,0,2,2,1,3,4,11,12,23,FlamengoPalmeiras,0
430,430,5425,2016,6,5/6/2016,Gremio,Ponte Preta,2,4,1,1,3,5,2,6,8,14,13,27,GremioPonte Preta,0
431,431,5426,2016,6,5/6/2016,Cruzeiro,Sao Paulo,2,0,0,0,2,0,0,2,2,12,9,21,CruzeiroSao Paulo,0
432,432,5427,2016,7,11/6/2016,Internacional,America-MG,2,3,0,0,2,3,0,5,5,16,15,31,InternacionalAmerica-MG,0
433,433,5428,2016,7,11/6/2016,Ponte Preta,Chapecoense,3,4,0,0,3,4,0,7,7,22,22,44,Ponte PretaChapecoense,0
434,434,5429,2016,7,11/6/2016,Fluminense,Gremio,4,2,0,1,4,3,1,6,7,9,10,19,FluminenseGremio,0
435,435,5430,2016,7,11/6/2016,Sao Paulo,Athletico-PR,1,2,0,0,1,2,0,3,3,12,17,29,Sao PauloAthletico-PR,0
436,436,5431,2016,7,12/6/2016,Coritiba,Sport,5,4,1,1,6,5,2,9,11,18,26,44,CoritibaSport,0
437,437,5432,2016,7,12/6/2016,Botafogo-RJ,Vitoria,3,1,0,0,3,1,0,4,4,20,18,38,Botafogo-RJVitoria,0
438,438,5433,2016,7,12/6/2016,Atletico-MG,Cruzeiro,4,6,1,3,5,9,4,10,14,15,15,30,Atletico-MGCruzeiro,1
439,439,5434,2016,7,12/6/2016,Palmeiras,Corinthians,4,4,0,0,4,4,0,8,8,19,18,37,PalmeirasCorinthians,1
440,440,5435,2016,7,12/6/2016,Figueirense,Flamengo,2,2,0,0,2,2,0,4,4,17,17,34,FigueirenseFlamengo,0
441,441,5436,2016,7,12/6/2016,Santa Cruz,Santos,1,2,0,0,1,2,0,3,3,19,11,30,Santa CruzSantos,0
442,442,5437,2016,8,15/6/2016,Sao Paulo,Vitoria,5,2,0,0,5,2,0,7,7,22,22,44,Sao PauloVitoria,0
443,443,5438,2016,8,15/6/2016,Chapecoense,Gremio,2,2,0,0,2,2,0,4,4,19,15,34,ChapecoenseGremio,0
444,444,5439,2016,8,15/6/2016,Ponte Preta,Athletico-PR,0,2,0,0,0,2,0,2,2,9,15,24,Ponte PretaAthletico-PR,0
445,445,5440,2016,8,15/6/2016,Santos,Sport,1,3,0,0,1,3,0,4,4,10,10,20,SantosSport,0
446,446,5441,2016,8,15/6/2016,Santa Cruz,Figueirense,3,3,0,1,3,4,1,6,7,25,8,33,Santa CruzFigueirense,0
447,447,5442,2016,8,15/6/2016,Botafogo-RJ,America-MG,2,2,0,0,2,2,0,4,4,17,20,37,Botafogo-RJAmerica-MG,0
448,448,5443,2016,8,15/6/2016,Coritiba,Palmeiras,4,3,0,0,4,3,0,7,7,14,19,33,CoritibaPalmeiras,0
2995,2995,5444,2016,8,15/6/2016,Cruzeiro,Flamengo,0,0,0,0,0,0,0,0,0,9,9,18,CruzeiroFlamengo,0
449,449,5445,2016,8,16/6/2016,Internacional,Atletico-MG,2,1,0,0,2,1,0,3,3,23,12,35,InternacionalAtletico-MG,0
450,450,5446,2016,8,16/6/2016,Fluminense,Corinthians,2,1,0,1,2,2,1,3,4,12,7,19,FluminenseCorinthians,0
451,451,5447,2016,9,18/6/2016,Palmeiras,Santa Cruz,1,4,0,1,1,5,1,5,6,18,24,42,PalmeirasSanta Cruz,0
452,452,5448,2016,9,18/6/2016,Athletico-PR,Santos,2,1,0,0,2,1,0,3,3,16,7,23,Athletico-PRSantos,0
453,453,5449,2016,9,18/6/2016,America-MG,Coritiba,0,3,0,0,0,3,0,3,3,17,12,29,America-MGCoritiba,0
454,454,5450,2016,9,19/6/2016,Vitoria,Chapecoense,1,4,0,0,1,4,0,5,5,20,18,38,VitoriaChapecoense,0
455,455,5451,2016,9,19/6/2016,Atletico-MG,Ponte Preta,0,1,0,0,0,1,0,1,1,9,17,26,Atletico-MGPonte Preta,0
456,456,5452,2016,9,19/6/2016,Corinthians,Botafogo-RJ,2,2,0,0,2,2,0,4,4,15,15,30,CorinthiansBotafogo-RJ,0
457,457,5453,2016,9,19/6/2016,Flamengo,Sao Paulo,1,3,0,1,1,4,1,4,5,9,19,28,FlamengoSao Paulo,0
458,458,5454,2016,9,19/6/2016,Figueirense,Internacional,3,0,0,0,3,0,0,3,3,16,15,31,FigueirenseInternacional,0
459,459,5455,2016,9,19/6/2016,Sport,Fluminense,2,0,0,0,2,0,0,2,2,12,12,24,SportFluminense,0
460,460,5456,2016,9,19/6/2016,Gremio,Cruzeiro,0,2,0,0,0,2,0,2,2,13,16,29,GremioCruzeiro,0
461,461,5457,2016,10,21/6/2016,Palmeiras,America-MG,0,1,0,0,0,1,0,1,1,6,8,14,PalmeirasAmerica-MG,0
462,462,5458,2016,10,22/6/2016,Ponte Preta,Cruzeiro,4,4,0,0,4,4,0,8,8,11,14,25,Ponte PretaCruzeiro,0
463,463,5459,2016,10,22/6/2016,Botafogo-RJ,Figueirense,0,1,0,0,0,1,0,1,1,12,14,26,Botafogo-RJFigueirense,0
464,464,5460,2016,10,22/6/2016,Santa Cruz,Flamengo,1,0,0,0,1,0,0,1,1,13,12,25,Santa CruzFlamengo,0
465,465,5461,2016,10,22/6/2016,Fluminense,Santos,1,1,0,0,1,1,0,2,2,9,11,20,FluminenseSantos,0
466,466,5462,2016,10,22/6/2016,Atletico-MG,Corinthians,3,1,0,0,3,1,0,4,4,24,11,35,Atletico-MGCorinthians,0
467,467,5463,2016,10,23/6/2016,Chapecoense,Athletico-PR,2,2,0,0,2,2,0,4,4,16,17,33,ChapecoenseAthletico-PR,0
468,468,5464,2016,10,23/6/2016,Gremio,Vitoria,4,4,1,0,5,4,1,8,9,11,17,28,GremioVitoria,0
469,469,5465,2016,10,23/6/2016,Sao Paulo,Sport,0,2,0,0,0,2,0,2,2,9,19,28,Sao PauloSport,0
470,470,5466,2016,10,23/6/2016,Coritiba,Internacional,2,5,1,0,3,5,1,7,8,13,27,40,CoritibaInternacional,0
471,471,5467,2016,11,25/6/2016,Cruzeiro,Palmeiras,4,2,0,0,4,2,0,6,6,13,14,27,CruzeiroPalmeiras,0
472,472,5468,2016,11,25/6/2016,Corinthians,Santa Cruz,3,1,0,0,3,1,0,4,4,14,16,30,CorinthiansSanta Cruz,0
473,473,5469,2016,11,26/6/2016,America-MG,Atletico-MG,3,3,0,0,3,3,0,6,6,19,17,36,America-MGAtletico-MG,1
474,474,5470,2016,11,26/6/2016,Flamengo,Fluminense,0,1,0,0,0,1,0,1,1,9,14,23,FlamengoFluminense,0
475,475,5471,2016,11,26/6/2016,Vitoria,Ponte Preta,3,2,0,0,3,2,0,5,5,17,22,39,VitoriaPonte Preta,0
476,476,5472,2016,11,26/6/2016,Athletico-PR,Gremio,1,0,0,1,1,1,1,1,2,12,16,28,Athletico-PRGremio,0
477,477,5473,2016,11,26/6/2016,Internacional,Botafogo-RJ,4,3,1,0,5,3,1,7,8,21,18,39,InternacionalBotafogo-RJ,0
478,478,5474,2016,11,26/6/2016,Santos,Sao Paulo,2,3,0,1,2,4,1,5,6,8,14,22,SantosSao Paulo,1
479,479,5475,2016,11,26/6/2016,Sport,Chapecoense,3,2,0,0,3,2,0,5,5,22,10,32,SportChapecoense,0
480,480,5476,2016,11,26/6/2016,Figueirense,Coritiba,3,4,0,0,3,4,0,7,7,19,23,42,FigueirenseCoritiba,0
481,481,5477,2016,12,29/6/2016,Flamengo,Internacional,1,1,0,0,1,1,0,2,2,11,22,33,FlamengoInternacional,0
482,482,5478,2016,12,29/6/2016,Vitoria,Sport,4,4,0,2,4,6,2,8,10,22,19,41,VitoriaSport,0
483,483,5479,2016,12,29/6/2016,Gremio,Santos,3,3,0,0,3,3,0,6,6,10,14,24,GremioSantos,0
484,484,5480,2016,12,29/6/2016,Coritiba,Athletico-PR,3,2,0,0,3,2,0,5,5,22,16,38,CoritibaAthletico-PR,1
485,485,5481,2016,12,29/6/2016,Chapecoense,Cruzeiro,4,6,0,0,4,6,0,10,10,19,20,39,ChapecoenseCruzeiro,0
486,486,5482,2016,12,29/6/2016,Sao Paulo,Fluminense,4,3,0,0,4,3,0,7,7,17,15,32,Sao PauloFluminense,0
487,487,5483,2016,12,29/6/2016,America-MG,Corinthians,2,1,0,0,2,1,0,3,3,10,13,23,America-MGCorinthians,0
488,488,5484,2016,12,30/6/2016,Santa Cruz,Ponte Preta,2,1,0,0,2,1,0,3,3,15,16,31,Santa CruzPonte Preta,0
489,489,5485,2016,12,30/6/2016,Palmeiras,Figueirense,1,1,0,0,1,1,0,2,2,26,24,50,PalmeirasFigueirense,0
2996,2996,5486,2016,12,30/6/2016,Atletico-MG,Botafogo-RJ,0,0,0,0,0,0,0,0,0,15,9,24,Atletico-MGBotafogo-RJ,0
490,490,5487,2016,13,2/7/2016,Fluminense,Coritiba,1,2,0,0,1,2,0,3,3,14,19,33,FluminenseCoritiba,0
491,491,5488,2016,13,2/7/2016,Athletico-PR,America-MG,2,2,0,0,2,2,0,4,4,9,12,21,Athletico-PRAmerica-MG,0
492,492,5489,2016,13,3/7/2016,Cruzeiro,Vitoria,3,3,0,1,3,4,1,6,7,12,18,30,CruzeiroVitoria,0
493,493,5490,2016,13,3/7/2016,Internacional,Gremio,4,5,0,0,4,5,0,9,9,11,11,22,InternacionalGremio,1
494,494,5491,2016,13,3/7/2016,Santos,Chapecoense,1,1,0,0,1,1,0,2,2,13,12,25,SantosChapecoense,0
495,495,5492,2016,13,3/7/2016,Ponte Preta,Sao Paulo,3,2,0,1,3,3,1,5,6,20,16,36,Ponte PretaSao Paulo,1
496,496,5493,2016,13,3/7/2016,Corinthians,Flamengo,2,3,0,0,2,3,0,5,5,15,10,25,CorinthiansFlamengo,0
497,497,5494,2016,13,3/7/2016,Botafogo-RJ,Santa Cruz,1,3,0,0,1,3,0,4,4,11,13,24,Botafogo-RJSanta Cruz,0
498,498,5495,2016,13,3/7/2016,Figueirense,Atletico-MG,2,4,1,1,3,5,2,6,8,18,21,39,FigueirenseAtletico-MG,0
499,499,5496,2016,13,4/7/2016,Sport,Palmeiras,4,5,0,0,4,5,0,9,9,18,21,39,SportPalmeiras,0
500,500,5497,2016,14,9/7/2016,Chapecoense,Corinthians,1,1,1,0,2,1,1,2,3,17,13,30,ChapecoenseCorinthians,0
501,501,5498,2016,14,9/7/2016,Coritiba,Botafogo-RJ,1,3,0,0,1,3,0,4,4,21,14,35,CoritibaBotafogo-RJ,0
502,502,5499,2016,14,9/7/2016,Ponte Preta,Sport,2,2,0,0,2,2,0,4,4,17,12,29,Ponte PretaSport,0
503,503,5500,2016,14,10/7/2016,Gremio,Figueirense,1,1,0,0,1,1,0,2,2,11,14,25,GremioFigueirense,0
504,504,5501,2016,14,10/7/2016,Flamengo,Atletico-MG,1,4,0,0,1,4,0,5,5,10,23,33,FlamengoAtletico-MG,0
505,505,5502,2016,14,10/7/2016,Santa Cruz,Internacional,0,2,0,0,0,2,0,2,2,21,19,40,Santa CruzInternacional,0
506,506,5503,2016,14,10/7/2016,Sao Paulo,America-MG,1,4,0,0,1,4,0,5,5,7,13,20,Sao PauloAmerica-MG,0
507,507,5504,2016,14,10/7/2016,Vitoria,Fluminense,3,4,0,0,3,4,0,7,7,16,22,38,VitoriaFluminense,0
508,508,5505,2016,14,11/7/2016,Cruzeiro,Athletico-PR,1,4,0,0,1,4,0,5,5,9,17,26,CruzeiroAthletico-PR,0
509,509,5506,2016,14,12/7/2016,Palmeiras,Santos,3,2,0,0,3,2,0,5,5,17,17,34,PalmeirasSantos,1
510,510,5507,2016,15,16/7/2016,Botafogo-RJ,Flamengo,2,4,0,0,2,4,0,6,6,12,22,34,Botafogo-RJFlamengo,1
511,511,5508,2016,15,16/7/2016,Santos,Ponte Preta,3,2,0,0,3,2,0,5,5,14,11,25,SantosPonte Preta,1
512,512,5509,2016,15,17/7/2016,America-MG,Santa Cruz,2,2,0,0,2,2,0,4,4,9,10,19,America-MGSanta Cruz,0
513,513,5510,2016,15,17/7/2016,Internacional,Palmeiras,4,2,0,0,4,2,0,6,6,17,13,30,InternacionalPalmeiras,0
514,514,5511,2016,15,17/7/2016,Figueirense,Chapecoense,1,4,0,0,1,4,0,5,5,16,18,34,FigueirenseChapecoense,1
515,515,5512,2016,15,17/7/2016,Fluminense,Cruzeiro,0,6,0,0,0,6,0,6,6,17,17,34,FluminenseCruzeiro,0
516,516,5513,2016,15,17/7/2016,Athletico-PR,Vitoria,3,3,0,0,3,3,0,6,6,16,10,26,Athletico-PRVitoria,0
517,517,5514,2016,15,17/7/2016,Corinthians,Sao Paulo,3,3,0,0,3,3,0,6,6,11,26,37,CorinthiansSao Paulo,1
518,518,5515,2016,15,17/7/2016,Sport,Gremio,0,3,0,0,0,3,0,3,3,15,16,31,SportGremio,0
519,519,5516,2016,15,18/7/2016,Atletico-MG,Coritiba,2,2,0,0,2,2,0,4,4,16,18,34,Atletico-MGCoritiba,0
520,520,5517,2016,16,23/7/2016,Corinthians,Figueirense,2,6,0,0,2,6,0,8,8,15,21,36,CorinthiansFigueirense,0
521,521,5518,2016,16,23/7/2016,Santa Cruz,Coritiba,2,1,0,0,2,1,0,3,3,17,19,36,Santa CruzCoritiba,0
522,522,5519,2016,16,24/7/2016,Palmeiras,Atletico-MG,1,2,0,0,1,2,0,3,3,11,19,30,PalmeirasAtletico-MG,0
523,523,5520,2016,16,24/7/2016,Ponte Preta,Internacional,3,3,0,1,3,4,1,6,7,20,13,33,Ponte PretaInternacional,0
524,524,5521,2016,16,24/7/2016,Gremio,Sao Paulo,0,3,0,1,0,4,1,3,4,16,12,28,GremioSao Paulo,0
525,525,5522,2016,16,24/7/2016,Athletico-PR,Fluminense,3,5,0,0,3,5,0,8,8,13,20,33,Athletico-PRFluminense,0
526,526,5523,2016,16,24/7/2016,Cruzeiro,Sport,1,4,0,0,1,4,0,5,5,15,18,33,CruzeiroSport,0
527,527,5524,2016,16,24/7/2016,Chapecoense,Botafogo-RJ,1,2,0,0,1,2,0,3,3,14,16,30,ChapecoenseBotafogo-RJ,0
528,528,5525,2016,16,24/7/2016,Vitoria,Santos,3,2,0,0,3,2,0,5,5,15,11,26,VitoriaSantos,0
529,529,5526,2016,16,25/7/2016,Flamengo,America-MG,1,0,0,0,1,0,0,1,1,11,13,24,FlamengoAmerica-MG,0
530,530,5527,2016,17,30/7/2016,Figueirense,Vitoria,3,4,1,1,4,5,2,7,9,19,26,45,FigueirenseVitoria,0
531,531,5528,2016,17,30/7/2016,Sport,Athletico-PR,2,1,0,0,2,1,0,3,3,23,9,32,SportAthletico-PR,0
532,532,5529,2016,17,30/7/2016,Atletico-MG,Santa Cruz,1,3,0,0,1,3,0,4,4,13,12,25,Atletico-MGSanta Cruz,0
533,533,5530,2016,17,31/7/2016,Sao Paulo,Chapecoense,4,1,0,0,4,1,0,5,5,13,11,24,Sao PauloChapecoense,0
534,534,5531,2016,17,31/7/2016,Fluminense,Ponte Preta,4,6,0,0,4,6,0,10,10,21,21,42,FluminensePonte Preta,0
535,535,5532,2016,17,31/7/2016,Coritiba,Flamengo,1,2,0,0,1,2,0,3,3,9,13,22,CoritibaFlamengo,0
536,536,5533,2016,17,31/7/2016,Internacional,Corinthians,2,2,0,0,2,2,0,4,4,19,19,38,InternacionalCorinthians,0
537,537,5534,2016,17,31/7/2016,Santos,Cruzeiro,1,1,0,0,1,1,0,2,2,12,10,22,SantosCruzeiro,0
538,538,5535,2016,17,31/7/2016,Botafogo-RJ,Palmeiras,4,3,0,0,4,3,0,7,7,20,23,43,Botafogo-RJPalmeiras,0
539,539,5536,2016,17,31/7/2016,America-MG,Gremio,2,2,0,1,2,3,1,4,5,15,8,23,America-MGGremio,0
540,540,5537,2016,18,3/8/2016,Vitoria,Coritiba,2,1,0,0,2,1,0,3,3,9,19,28,VitoriaCoritiba,0
541,541,5538,2016,18,3/8/2016,Sport,America-MG,1,3,0,0,1,3,0,4,4,8,22,30,SportAmerica-MG,0
542,542,5539,2016,18,3/8/2016,Santos,Flamengo,2,2,0,0,2,2,0,4,4,10,9,19,SantosFlamengo,0
543,543,5540,2016,18,3/8/2016,Athletico-PR,Corinthians,3,0,0,0,3,0,0,3,3,11,12,23,Athletico-PRCorinthians,0
544,544,5541,2016,18,4/8/2016,Ponte Preta,Botafogo-RJ,2,2,0,0,2,2,0,4,4,16,12,28,Ponte PretaBotafogo-RJ,0
545,545,5542,2016,18,4/8/2016,Gremio,Santa Cruz,1,3,0,0,1,3,0,4,4,18,18,36,GremioSanta Cruz,0
546,546,5543,2016,18,4/8/2016,Sao Paulo,Atletico-MG,2,2,0,0,2,2,0,4,4,9,17,26,Sao PauloAtletico-MG,0
547,547,5544,2016,18,4/8/2016,Cruzeiro,Internacional,1,1,0,0,1,1,0,2,2,10,14,24,CruzeiroInternacional,0
548,548,5545,2016,18,4/8/2016,Chapecoense,Palmeiras,1,0,0,0,1,0,0,1,1,18,15,33,ChapecoensePalmeiras,0
549,549,5546,2016,18,3/9/2016,Fluminense,Figueirense,3,3,0,0,3,3,0,6,6,21,15,36,FluminenseFigueirense,0
550,550,5547,2016,19,6/8/2016,Flamengo,Athletico-PR,2,4,0,0,2,4,0,6,6,11,11,22,FlamengoAthletico-PR,0
551,551,5548,2016,19,7/8/2016,America-MG,Santos,2,1,0,1,2,2,1,3,4,11,7,18,America-MGSantos,0
552,552,5549,2016,19,7/8/2016,Coritiba,Ponte Preta,4,3,0,0,4,3,0,7,7,20,18,38,CoritibaPonte Preta,0
553,553,5550,2016,19,7/8/2016,Palmeiras,Vitoria,2,4,0,0,2,4,0,6,6,13,20,33,PalmeirasVitoria,0
554,554,5551,2016,19,7/8/2016,Santa Cruz,Sao Paulo,1,3,0,0,1,3,0,4,4,15,24,39,Santa CruzSao Paulo,0
555,555,5552,2016,19,7/8/2016,Internacional,Fluminense,4,4,0,0,4,4,0,8,8,22,14,36,InternacionalFluminense,0
556,556,5553,2016,19,7/8/2016,Figueirense,Sport,5,3,0,0,5,3,0,8,8,18,16,34,FigueirenseSport,0
557,557,5554,2016,19,8/8/2016,Atletico-MG,Chapecoense,0,1,0,0,0,1,0,1,1,15,12,27,Atletico-MGChapecoense,0
558,558,5555,2016,19,8/8/2016,Corinthians,Cruzeiro,4,3,0,0,4,3,0,7,7,15,8,23,CorinthiansCruzeiro,0
559,559,5556,2016,19,4/9/2016,Botafogo-RJ,Gremio,3,4,0,0,3,4,0,7,7,16,25,41,Botafogo-RJGremio,0
560,560,5557,2016,20,13/8/2016,Sport,Flamengo,2,3,0,0,2,3,0,5,5,24,15,39,SportFlamengo,0
561,561,5558,2016,20,13/8/2016,Ponte Preta,Figueirense,2,2,0,0,2,2,0,4,4,21,25,46,Ponte PretaFigueirense,0
562,562,5559,2016,20,14/8/2016,Fluminense,America-MG,2,5,0,0,2,5,0,7,7,12,28,40,FluminenseAmerica-MG,0
563,563,5560,2016,20,14/8/2016,Gremio,Corinthians,4,1,0,0,4,1,0,5,5,15,14,29,GremioCorinthians,0
564,564,5561,2016,20,14/8/2016,Cruzeiro,Coritiba,2,4,0,0,2,4,0,6,6,15,20,35,CruzeiroCoritiba,0
565,565,5562,2016,20,14/8/2016,Santos,Atletico-MG,4,4,0,0,4,4,0,8,8,24,9,33,SantosAtletico-MG,0
566,566,5563,2016,20,14/8/2016,Vitoria,Santa Cruz,1,2,0,0,1,2,0,3,3,15,20,35,VitoriaSanta Cruz,0
567,567,5564,2016,20,14/8/2016,Sao Paulo,Botafogo-RJ,2,2,0,0,2,2,0,4,4,11,14,25,Sao PauloBotafogo-RJ,0
568,568,5565,2016,20,14/8/2016,Athletico-PR,Palmeiras,3,3,0,0,3,3,0,6,6,12,15,27,Athletico-PRPalmeiras,0
569,569,5566,2016,20,15/8/2016,Chapecoense,Internacional,1,2,0,0,1,2,0,3,3,15,18,33,ChapecoenseInternacional,0
570,570,5567,2016,21,19/8/2016,America-MG,Chapecoense,1,1,0,0,1,1,0,2,2,13,10,23,America-MGChapecoense,0
571,571,5568,2016,21,20/8/2016,Botafogo-RJ,Sport,1,2,0,0,1,2,0,3,3,19,12,31,Botafogo-RJSport,0
572,572,5569,2016,21,21/8/2016,Flamengo,Gremio,2,1,0,0,2,1,0,3,3,14,16,30,FlamengoGremio,0
573,573,5570,2016,21,21/8/2016,Atletico-MG,Athletico-PR,0,2,0,0,0,2,0,2,2,15,15,30,Atletico-MGAthletico-PR,0
574,574,5571,2016,21,21/8/2016,Internacional,Sao Paulo,1,2,0,0,1,2,0,3,3,9,22,31,InternacionalSao Paulo,0
575,575,5572,2016,21,21/8/2016,Santa Cruz,Fluminense,0,2,0,0,0,2,0,2,2,16,16,32,Santa CruzFluminense,0
576,576,5573,2016,21,21/8/2016,Palmeiras,Ponte Preta,3,6,0,0,3,6,0,9,9,12,22,34,PalmeirasPonte Preta,1
577,577,5574,2016,21,21/8/2016,Coritiba,Santos,1,3,0,0,1,3,0,4,4,13,16,29,CoritibaSantos,0
578,578,5575,2016,21,21/8/2016,Figueirense,Cruzeiro,4,5,1,0,5,5,1,9,10,20,24,44,FigueirenseCruzeiro,0
579,579,5576,2016,21,22/8/2016,Corinthians,Vitoria,2,4,0,0,2,4,0,6,6,15,20,35,CorinthiansVitoria,0
580,580,5577,2016,22,27/8/2016,Ponte Preta,Corinthians,2,1,0,1,2,2,1,3,4,15,8,23,Ponte PretaCorinthians,1
581,581,5578,2016,22,28/8/2016,Cruzeiro,Santa Cruz,3,3,0,0,3,3,0,6,6,17,13,30,CruzeiroSanta Cruz,0
582,582,5579,2016,22,28/8/2016,Santos,Figueirense,3,2,0,0,3,2,0,5,5,13,12,25,SantosFigueirense,0
583,583,5580,2016,22,28/8/2016,Gremio,Atletico-MG,4,4,0,0,4,4,0,8,8,18,17,35,GremioAtletico-MG,0
584,584,5581,2016,22,28/8/2016,Fluminense,Palmeiras,7,5,0,0,7,5,0,12,12,17,20,37,FluminensePalmeiras,0
585,585,5582,2016,22,28/8/2016,Chapecoense,Flamengo,4,0,0,0,4,0,0,4,4,15,13,28,ChapecoenseFlamengo,0
586,586,5583,2016,22,28/8/2016,Sao Paulo,Coritiba,2,1,0,0,2,1,0,3,3,18,16,34,Sao PauloCoritiba,0
587,587,5584,2016,22,28/8/2016,Sport,Internacional,4,5,0,0,4,5,0,9,9,18,19,37,SportInternacional,0
588,588,5585,2016,22,28/8/2016,Vitoria,America-MG,3,5,0,0,3,5,0,8,8,20,19,39,VitoriaAmerica-MG,0
589,589,5586,2016,22,29/8/2016,Athletico-PR,Botafogo-RJ,3,2,0,0,3,2,0,5,5,12,14,26,Athletico-PRBotafogo-RJ,0
590,590,5587,2016,23,7/9/2016,Santa Cruz,Chapecoense,3,3,1,0,4,3,1,6,7,9,18,27,Santa CruzChapecoense,0
591,591,5588,2016,23,7/9/2016,Figueirense,Athletico-PR,1,2,0,0,1,2,0,3,3,16,20,36,FigueirenseAthletico-PR,0
592,592,5589,2016,23,7/9/2016,Botafogo-RJ,Fluminense,5,2,0,0,5,2,0,7,7,22,15,37,Botafogo-RJFluminense,1
593,593,5590,2016,23,7/9/2016,Atletico-MG,Vitoria,2,5,0,0,2,5,0,7,7,17,17,34,Atletico-MGVitoria,0
594,594,5591,2016,23,7/9/2016,Palmeiras,Sao Paulo,3,3,0,0,3,3,0,6,6,20,19,39,PalmeirasSao Paulo,1
595,595,5592,2016,23,7/9/2016,Flamengo,Ponte Preta,1,3,0,0,1,3,0,4,4,15,19,34,FlamengoPonte Preta,0
596,596,5593,2016,23,7/9/2016,Coritiba,Gremio,3,0,0,0,3,0,0,3,3,15,9,24,CoritibaGremio,0
597,597,5594,2016,23,8/9/2016,Corinthians,Sport,2,2,0,0,2,2,0,4,4,15,17,32,CorinthiansSport,0
598,598,5595,2016,23,8/9/2016,America-MG,Cruzeiro,1,2,0,0,1,2,0,3,3,19,13,32,America-MGCruzeiro,1
599,599,5596,2016,23,8/9/2016,Internacional,Santos,4,4,0,1,4,5,1,8,9,19,8,27,InternacionalSantos,0
600,600,5597,2016,24,10/9/2016,Vitoria,Flamengo,2,1,1,0,3,1,1,3,4,14,8,22,VitoriaFlamengo,0
601,601,5598,2016,24,11/9/2016,Chapecoense,Coritiba,2,3,0,0,2,3,0,5,5,20,16,36,ChapecoenseCoritiba,0
602,602,5599,2016,24,11/9/2016,Sao Paulo,Figueirense,2,2,0,0,2,2,0,4,4,25,17,42,Sao PauloFigueirense,0
603,603,5600,2016,24,11/9/2016,Cruzeiro,Botafogo-RJ,4,2,0,0,4,2,0,6,6,16,16,32,CruzeiroBotafogo-RJ,0
604,604,5601,2016,24,11/9/2016,Sport,Santa Cruz,2,1,1,1,3,2,2,3,5,14,18,32,SportSanta Cruz,1
605,605,5602,2016,24,11/9/2016,Athletico-PR,Internacional,0,2,0,0,0,2,0,2,2,11,12,23,Athletico-PRInternacional,0
606,606,5603,2016,24,11/9/2016,Santos,Corinthians,2,1,0,0,2,1,0,3,3,18,17,35,SantosCorinthians,1
607,607,5604,2016,24,11/9/2016,Ponte Preta,America-MG,2,1,0,0,2,1,0,3,3,10,12,22,Ponte PretaAmerica-MG,0
608,608,5605,2016,24,11/9/2016,Gremio,Palmeiras,4,3,0,0,4,3,0,7,7,23,16,39,GremioPalmeiras,0
609,609,5606,2016,24,12/9/2016,Fluminense,Atletico-MG,1,4,0,0,1,4,0,5,5,14,16,30,FluminenseAtletico-MG,0
610,610,5607,2016,25,14/9/2016,Botafogo-RJ,Santos,2,1,0,0,2,1,0,3,3,10,10,20,Botafogo-RJSantos,0
611,611,5608,2016,25,14/9/2016,Figueirense,America-MG,0,2,0,1,0,3,1,2,3,17,13,30,FigueirenseAmerica-MG,0
612,612,5609,2016,25,14/9/2016,Ponte Preta,Gremio,2,1,0,0,2,1,0,3,3,16,18,34,Ponte PretaGremio,0
613,613,5610,2016,25,14/9/2016,Santa Cruz,Athletico-PR,3,4,0,0,3,4,0,7,7,12,13,25,Santa CruzAthletico-PR,0
614,614,5611,2016,25,14/9/2016,Coritiba,Corinthians,3,1,1,0,4,1,1,4,5,15,12,27,CoritibaCorinthians,0
615,615,5612,2016,25,14/9/2016,Palmeiras,Flamengo,2,1,0,1,2,2,1,3,4,13,13,26,PalmeirasFlamengo,0
616,616,5613,2016,25,15/9/2016,Atletico-MG,Sport,0,1,0,1,0,2,1,1,2,13,15,28,Atletico-MGSport,0
617,617,5614,2016,25,15/9/2016,Fluminense,Chapecoense,3,4,0,0,3,4,0,7,7,19,18,37,FluminenseChapecoense,0
618,618,5615,2016,25,15/9/2016,Sao Paulo,Cruzeiro,0,0,0,1,0,1,1,0,1,14,8,22,Sao PauloCruzeiro,0
619,619,5616,2016,25,15/9/2016,Internacional,Vitoria,3,5,0,0,3,5,0,8,8,18,24,42,InternacionalVitoria,0
620,620,5617,2016,26,17/9/2016,Corinthians,Palmeiras,2,4,1,0,3,4,1,6,7,16,16,32,CorinthiansPalmeiras,1
621,621,5618,2016,26,18/9/2016,Flamengo,Figueirense,2,3,0,1,2,4,1,5,6,16,17,33,FlamengoFigueirense,0
622,622,5619,2016,26,18/9/2016,Cruzeiro,Atletico-MG,1,2,1,0,2,2,1,3,4,12,23,35,CruzeiroAtletico-MG,1
623,623,5620,2016,26,18/9/2016,Sport,Coritiba,0,1,0,0,0,1,0,1,1,20,21,41,SportCoritiba,0
624,624,5621,2016,26,18/9/2016,Gremio,Fluminense,4,3,0,0,4,3,0,7,7,17,11,28,GremioFluminense,0
625,625,5622,2016,26,18/9/2016,Chapecoense,Ponte Preta,2,0,0,0,2,0,0,2,2,16,12,28,ChapecoensePonte Preta,0
626,626,5623,2016,26,18/9/2016,Athletico-PR,Sao Paulo,1,1,0,0,1,1,0,2,2,12,12,24,Athletico-PRSao Paulo,0
627,627,5624,2016,26,18/9/2016,Santos,Santa Cruz,1,1,0,0,1,1,0,2,2,13,11,24,SantosSanta Cruz,0
628,628,5625,2016,26,18/9/2016,Vitoria,Botafogo-RJ,2,5,0,0,2,5,0,7,7,15,24,39,VitoriaBotafogo-RJ,0
629,629,5626,2016,26,19/9/2016,America-MG,Internacional,1,2,0,0,1,2,0,3,3,12,14,26,America-MGInternacional,0
630,630,5627,2016,27,24/9/2016,Palmeiras,Coritiba,2,3,0,0,2,3,0,5,5,13,24,37,PalmeirasCoritiba,0
631,631,5628,2016,27,24/9/2016,Sport,Santos,3,2,0,1,3,3,1,5,6,20,11,31,SportSantos,0
632,632,5629,2016,27,24/9/2016,America-MG,Botafogo-RJ,2,3,0,0,2,3,0,5,5,16,12,28,America-MGBotafogo-RJ,0
633,633,5630,2016,27,25/9/2016,Athletico-PR,Ponte Preta,2,5,0,1,2,6,1,7,8,11,20,31,Athletico-PRPonte Preta,0
634,634,5631,2016,27,25/9/2016,Figueirense,Santa Cruz,1,5,0,0,1,5,0,6,6,19,12,31,FigueirenseSanta Cruz,0
635,635,5632,2016,27,25/9/2016,Vitoria,Sao Paulo,4,3,0,0,4,3,0,7,7,21,19,40,VitoriaSao Paulo,0
636,636,5633,2016,27,25/9/2016,Corinthians,Fluminense,4,3,0,0,4,3,0,7,7,19,15,34,CorinthiansFluminense,0
637,637,5634,2016,27,25/9/2016,Flamengo,Cruzeiro,1,2,0,0,1,2,0,3,3,13,12,25,FlamengoCruzeiro,0
638,638,5635,2016,27,25/9/2016,Gremio,Chapecoense,2,2,0,0,2,2,0,4,4,13,12,25,GremioChapecoense,0
639,639,5636,2016,27,25/9/2016,Atletico-MG,Internacional,2,2,0,0,2,2,0,4,4,11,17,28,Atletico-MGInternacional,0
640,640,5637,2016,28,1/10/2016,Fluminense,Sport,1,3,0,0,1,3,0,4,4,11,30,41,FluminenseSport,0
641,641,5638,2016,28,1/10/2016,Sao Paulo,Flamengo,4,3,0,0,4,3,0,7,7,18,9,27,Sao PauloFlamengo,0
642,642,5639,2016,28,1/10/2016,Chapecoense,Vitoria,1,2,0,0,1,2,0,3,3,18,18,36,ChapecoenseVitoria,0
643,643,5640,2016,28,1/10/2016,Santos,Athletico-PR,2,1,0,0,2,1,0,3,3,10,13,23,SantosAthletico-PR,0
644,644,5641,2016,28,1/10/2016,Botafogo-RJ,Corinthians,4,4,0,0,4,4,0,8,8,23,16,39,Botafogo-RJCorinthians,0
645,645,5642,2016,28,1/10/2016,Ponte Preta,Atletico-MG,2,2,0,0,2,2,0,4,4,25,16,41,Ponte PretaAtletico-MG,0
646,646,5643,2016,28,1/10/2016,Cruzeiro,Gremio,3,3,0,0,3,3,0,6,6,19,20,39,CruzeiroGremio,0
647,647,5644,2016,28,1/10/2016,Internacional,Figueirense,2,2,0,0,2,2,0,4,4,32,19,51,InternacionalFigueirense,0
648,648,5645,2016,28,3/10/2016,Santa Cruz,Palmeiras,6,3,0,0,6,3,0,9,9,20,12,32,Santa CruzPalmeiras,0
649,649,5646,2016,28,3/10/2016,Coritiba,America-MG,2,2,0,0,2,2,0,4,4,17,15,32,CoritibaAmerica-MG,0
650,650,5647,2016,29,5/10/2016,Athletico-PR,Chapecoense,2,3,0,0,2,3,0,5,5,9,14,23,Athletico-PRChapecoense,0
651,651,5648,2016,29,5/10/2016,Vitoria,Gremio,3,3,0,0,3,3,0,6,6,16,19,35,VitoriaGremio,0
652,652,5649,2016,29,5/10/2016,Corinthians,Atletico-MG,0,2,0,1,0,3,1,2,3,16,16,32,CorinthiansAtletico-MG,0
2997,2997,5650,2016,29,5/10/2016,Santos,Fluminense,0,0,0,0,0,0,0,0,0,16,10,26,SantosFluminense,0
653,653,5651,2016,29,5/10/2016,Sport,Sao Paulo,0,2,0,0,0,2,0,2,2,19,17,36,SportSao Paulo,0
654,654,5652,2016,29,6/10/2016,Internacional,Coritiba,2,4,0,0,2,4,0,6,6,15,14,29,InternacionalCoritiba,0
655,655,5653,2016,29,8/10/2016,Cruzeiro,Ponte Preta,2,2,0,0,2,2,0,4,4,15,25,40,CruzeiroPonte Preta,0
656,656,5654,2016,29,9/10/2016,Flamengo,Santa Cruz,1,1,0,1,1,2,1,2,3,11,12,23,FlamengoSanta Cruz,0
657,657,5655,2016,29,9/10/2016,America-MG,Palmeiras,2,1,1,0,3,1,1,3,4,17,10,27,America-MGPalmeiras,0
658,658,5656,2016,29,9/10/2016,Figueirense,Botafogo-RJ,2,2,0,0,2,2,0,4,4,14,13,27,FigueirenseBotafogo-RJ,0
659,659,5657,2016,30,12/10/2016,Chapecoense,Sport,1,2,0,1,1,3,1,3,4,16,19,35,ChapecoenseSport,0
660,660,5658,2016,30,12/10/2016,Coritiba,Figueirense,4,3,0,0,4,3,0,7,7,13,22,35,CoritibaFigueirense,0
661,661,5659,2016,30,12/10/2016,Santa Cruz,Corinthians,2,2,0,0,2,2,0,4,4,8,7,15,Santa CruzCorinthians,0
662,662,5660,2016,30,12/10/2016,Botafogo-RJ,Internacional,3,2,0,0,3,2,0,5,5,17,15,32,Botafogo-RJInternacional,0
663,663,5661,2016,30,13/10/2016,Palmeiras,Cruzeiro,1,4,0,0,1,4,0,5,5,16,16,32,PalmeirasCruzeiro,0
664,664,5662,2016,30,13/10/2016,Ponte Preta,Vitoria,4,2,0,0,4,2,0,6,6,23,12,35,Ponte PretaVitoria,0
2998,2998,5663,2016,30,13/10/2016,Atletico-MG,America-MG,0,0,0,0,0,0,0,0,0,8,11,19,Atletico-MGAmerica-MG,1
665,665,5664,2016,30,13/10/2016,Fluminense,Flamengo,3,3,0,0,3,3,0,6,6,14,21,35,FluminenseFlamengo,1
666,666,5665,2016,30,13/10/2016,Sao Paulo,Santos,2,3,0,0,2,3,0,5,5,16,18,34,Sao PauloSantos,1
667,667,5666,2016,30,13/10/2016,Gremio,Athletico-PR,2,3,0,0,2,3,0,5,5,16,13,29,GremioAthletico-PR,0
668,668,5667,2016,31,16/10/2016,Botafogo-RJ,Atletico-MG,2,4,0,0,2,4,0,6,6,16,13,29,Botafogo-RJAtletico-MG,0
669,669,5668,2016,31,16/10/2016,Cruzeiro,Chapecoense,1,2,0,0,1,2,0,3,3,15,17,32,CruzeiroChapecoense,0
670,670,5669,2016,31,16/10/2016,Athletico-PR,Coritiba,0,3,0,0,0,3,0,3,3,18,14,32,Athletico-PRCoritiba,1
671,671,5670,2016,31,16/10/2016,Internacional,Flamengo,3,1,0,0,3,1,0,4,4,22,13,35,InternacionalFlamengo,0
672,672,5671,2016,31,16/10/2016,Figueirense,Palmeiras,4,3,0,0,4,3,0,7,7,18,29,47,FigueirensePalmeiras,0
673,673,5672,2016,31,16/10/2016,Corinthians,America-MG,2,1,0,0,2,1,0,3,3,11,10,21,CorinthiansAmerica-MG,0
674,674,5673,2016,31,16/10/2016,Ponte Preta,Santa Cruz,0,2,0,0,0,2,0,2,2,19,17,36,Ponte PretaSanta Cruz,0
675,675,5674,2016,31,16/10/2016,Santos,Gremio,1,7,0,0,1,7,0,8,8,13,20,33,SantosGremio,0
676,676,5675,2016,31,16/10/2016,Sport,Vitoria,1,4,0,1,1,5,1,5,6,9,20,29,SportVitoria,0
677,677,5676,2016,31,17/10/2016,Fluminense,Sao Paulo,1,4,0,0,1,4,0,5,5,8,18,26,FluminenseSao Paulo,0
678,678,5677,2016,32,19/10/2016,Santa Cruz,Botafogo-RJ,0,2,0,0,0,2,0,2,2,12,15,27,Santa CruzBotafogo-RJ,0
679,679,5678,2016,32,22/10/2016,Sao Paulo,Ponte Preta,0,1,0,0,0,1,0,1,1,16,15,31,Sao PauloPonte Preta,1
680,680,5679,2016,32,23/10/2016,Flamengo,Corinthians,2,4,0,1,2,5,1,6,7,13,19,32,FlamengoCorinthians,0
681,681,5680,2016,32,23/10/2016,Vitoria,Cruzeiro,2,3,0,1,2,4,1,5,6,20,16,36,VitoriaCruzeiro,0
682,682,5681,2016,32,23/10/2016,Palmeiras,Sport,3,2,0,0,3,2,0,5,5,26,23,49,PalmeirasSport,0
683,683,5682,2016,32,23/10/2016,Gremio,Internacional,0,2,1,1,1,3,2,2,4,12,25,37,GremioInternacional,1
684,684,5683,2016,32,23/10/2016,Coritiba,Fluminense,0,4,1,0,1,4,1,4,5,12,17,29,CoritibaFluminense,0
685,685,5684,2016,32,23/10/2016,Atletico-MG,Figueirense,2,4,0,2,2,6,2,6,8,16,15,31,Atletico-MGFigueirense,0
686,686,5685,2016,32,23/10/2016,Chapecoense,Santos,2,3,0,0,2,3,0,5,5,13,16,29,ChapecoenseSantos,0
2999,2999,5686,2016,32,24/10/2016,America-MG,Athletico-PR,0,0,0,0,0,0,0,0,0,8,9,17,America-MGAthletico-PR,0
687,687,5687,2016,33,27/10/2016,Sport,Ponte Preta,2,3,0,0,2,3,0,5,5,12,23,35,SportPonte Preta,0
688,688,5688,2016,33,28/10/2016,Fluminense,Vitoria,3,2,0,0,3,2,0,5,5,20,22,42,FluminenseVitoria,0
689,689,5689,2016,33,29/10/2016,Atletico-MG,Flamengo,0,1,0,0,0,1,0,1,1,12,14,26,Atletico-MGFlamengo,0
690,690,5690,2016,33,29/10/2016,Athletico-PR,Cruzeiro,1,1,0,0,1,1,0,2,2,17,13,30,Athletico-PRCruzeiro,0
691,691,5691,2016,33,29/10/2016,Corinthians,Chapecoense,1,2,0,0,1,2,0,3,3,11,18,29,CorinthiansChapecoense,0
692,692,5692,2016,33,29/10/2016,Botafogo-RJ,Coritiba,5,3,0,0,5,3,0,8,8,13,20,33,Botafogo-RJCoritiba,0
693,693,5693,2016,33,29/10/2016,Internacional,Santa Cruz,3,2,1,0,4,2,1,5,6,15,11,26,InternacionalSanta Cruz,0
694,694,5694,2016,33,29/10/2016,Figueirense,Gremio,2,2,0,0,2,2,0,4,4,22,18,40,FigueirenseGremio,0
695,695,5695,2016,33,29/10/2016,Santos,Palmeiras,4,3,0,0,4,3,0,7,7,20,22,42,SantosPalmeiras,1
696,696,5696,2016,33,31/10/2016,America-MG,Sao Paulo,0,1,0,0,0,1,0,1,1,17,8,25,America-MGSao Paulo,0
697,697,5697,2016,34,5/11/2016,Flamengo,Botafogo-RJ,3,3,0,0,3,3,0,6,6,14,26,40,FlamengoBotafogo-RJ,1
698,698,5698,2016,34,5/11/2016,Sao Paulo,Corinthians,3,4,0,0,3,4,0,7,7,21,19,40,Sao PauloCorinthians,1
699,699,5699,2016,34,6/11/2016,Ponte Preta,Santos,1,1,0,0,1,1,0,2,2,20,19,39,Ponte PretaSantos,1
700,700,5700,2016,34,6/11/2016,Santa Cruz,America-MG,1,1,0,0,1,1,0,2,2,10,9,19,Santa CruzAmerica-MG,0
701,701,5701,2016,34,6/11/2016,Cruzeiro,Fluminense,2,1,0,0,2,1,0,3,3,14,7,21,CruzeiroFluminense,0
3000,3000,5702,2016,34,6/11/2016,Palmeiras,Internacional,0,0,0,0,0,0,0,0,0,10,19,29,PalmeirasInternacional,0
702,702,5703,2016,34,6/11/2016,Vitoria,Athletico-PR,2,2,0,0,2,2,0,4,4,13,18,31,VitoriaAthletico-PR,0
703,703,5704,2016,34,6/11/2016,Coritiba,Atletico-MG,1,3,0,0,1,3,0,4,4,12,11,23,CoritibaAtletico-MG,0
704,704,5705,2016,34,6/11/2016,Chapecoense,Figueirense,1,3,0,1,1,4,1,4,5,16,20,36,ChapecoenseFigueirense,1
705,705,5706,2016,34,7/11/2016,Gremio,Sport,4,3,0,0,4,3,0,7,7,11,10,21,GremioSport,0
706,706,5707,2016,35,15/11/2016,Fluminense,Athletico-PR,3,3,0,0,3,3,0,6,6,14,16,30,FluminenseAthletico-PR,0
707,707,5708,2016,35,16/11/2016,Botafogo-RJ,Chapecoense,3,1,0,0,3,1,0,4,4,15,18,33,Botafogo-RJChapecoense,0
708,708,5709,2016,35,16/11/2016,Coritiba,Santa Cruz,3,2,0,0,3,2,0,5,5,18,13,31,CoritibaSanta Cruz,0
709,709,5710,2016,35,16/11/2016,Sport,Cruzeiro,2,2,0,0,2,2,0,4,4,10,11,21,SportCruzeiro,0
710,710,5711,2016,35,16/11/2016,America-MG,Flamengo,1,0,0,0,1,0,0,1,1,13,11,24,America-MGFlamengo,0
711,711,5712,2016,35,16/11/2016,Figueirense,Corinthians,3,2,0,1,3,3,1,5,6,26,15,41,FigueirenseCorinthians,0
712,712,5713,2016,35,17/11/2016,Santos,Vitoria,3,1,0,0,3,1,0,4,4,16,14,30,SantosVitoria,0
713,713,5714,2016,35,17/11/2016,Sao Paulo,Gremio,3,2,0,0,3,2,0,5,5,15,17,32,Sao PauloGremio,0
714,714,5715,2016,35,17/11/2016,Internacional,Ponte Preta,1,3,0,0,1,3,0,4,4,15,19,34,InternacionalPonte Preta,0
715,715,5716,2016,35,17/11/2016,Atletico-MG,Palmeiras,2,4,0,0,2,4,0,6,6,18,27,45,Atletico-MGPalmeiras,0
716,716,5717,2016,36,20/11/2016,Vitoria,Figueirense,4,2,0,0,4,2,0,6,6,20,16,36,VitoriaFigueirense,0
717,717,5718,2016,36,20/11/2016,Cruzeiro,Santos,3,3,1,0,4,3,1,6,7,11,11,22,CruzeiroSantos,0
718,718,5719,2016,36,20/11/2016,Palmeiras,Botafogo-RJ,0,4,0,1,0,5,1,4,5,13,22,35,PalmeirasBotafogo-RJ,0
719,719,5720,2016,36,20/11/2016,Athletico-PR,Sport,0,2,0,0,0,2,0,2,2,11,12,23,Athletico-PRSport,0
720,720,5721,2016,36,20/11/2016,Gremio,America-MG,0,2,0,0,0,2,0,2,2,8,18,26,GremioAmerica-MG,0
721,721,5722,2016,36,20/11/2016,Ponte Preta,Fluminense,3,3,0,1,3,4,1,6,7,20,18,38,Ponte PretaFluminense,0
722,722,5723,2016,36,20/11/2016,Flamengo,Coritiba,1,2,0,0,1,2,0,3,3,15,18,33,FlamengoCoritiba,0
723,723,5724,2016,36,20/11/2016,Chapecoense,Sao Paulo,1,1,0,0,1,1,0,2,2,20,19,39,ChapecoenseSao Paulo,0
724,724,5725,2016,36,20/11/2016,Santa Cruz,Atletico-MG,3,0,1,1,4,1,2,3,5,16,10,26,Santa CruzAtletico-MG,0
725,725,5726,2016,36,21/11/2016,Corinthians,Internacional,2,2,0,0,2,2,0,4,4,22,22,44,CorinthiansInternacional,0
726,726,5727,2016,37,26/11/2016,America-MG,Sport,1,3,1,0,2,3,1,4,5,13,15,28,America-MGSport,0
727,727,5728,2016,37,26/11/2016,Botafogo-RJ,Ponte Preta,5,4,0,1,5,5,1,9,10,19,17,36,Botafogo-RJPonte Preta,0
728,728,5729,2016,37,26/11/2016,Corinthians,Athletico-PR,3,2,0,0,3,2,0,5,5,6,9,15,CorinthiansAthletico-PR,0
729,729,5730,2016,37,27/11/2016,Atletico-MG,Sao Paulo,1,6,0,0,1,6,0,7,7,18,15,33,Atletico-MGSao Paulo,0
730,730,5731,2016,37,27/11/2016,Palmeiras,Chapecoense,1,2,0,0,1,2,0,3,3,25,24,49,PalmeirasChapecoense,0
731,731,5732,2016,37,27/11/2016,Flamengo,Santos,1,0,0,0,1,0,0,1,1,20,14,34,FlamengoSantos,0
732,732,5733,2016,37,27/11/2016,Internacional,Cruzeiro,3,4,0,0,3,4,0,7,7,13,15,28,InternacionalCruzeiro,0
733,733,5734,2016,37,27/11/2016,Figueirense,Fluminense,3,3,0,0,3,3,0,6,6,26,28,54,FigueirenseFluminense,0
734,734,5735,2016,37,27/11/2016,Santa Cruz,Gremio,3,4,0,0,3,4,0,7,7,12,16,28,Santa CruzGremio,0
735,735,5736,2016,37,28/11/2016,Coritiba,Vitoria,5,6,0,0,5,6,0,11,11,23,19,42,CoritibaVitoria,0
736,736,5737,2016,38,11/12/2016,Santos,America-MG,0,1,0,0,0,1,0,1,1,6,9,15,SantosAmerica-MG,0
737,737,5738,2016,38,11/12/2016,Fluminense,Internacional,1,1,0,0,1,1,0,2,2,19,23,42,FluminenseInternacional,0
738,738,5739,2016,38,11/12/2016,Gremio,Botafogo-RJ,2,4,0,1,2,5,1,6,7,10,13,23,GremioBotafogo-RJ,0
739,739,5740,2016,38,11/12/2016,Sao Paulo,Santa Cruz,2,1,1,0,3,1,1,3,4,13,9,22,Sao PauloSanta Cruz,0
740,740,5741,2016,38,11/12/2016,Cruzeiro,Corinthians,2,4,0,0,2,4,0,6,6,9,22,31,CruzeiroCorinthians,0
741,741,5742,2016,38,11/12/2016,Sport,Figueirense,5,2,0,0,5,2,0,7,7,22,22,44,SportFigueirense,0
742,742,5743,2016,38,11/12/2016,Athletico-PR,Flamengo,2,6,0,1,2,7,1,8,9,15,12,27,Athletico-PRFlamengo,0
743,743,5744,2016,38,11/12/2016,Vitoria,Palmeiras,1,6,0,0,1,6,0,7,7,15,16,31,VitoriaPalmeiras,0
744,744,5745,2016,38,11/12/2016,Ponte Preta,Coritiba,0,1,0,0,0,1,0,1,1,14,15,29,Ponte PretaCoritiba,0
745,745,5746,2017,1,13/5/2017,Flamengo,Atletico-MG,2,3,0,0,2,3,0,5,5,7,10,17,FlamengoAtletico-MG,0
746,746,5747,2017,1,13/5/2017,Corinthians,Chapecoense,2,2,0,0,2,2,0,4,4,10,12,22,CorinthiansChapecoense,0
747,747,5748,2017,1,14/5/2017,Fluminense,Santos,1,5,0,0,1,5,0,6,6,15,18,33,FluminenseSantos,0
748,748,5749,2017,1,14/5/2017,Cruzeiro,Sao Paulo,0,1,0,0,0,1,0,1,1,10,13,23,CruzeiroSao Paulo,0
749,749,5750,2017,1,14/5/2017,Bahia,Athletico-PR,0,1,0,1,0,2,1,1,2,11,11,22,BahiaAthletico-PR,0
750,750,5751,2017,1,14/5/2017,Ponte Preta,Sport,0,2,0,0,0,2,0,2,2,13,17,30,Ponte PretaSport,0
751,751,5752,2017,1,14/5/2017,Avai,Vitoria,0,2,0,0,0,2,0,2,2,6,15,21,AvaiVitoria,0
752,752,5753,2017,1,14/5/2017,Palmeiras,Vasco,0,2,0,0,0,2,0,2,2,19,16,35,PalmeirasVasco,0
753,753,5754,2017,1,14/5/2017,Gremio,Botafogo-RJ,2,5,0,0,2,5,0,7,7,13,19,32,GremioBotafogo-RJ,0
754,754,5755,2017,1,15/5/2017,Coritiba,Atletico-GO,1,2,0,0,1,2,0,3,3,17,13,30,CoritibaAtletico-GO,0
755,755,5756,2017,2,20/5/2017,Santos,Coritiba,6,4,0,0,6,4,0,10,10,24,17,41,SantosCoritiba,0
756,756,5757,2017,2,20/5/2017,Atletico-GO,Flamengo,2,1,0,0,2,1,0,3,3,11,13,24,Atletico-GOFlamengo,0
757,757,5758,2017,2,20/5/2017,Chapecoense,Palmeiras,1,1,0,0,1,1,0,2,2,16,13,29,ChapecoensePalmeiras,0
758,758,5759,2017,2,21/5/2017,Vasco,Bahia,4,2,0,1,4,3,1,6,7,13,23,36,VascoBahia,0
759,759,5760,2017,2,21/5/2017,Athletico-PR,Gremio,2,4,0,1,2,5,1,6,7,11,16,27,Athletico-PRGremio,0
760,760,5761,2017,2,21/5/2017,Vitoria,Corinthians,0,1,0,0,0,1,0,1,1,13,6,19,VitoriaCorinthians,0
761,761,5762,2017,2,21/5/2017,Atletico-MG,Fluminense,0,6,0,0,0,6,0,6,6,18,23,41,Atletico-MGFluminense,0
762,762,5763,2017,2,21/5/2017,Botafogo-RJ,Ponte Preta,1,0,0,0,1,0,0,1,1,15,12,27,Botafogo-RJPonte Preta,0
763,763,5764,2017,2,21/5/2017,Sport,Cruzeiro,3,3,0,0,3,3,0,6,6,20,14,34,SportCruzeiro,0
764,764,5765,2017,2,22/5/2017,Sao Paulo,Avai,1,2,0,0,1,2,0,3,3,16,10,26,Sao PauloAvai,0
765,765,5766,2017,3,27/5/2017,Vasco,Fluminense,2,3,0,0,2,3,0,5,5,11,11,22,VascoFluminense,1
766,766,5767,2017,3,27/5/2017,Sao Paulo,Palmeiras,3,1,0,0,3,1,0,4,4,13,16,29,Sao PauloPalmeiras,1
767,767,5768,2017,3,27/5/2017,Vitoria,Coritiba,3,3,0,0,3,3,0,6,6,19,16,35,VitoriaCoritiba,0
768,768,5769,2017,3,28/5/2017,Atletico-MG,Ponte Preta,2,2,0,0,2,2,0,4,4,16,14,30,Atletico-MGPonte Preta,0
769,769,5770,2017,3,28/5/2017,Athletico-PR,Flamengo,1,0,0,0,1,0,0,1,1,10,12,22,Athletico-PRFlamengo,0
770,770,5771,2017,3,28/5/2017,Santos,Cruzeiro,2,3,0,0,2,3,0,5,5,8,14,22,SantosCruzeiro,0
771,771,5772,2017,3,28/5/2017,Atletico-GO,Corinthians,2,0,0,0,2,0,0,2,2,23,11,34,Atletico-GOCorinthians,0
772,772,5773,2017,3,28/5/2017,Sport,Gremio,4,1,1,0,5,1,1,5,6,21,13,34,SportGremio,0
773,773,5774,2017,3,28/5/2017,Botafogo-RJ,Bahia,1,1,0,0,1,1,0,2,2,20,18,38,Botafogo-RJBahia,0
774,774,5775,2017,3,29/5/2017,Chapecoense,Avai,2,1,1,1,3,2,2,3,5,16,11,27,ChapecoenseAvai,1
775,775,5776,2017,4,3/6/2017,Coritiba,Athletico-PR,3,2,0,0,3,2,0,5,5,15,11,26,CoritibaAthletico-PR,1
776,776,5777,2017,4,3/6/2017,Fluminense,Vitoria,0,5,0,0,0,5,0,5,5,18,22,40,FluminenseVitoria,0
777,777,5778,2017,4,3/6/2017,Corinthians,Santos,0,1,0,1,0,2,1,1,2,11,9,20,CorinthiansSantos,1
778,778,5779,2017,4,4/6/2017,Flamengo,Botafogo-RJ,2,2,0,0,2,2,0,4,4,19,19,38,FlamengoBotafogo-RJ,1
779,779,5780,2017,4,4/6/2017,Avai,Sport,4,4,0,0,4,4,0,8,8,26,25,51,AvaiSport,0
780,780,5781,2017,4,4/6/2017,Palmeiras,Atletico-MG,2,4,0,0,2,4,0,6,6,20,12,32,PalmeirasAtletico-MG,0
781,781,5782,2017,4,4/6/2017,Ponte Preta,Sao Paulo,2,5,0,0,2,5,0,7,7,13,12,25,Ponte PretaSao Paulo,1
782,782,5783,2017,4,4/6/2017,Gremio,Vasco,2,3,0,0,2,3,0,5,5,15,13,28,GremioVasco,0
783,783,5784,2017,4,4/6/2017,Cruzeiro,Chapecoense,1,3,0,0,1,3,0,4,4,8,16,24,CruzeiroChapecoense,0
784,784,5785,2017,4,5/6/2017,Bahia,Atletico-GO,0,2,0,0,0,2,0,2,2,21,27,48,BahiaAtletico-GO,0
785,785,5786,2017,5,6/6/2017,Fluminense,Athletico-PR,3,3,0,0,3,3,0,6,6,19,16,35,FluminenseAthletico-PR,0
786,786,5787,2017,5,7/6/2017,Atletico-MG,Avai,3,1,0,0,3,1,0,4,4,20,10,30,Atletico-MGAvai,0
787,787,5788,2017,5,7/6/2017,Coritiba,Palmeiras,4,3,0,0,4,3,0,7,7,14,17,31,CoritibaPalmeiras,0
788,788,5789,2017,5,7/6/2017,Santos,Botafogo-RJ,4,2,0,0,4,2,0,6,6,13,9,22,SantosBotafogo-RJ,0
789,789,5790,2017,5,7/6/2017,Vasco,Corinthians,0,3,0,0,0,3,0,3,3,10,14,24,VascoCorinthians,0
790,790,5791,2017,5,7/6/2017,Sport,Flamengo,2,2,0,0,2,2,0,4,4,17,16,33,SportFlamengo,0
791,791,5792,2017,5,8/6/2017,Atletico-GO,Ponte Preta,1,2,0,1,1,3,1,3,4,20,9,29,Atletico-GOPonte Preta,0
792,792,5793,2017,5,8/6/2017,Sao Paulo,Vitoria,1,1,0,0,1,1,0,2,2,14,18,32,Sao PauloVitoria,0
793,793,5794,2017,5,8/6/2017,Chapecoense,Gremio,4,3,0,0,4,3,0,7,7,22,9,31,ChapecoenseGremio,0
794,794,5795,2017,5,8/6/2017,Bahia,Cruzeiro,4,2,0,1,4,3,1,6,7,18,12,30,BahiaCruzeiro,0
795,795,5796,2017,6,10/6/2017,Palmeiras,Fluminense,4,2,0,0,4,2,0,6,6,24,19,43,PalmeirasFluminense,0
796,796,5797,2017,6,10/6/2017,Vasco,Sport,0,1,0,0,0,1,0,1,1,15,19,34,VascoSport,0
797,797,5798,2017,6,11/6/2017,Botafogo-RJ,Coritiba,4,3,0,0,4,3,0,7,7,14,28,42,Botafogo-RJCoritiba,0
798,798,5799,2017,6,11/6/2017,Ponte Preta,Chapecoense,2,4,0,0,2,4,0,6,6,8,22,30,Ponte PretaChapecoense,0
799,799,5800,2017,6,11/6/2017,Avai,Flamengo,2,1,1,0,3,1,1,3,4,17,18,35,AvaiFlamengo,0
800,800,5801,2017,6,11/6/2017,Vitoria,Atletico-MG,3,2,0,0,3,2,0,5,5,20,7,27,VitoriaAtletico-MG,0
801,801,5802,2017,6,11/6/2017,Corinthians,Sao Paulo,1,1,0,0,1,1,0,2,2,11,15,26,CorinthiansSao Paulo,1
802,802,5803,2017,6,11/6/2017,Cruzeiro,Atletico-GO,3,4,0,0,3,4,0,7,7,11,21,32,CruzeiroAtletico-GO,0
803,803,5804,2017,6,11/6/2017,Athletico-PR,Santos,1,1,0,1,1,2,1,2,3,15,12,27,Athletico-PRSantos,0
804,804,5805,2017,6,12/6/2017,Gremio,Bahia,0,1,0,0,0,1,0,1,1,15,16,31,GremioBahia,0
805,805,5806,2017,7,14/6/2017,Atletico-MG,Athletico-PR,2,5,0,1,2,6,1,7,8,11,10,21,Atletico-MGAthletico-PR,0
806,806,5807,2017,7,14/6/2017,Atletico-GO,Avai,3,6,0,0,3,6,0,9,9,21,24,45,Atletico-GOAvai,0
807,807,5808,2017,7,14/6/2017,Vitoria,Botafogo-RJ,1,1,1,0,2,1,1,2,3,12,10,22,VitoriaBotafogo-RJ,0
808,808,5809,2017,7,14/6/2017,Sport,Sao Paulo,1,1,0,0,1,1,0,2,2,21,14,35,SportSao Paulo,0
809,809,5810,2017,7,14/6/2017,Flamengo,Ponte Preta,2,2,0,0,2,2,0,4,4,12,16,28,FlamengoPonte Preta,0
810,810,5811,2017,7,14/6/2017,Santos,Palmeiras,1,3,0,0,1,3,0,4,4,16,14,30,SantosPalmeiras,1
811,811,5812,2017,7,14/6/2017,Chapecoense,Vasco,3,2,0,0,3,2,0,5,5,24,15,39,ChapecoenseVasco,0
812,812,5813,2017,7,14/6/2017,Corinthians,Cruzeiro,0,1,0,0,0,1,0,1,1,9,16,25,CorinthiansCruzeiro,0
813,813,5814,2017,7,15/6/2017,Coritiba,Bahia,1,4,1,1,2,5,2,5,7,16,14,30,CoritibaBahia,0
814,814,5815,2017,7,15/6/2017,Fluminense,Gremio,4,3,0,0,4,3,0,7,7,12,17,29,FluminenseGremio,0
815,815,5816,2017,8,17/6/2017,Atletico-GO,Athletico-PR,1,5,0,0,1,5,0,6,6,16,15,31,Atletico-GOAthletico-PR,0
816,816,5817,2017,8,17/6/2017,Vasco,Avai,4,1,0,0,4,1,0,5,5,20,22,42,VascoAvai,0
817,817,5818,2017,8,17/6/2017,Santos,Ponte Preta,3,4,0,0,3,4,0,7,7,17,13,30,SantosPonte Preta,1
818,818,5819,2017,8,18/6/2017,Coritiba,Corinthians,2,3,0,0,2,3,0,5,5,18,13,31,CoritibaCorinthians,0
819,819,5820,2017,8,18/6/2017,Bahia,Palmeiras,2,5,0,0,2,5,0,7,7,14,23,37,BahiaPalmeiras,0
820,820,5821,2017,8,18/6/2017,Fluminense,Flamengo,1,6,0,0,1,6,0,7,7,16,25,41,FluminenseFlamengo,1
821,821,5822,2017,8,18/6/2017,Chapecoense,Botafogo-RJ,0,2,0,0,0,2,0,2,2,11,13,24,ChapecoenseBotafogo-RJ,0
822,822,5823,2017,8,18/6/2017,Sao Paulo,Atletico-MG,2,2,0,0,2,2,0,4,4,12,24,36,Sao PauloAtletico-MG,0
3001,3001,5824,2017,8,18/6/2017,Sport,Vitoria,0,0,0,0,0,0,0,0,0,10,19,29,SportVitoria,0
823,823,5825,2017,8,19/6/2017,Cruzeiro,Gremio,5,2,0,0,5,2,0,7,7,12,14,26,CruzeiroGremio,0
824,824,5826,2017,9,21/6/2017,Vitoria,Santos,2,1,0,0,2,1,0,3,3,15,10,25,VitoriaSantos,0
825,825,5827,2017,9,21/6/2017,Palmeiras,Atletico-GO,2,2,0,0,2,2,0,4,4,10,17,27,PalmeirasAtletico-GO,0
826,826,5828,2017,9,21/6/2017,Botafogo-RJ,Vasco,5,1,0,0,5,1,0,6,6,20,11,31,Botafogo-RJVasco,1
827,827,5829,2017,9,21/6/2017,Avai,Fluminense,1,1,0,0,1,1,0,2,2,19,20,39,AvaiFluminense,0
828,828,5830,2017,9,21/6/2017,Athletico-PR,Sao Paulo,3,3,0,0,3,3,0,6,6,17,15,32,Athletico-PRSao Paulo,0
829,829,5831,2017,9,21/6/2017,Atletico-MG,Sport,2,1,0,0,2,1,0,3,3,23,26,49,Atletico-MGSport,0
830,830,5832,2017,9,22/6/2017,Corinthians,Bahia,3,3,1,1,4,4,2,6,8,15,12,27,CorinthiansBahia,0
831,831,5833,2017,9,22/6/2017,Ponte Preta,Cruzeiro,2,2,0,0,2,2,0,4,4,21,23,44,Ponte PretaCruzeiro,0
832,832,5834,2017,9,22/6/2017,Gremio,Coritiba,2,0,0,0,2,0,0,2,2,18,11,29,GremioCoritiba,0
833,833,5835,2017,9,22/6/2017,Flamengo,Chapecoense,3,1,0,0,3,1,0,4,4,21,13,34,FlamengoChapecoense,0
834,834,5836,2017,10,24/6/2017,Santos,Sport,0,1,0,0,0,1,0,1,1,13,17,30,SantosSport,0
835,835,5837,2017,10,25/6/2017,Vasco,Atletico-GO,2,0,0,0,2,0,0,2,2,21,19,40,VascoAtletico-GO,0
836,836,5838,2017,10,25/6/2017,Gremio,Corinthians,4,5,0,0,4,5,0,9,9,16,16,32,GremioCorinthians,0
837,837,5839,2017,10,25/6/2017,Sao Paulo,Fluminense,1,1,0,0,1,1,0,2,2,12,25,37,Sao PauloFluminense,0
838,838,5840,2017,10,25/6/2017,Athletico-PR,Vitoria,0,3,0,0,0,3,0,3,3,10,11,21,Athletico-PRVitoria,0
839,839,5841,2017,10,25/6/2017,Cruzeiro,Coritiba,0,2,0,0,0,2,0,2,2,15,26,41,CruzeiroCoritiba,0
840,840,5842,2017,10,25/6/2017,Ponte Preta,Palmeiras,6,3,2,1,8,4,3,9,12,21,28,49,Ponte PretaPalmeiras,1
841,841,5843,2017,10,25/6/2017,Bahia,Flamengo,2,3,1,0,3,3,1,5,6,6,23,29,BahiaFlamengo,0
842,842,5844,2017,10,25/6/2017,Chapecoense,Atletico-MG,5,5,0,0,5,5,0,10,10,24,19,43,ChapecoenseAtletico-MG,0
843,843,5845,2017,10,26/6/2017,Botafogo-RJ,Avai,1,2,0,0,1,2,0,3,3,11,10,21,Botafogo-RJAvai,0
844,844,5846,2017,11,1/7/2017,Palmeiras,Gremio,3,1,0,0,3,1,0,4,4,23,14,37,PalmeirasGremio,0
845,845,5847,2017,11,1/7/2017,Atletico-GO,Santos,3,1,1,0,4,1,1,4,5,14,10,24,Atletico-GOSantos,0
846,846,5848,2017,11,2/7/2017,Sport,Athletico-PR,1,3,0,0,1,3,0,4,4,12,18,30,SportAthletico-PR,0
847,847,5849,2017,11,2/7/2017,Vitoria,Bahia,5,3,0,0,5,3,0,8,8,17,16,33,VitoriaBahia,1
848,848,5850,2017,11,2/7/2017,Atletico-MG,Cruzeiro,4,4,0,0,4,4,0,8,8,23,18,41,Atletico-MGCruzeiro,1
849,849,5851,2017,11,2/7/2017,Flamengo,Sao Paulo,1,1,0,0,1,1,0,2,2,17,14,31,FlamengoSao Paulo,0
850,850,5852,2017,11,2/7/2017,Corinthians,Botafogo-RJ,3,2,0,0,3,2,0,5,5,14,14,28,CorinthiansBotafogo-RJ,0
851,851,5853,2017,11,2/7/2017,Avai,Ponte Preta,2,2,0,0,2,2,0,4,4,14,25,39,AvaiPonte Preta,0
852,852,5854,2017,11,2/7/2017,Coritiba,Vasco,3,5,0,0,3,5,0,8,8,17,20,37,CoritibaVasco,0
853,853,5855,2017,11,3/7/2017,Fluminense,Chapecoense,3,5,0,1,3,6,1,8,9,14,22,36,FluminenseChapecoense,0
854,854,5856,2017,12,8/7/2017,Atletico-GO,Vitoria,1,4,0,0,1,4,0,5,5,12,23,35,Atletico-GOVitoria,0
855,855,5857,2017,12,8/7/2017,Vasco,Flamengo,4,1,0,0,4,1,0,5,5,23,15,38,VascoFlamengo,1
856,856,5858,2017,12,8/7/2017,Corinthians,Ponte Preta,2,2,0,0,2,2,0,4,4,17,8,25,CorinthiansPonte Preta,1
857,857,5859,2017,12,9/7/2017,Chapecoense,Athletico-PR,1,3,0,0,1,3,0,4,4,18,13,31,ChapecoenseAthletico-PR,0
858,858,5860,2017,12,9/7/2017,Bahia,Fluminense,4,2,0,0,4,2,0,6,6,16,18,34,BahiaFluminense,0
859,859,5861,2017,12,9/7/2017,Gremio,Avai,1,5,0,1,1,6,1,6,7,9,17,26,GremioAvai,0
860,860,5862,2017,12,9/7/2017,Cruzeiro,Palmeiras,1,4,0,0,1,4,0,5,5,12,15,27,CruzeiroPalmeiras,0
861,861,5863,2017,12,9/7/2017,Santos,Sao Paulo,4,3,0,0,4,3,0,7,7,18,5,23,SantosSao Paulo,1
862,862,5864,2017,12,9/7/2017,Botafogo-RJ,Atletico-MG,1,3,0,0,1,3,0,4,4,14,27,41,Botafogo-RJAtletico-MG,0
863,863,5865,2017,12,10/7/2017,Coritiba,Sport,2,2,1,0,3,2,1,4,5,16,18,34,CoritibaSport,0
864,864,5866,2017,13,12/7/2017,Ponte Preta,Bahia,1,3,0,0,1,3,0,4,4,12,14,26,Ponte PretaBahia,0
865,865,5867,2017,13,12/7/2017,Atletico-MG,Santos,1,2,0,0,1,2,0,3,3,9,13,22,Atletico-MGSantos,0
866,866,5868,2017,13,12/7/2017,Fluminense,Botafogo-RJ,3,4,0,0,3,4,0,7,7,13,20,33,FluminenseBotafogo-RJ,1
867,867,5869,2017,13,12/7/2017,Palmeiras,Corinthians,3,4,0,0,3,4,0,7,7,16,14,30,PalmeirasCorinthians,1
868,868,5870,2017,13,12/7/2017,Athletico-PR,Cruzeiro,3,1,0,0,3,1,0,4,4,16,9,25,Athletico-PRCruzeiro,0
869,869,5871,2017,13,12/7/2017,Vitoria,Vasco,4,3,0,0,4,3,0,7,7,16,14,30,VitoriaVasco,0
870,870,5872,2017,13,13/7/2017,Sao Paulo,Atletico-GO,0,3,0,0,0,3,0,3,3,18,21,39,Sao PauloAtletico-GO,0
871,871,5873,2017,13,13/7/2017,Sport,Chapecoense,2,8,0,0,2,8,0,10,10,9,26,35,SportChapecoense,0
872,872,5874,2017,13,13/7/2017,Flamengo,Gremio,2,2,0,0,2,2,0,4,4,12,20,32,FlamengoGremio,0
873,873,5875,2017,13,13/7/2017,Avai,Coritiba,2,2,0,0,2,2,0,4,4,14,18,32,AvaiCoritiba,0
3002,3002,5876,2017,14,15/7/2017,Corinthians,Athletico-PR,0,0,0,0,0,0,0,0,0,5,11,16,CorinthiansAthletico-PR,0
874,874,5877,2017,14,16/7/2017,Palmeiras,Vitoria,2,3,0,0,2,3,0,5,5,21,19,40,PalmeirasVitoria,0
875,875,5878,2017,14,16/7/2017,Vasco,Santos,4,3,0,1,4,4,1,7,8,16,25,41,VascoSantos,0
876,876,5879,2017,14,16/7/2017,Atletico-GO,Atletico-MG,2,3,0,0,2,3,0,5,5,21,24,45,Atletico-GOAtletico-MG,0
877,877,5880,2017,14,16/7/2017,Chapecoense,Sao Paulo,4,2,0,0,4,2,0,6,6,22,14,36,ChapecoenseSao Paulo,0
878,878,5881,2017,14,16/7/2017,Cruzeiro,Flamengo,3,1,0,0,3,1,0,4,4,16,14,30,CruzeiroFlamengo,0
879,879,5882,2017,14,16/7/2017,Gremio,Ponte Preta,1,2,0,0,1,2,0,3,3,20,18,38,GremioPonte Preta,0
880,880,5883,2017,14,16/7/2017,Bahia,Avai,2,0,0,0,2,0,0,2,2,18,12,30,BahiaAvai,0
881,881,5884,2017,14,16/7/2017,Coritiba,Fluminense,4,4,0,0,4,4,0,8,8,19,18,37,CoritibaFluminense,0
882,882,5885,2017,14,17/7/2017,Botafogo-RJ,Sport,4,3,0,0,4,3,0,7,7,14,16,30,Botafogo-RJSport,0
883,883,5886,2017,15,19/7/2017,Vitoria,Gremio,3,3,0,0,3,3,0,6,6,18,7,25,VitoriaGremio,0
884,884,5887,2017,15,19/7/2017,Santos,Chapecoense,5,2,0,0,5,2,0,7,7,13,17,30,SantosChapecoense,0
885,885,5888,2017,15,19/7/2017,Avai,Corinthians,2,3,0,0,2,3,0,5,5,18,10,28,AvaiCorinthians,0
886,886,5889,2017,15,19/7/2017,Ponte Preta,Coritiba,1,0,0,0,1,0,0,1,1,12,12,24,Ponte PretaCoritiba,0
887,887,5890,2017,15,19/7/2017,Atletico-MG,Bahia,4,6,0,0,4,6,0,10,10,19,18,37,Atletico-MGBahia,0
888,888,5891,2017,15,19/7/2017,Sao Paulo,Vasco,3,3,0,0,3,3,0,6,6,26,20,46,Sao PauloVasco,0
889,889,5892,2017,15,19/7/2017,Flamengo,Palmeiras,2,9,0,0,2,9,0,11,11,16,23,39,FlamengoPalmeiras,0
890,890,5893,2017,15,20/7/2017,Fluminense,Cruzeiro,3,3,0,0,3,3,0,6,6,21,18,39,FluminenseCruzeiro,0
891,891,5894,2017,15,20/7/2017,Sport,Atletico-GO,2,1,0,0,2,1,0,3,3,22,34,56,SportAtletico-GO,0
892,892,5895,2017,15,20/7/2017,Athletico-PR,Botafogo-RJ,3,5,0,1,3,6,1,8,9,16,21,37,Athletico-PRBotafogo-RJ,0
893,893,5896,2017,16,22/7/2017,Vitoria,Chapecoense,2,5,0,0,2,5,0,7,7,13,19,32,VitoriaChapecoense,0
894,894,5897,2017,16,22/7/2017,Flamengo,Coritiba,1,6,0,0,1,6,0,7,7,20,24,44,FlamengoCoritiba,0
895,895,5898,2017,16,23/7/2017,Santos,Bahia,1,1,0,0,1,1,0,2,2,10,19,29,SantosBahia,0
896,896,5899,2017,16,23/7/2017,Avai,Cruzeiro,2,0,0,0,2,0,0,2,2,20,10,30,AvaiCruzeiro,0
897,897,5900,2017,16,23/7/2017,Sport,Palmeiras,3,4,0,0,3,4,0,7,7,21,31,52,SportPalmeiras,0
898,898,5901,2017,16,23/7/2017,Fluminense,Corinthians,2,2,0,0,2,2,0,4,4,15,13,28,FluminenseCorinthians,0
899,899,5902,2017,16,23/7/2017,Athletico-PR,Ponte Preta,2,2,0,0,2,2,0,4,4,25,19,44,Athletico-PRPonte Preta,0
900,900,5903,2017,16,23/7/2017,Atletico-GO,Botafogo-RJ,1,4,0,0,1,4,0,5,5,12,20,32,Atletico-GOBotafogo-RJ,0
901,901,5904,2017,16,23/7/2017,Atletico-MG,Vasco,5,3,0,0,5,3,0,8,8,24,16,40,Atletico-MGVasco,0
902,902,5905,2017,16,24/7/2017,Sao Paulo,Gremio,1,3,0,0,1,3,0,4,4,17,14,31,Sao PauloGremio,0
903,903,5906,2017,17,29/7/2017,Botafogo-RJ,Sao Paulo,0,1,0,0,0,1,0,1,1,9,11,20,Botafogo-RJSao Paulo,0
904,904,5907,2017,17,29/7/2017,Palmeiras,Avai,1,2,0,1,1,3,1,3,4,19,18,37,PalmeirasAvai,0
905,905,5908,2017,17,30/7/2017,Chapecoense,Atletico-GO,1,1,0,0,1,1,0,2,2,21,19,40,ChapecoenseAtletico-GO,0
906,906,5909,2017,17,30/7/2017,Coritiba,Atletico-MG,4,4,0,0,4,4,0,8,8,18,25,43,CoritibaAtletico-MG,0
907,907,5910,2017,17,30/7/2017,Bahia,Sport,2,6,0,0,2,6,0,8,8,18,24,42,BahiaSport,0
908,908,5911,2017,17,30/7/2017,Corinthians,Flamengo,0,1,0,0,0,1,0,1,1,9,16,25,CorinthiansFlamengo,0
909,909,5912,2017,17,30/7/2017,Gremio,Santos,4,5,1,0,5,5,1,9,10,14,17,31,GremioSantos,0
910,910,5913,2017,17,30/7/2017,Cruzeiro,Vitoria,4,4,0,0,4,4,0,8,8,15,23,38,CruzeiroVitoria,0
911,911,5914,2017,17,31/7/2017,Vasco,Athletico-PR,3,3,0,0,3,3,0,6,6,13,20,33,VascoAthletico-PR,0
912,912,5915,2017,17,9/8/2017,Ponte Preta,Fluminense,1,1,0,0,1,1,0,2,2,14,12,26,Ponte PretaFluminense,0
913,913,5916,2017,18,2/8/2017,Sport,Fluminense,5,4,0,1,5,5,1,9,10,14,18,32,SportFluminense,0
914,914,5917,2017,18,2/8/2017,Chapecoense,Bahia,5,3,0,0,5,3,0,8,8,26,17,43,ChapecoenseBahia,0
915,915,5918,2017,18,2/8/2017,Atletico-MG,Corinthians,3,1,0,0,3,1,0,4,4,19,12,31,Atletico-MGCorinthians,0
916,916,5919,2017,18,2/8/2017,Vitoria,Ponte Preta,3,1,0,0,3,1,0,4,4,20,7,27,VitoriaPonte Preta,0
917,917,5920,2017,18,2/8/2017,Santos,Flamengo,3,3,1,1,4,4,2,6,8,18,15,33,SantosFlamengo,0
918,918,5921,2017,18,2/8/2017,Atletico-GO,Gremio,4,2,0,0,4,2,0,6,6,20,21,41,Atletico-GOGremio,0
919,919,5922,2017,18,2/8/2017,Botafogo-RJ,Palmeiras,5,2,0,0,5,2,0,7,7,22,14,36,Botafogo-RJPalmeiras,0
920,920,5923,2017,18,3/8/2017,Athletico-PR,Avai,1,2,0,0,1,2,0,3,3,9,18,27,Athletico-PRAvai,0
921,921,5924,2017,18,3/8/2017,Sao Paulo,Coritiba,4,5,0,0,4,5,0,9,9,18,15,33,Sao PauloCoritiba,0
922,922,5925,2017,18,3/8/2017,Vasco,Cruzeiro,4,1,0,0,4,1,0,5,5,12,18,30,VascoCruzeiro,0
923,923,5926,2017,19,5/8/2017,Corinthians,Sport,1,2,0,0,1,2,0,3,3,2,10,12,CorinthiansSport,0
924,924,5927,2017,19,5/8/2017,Fluminense,Atletico-GO,1,3,0,0,1,3,0,4,4,13,12,25,FluminenseAtletico-GO,0
925,925,5928,2017,19,6/8/2017,Flamengo,Vitoria,4,2,0,0,4,2,0,6,6,15,21,36,FlamengoVitoria,0
926,926,5929,2017,19,6/8/2017,Cruzeiro,Botafogo-RJ,3,3,0,0,3,3,0,6,6,16,15,31,CruzeiroBotafogo-RJ,0
927,927,5930,2017,19,6/8/2017,Gremio,Atletico-MG,3,1,0,0,3,1,0,4,4,18,13,31,GremioAtletico-MG,0
3003,3003,5931,2017,19,6/8/2017,Coritiba,Chapecoense,0,0,0,0,0,0,0,0,0,13,21,34,CoritibaChapecoense,0
928,928,5932,2017,19,6/8/2017,Palmeiras,Athletico-PR,1,3,0,0,1,3,0,4,4,10,22,32,PalmeirasAthletico-PR,0
929,929,5933,2017,19,6/8/2017,Bahia,Sao Paulo,4,2,0,0,4,2,0,6,6,20,12,32,BahiaSao Paulo,0
930,930,5934,2017,19,6/8/2017,Avai,Santos,3,1,0,0,3,1,0,4,4,22,16,38,AvaiSantos,0
931,931,5935,2017,19,6/8/2017,Ponte Preta,Vasco,1,4,0,0,1,4,0,5,5,17,16,33,Ponte PretaVasco,0
932,932,5936,2017,20,12/8/2017,Atletico-GO,Coritiba,2,3,0,0,2,3,0,5,5,27,20,47,Atletico-GOCoritiba,0
933,933,5937,2017,20,12/8/2017,Vitoria,Avai,1,3,0,0,1,3,0,4,4,14,11,25,VitoriaAvai,0
934,934,5938,2017,20,13/8/2017,Sao Paulo,Cruzeiro,5,4,1,2,6,6,3,9,12,19,18,37,Sao PauloCruzeiro,0
935,935,5939,2017,20,13/8/2017,Sport,Ponte Preta,1,1,0,0,1,1,0,2,2,14,10,24,SportPonte Preta,0
936,936,5940,2017,20,13/8/2017,Atletico-MG,Flamengo,4,2,0,1,4,3,1,6,7,22,17,39,Atletico-MGFlamengo,0
937,937,5941,2017,20,13/8/2017,Vasco,Palmeiras,1,2,0,0,1,2,0,3,3,17,13,30,VascoPalmeiras,0
938,938,5942,2017,20,13/8/2017,Athletico-PR,Bahia,2,4,0,0,2,4,0,6,6,13,15,28,Athletico-PRBahia,0
939,939,5943,2017,20,13/8/2017,Botafogo-RJ,Gremio,3,1,0,0,3,1,0,4,4,18,15,33,Botafogo-RJGremio,0
940,940,5944,2017,20,14/8/2017,Santos,Fluminense,2,2,0,0,2,2,0,4,4,7,10,17,SantosFluminense,0
941,941,5945,2017,20,23/8/2017,Chapecoense,Corinthians,1,4,0,0,1,4,0,5,5,13,7,20,ChapecoenseCorinthians,0
942,942,5946,2017,21,19/8/2017,Corinthians,Vitoria,1,2,0,0,1,2,0,3,3,9,21,30,CorinthiansVitoria,0
943,943,5947,2017,21,19/8/2017,Flamengo,Atletico-GO,2,3,0,0,2,3,0,5,5,12,13,25,FlamengoAtletico-GO,0
944,944,5948,2017,21,20/8/2017,Gremio,Athletico-PR,2,2,0,0,2,2,0,4,4,11,26,37,GremioAthletico-PR,0
945,945,5949,2017,21,20/8/2017,Avai,Sao Paulo,1,3,0,0,1,3,0,4,4,17,16,33,AvaiSao Paulo,0
946,946,5950,2017,21,20/8/2017,Bahia,Vasco,0,4,0,0,0,4,0,4,4,18,18,36,BahiaVasco,0
947,947,5951,2017,21,20/8/2017,Cruzeiro,Sport,1,0,0,0,1,0,0,1,1,11,12,23,CruzeiroSport,0
948,948,5952,2017,21,20/8/2017,Ponte Preta,Botafogo-RJ,4,4,0,0,4,4,0,8,8,18,18,36,Ponte PretaBotafogo-RJ,0
949,949,5953,2017,21,20/8/2017,Coritiba,Santos,3,1,0,0,3,1,0,4,4,13,7,20,CoritibaSantos,0
950,950,5954,2017,21,20/8/2017,Palmeiras,Chapecoense,1,4,0,0,1,4,0,5,5,11,24,35,PalmeirasChapecoense,0
951,951,5955,2017,21,21/8/2017,Fluminense,Atletico-MG,1,2,0,0,1,2,0,3,3,0,0,0,FluminenseAtletico-MG,0
952,952,5956,2017,22,26/8/2017,Fluminense,Vasco,2,4,0,0,2,4,0,6,6,14,12,26,FluminenseVasco,1
953,953,5957,2017,22,26/8/2017,Corinthians,Atletico-GO,1,5,0,0,1,5,0,6,6,15,17,32,CorinthiansAtletico-GO,0
954,954,5958,2017,22,27/8/2017,Ponte Preta,Atletico-MG,4,4,0,0,4,4,0,8,8,20,19,39,Ponte PretaAtletico-MG,0
955,955,5959,2017,22,27/8/2017,Palmeiras,Sao Paulo,1,2,0,0,1,2,0,3,3,12,8,20,PalmeirasSao Paulo,1
956,956,5960,2017,22,27/8/2017,Bahia,Botafogo-RJ,2,0,0,0,2,0,0,2,2,14,9,23,BahiaBotafogo-RJ,0
957,957,5961,2017,22,27/8/2017,Flamengo,Athletico-PR,0,2,0,0,0,2,0,2,2,6,11,17,FlamengoAthletico-PR,0
958,958,5962,2017,22,27/8/2017,Cruzeiro,Santos,0,2,0,0,0,2,0,2,2,13,18,31,CruzeiroSantos,0
959,959,5963,2017,22,27/8/2017,Avai,Chapecoense,4,5,0,0,4,5,0,9,9,18,22,40,AvaiChapecoense,1
960,960,5964,2017,22,28/8/2017,Coritiba,Vitoria,2,2,2,1,4,3,3,4,7,18,22,40,CoritibaVitoria,0
961,961,5965,2017,22,2/9/2017,Gremio,Sport,1,5,0,0,1,5,0,6,6,8,21,29,GremioSport,0
962,962,5966,2017,23,9/9/2017,Atletico-MG,Palmeiras,3,3,0,2,3,5,2,6,8,14,18,32,Atletico-MGPalmeiras,0
963,963,5967,2017,23,9/9/2017,Vasco,Gremio,3,0,0,0,3,0,0,3,3,18,11,29,VascoGremio,0
964,964,5968,2017,23,9/9/2017,Sao Paulo,Ponte Preta,2,1,1,0,3,1,1,3,4,12,9,21,Sao PauloPonte Preta,1
965,965,5969,2017,23,10/9/2017,Athletico-PR,Coritiba,1,3,0,1,1,4,1,4,5,16,15,31,Athletico-PRCoritiba,1
966,966,5970,2017,23,10/9/2017,Santos,Corinthians,3,5,0,0,3,5,0,8,8,9,17,26,SantosCorinthians,1
967,967,5971,2017,23,10/9/2017,Sport,Avai,4,5,0,0,4,5,0,9,9,13,17,30,SportAvai,0
968,968,5972,2017,23,10/9/2017,Vitoria,Fluminense,1,3,0,1,1,4,1,4,5,9,11,20,VitoriaFluminense,0
969,969,5973,2017,23,10/9/2017,Chapecoense,Cruzeiro,2,1,0,0,2,1,0,3,3,15,17,32,ChapecoenseCruzeiro,0
3004,3004,5974,2017,23,10/9/2017,Botafogo-RJ,Flamengo,0,0,0,0,0,0,0,0,0,10,16,26,Botafogo-RJFlamengo,1
970,970,5975,2017,23,11/9/2017,Atletico-GO,Bahia,1,2,0,0,1,2,0,3,3,16,11,27,Atletico-GOBahia,0
971,971,5976,2017,24,16/9/2017,Botafogo-RJ,Santos,2,2,0,0,2,2,0,4,4,14,12,26,Botafogo-RJSantos,0
972,972,5977,2017,24,16/9/2017,Ponte Preta,Atletico-GO,2,2,0,0,2,2,0,4,4,22,20,42,Ponte PretaAtletico-GO,0
973,973,5978,2017,24,17/9/2017,Avai,Atletico-MG,2,3,0,1,2,4,1,5,6,17,16,33,AvaiAtletico-MG,0
974,974,5979,2017,24,17/9/2017,Gremio,Chapecoense,1,5,0,0,1,5,0,6,6,6,19,25,GremioChapecoense,0
975,975,5980,2017,24,17/9/2017,Corinthians,Vasco,1,2,0,0,1,2,0,3,3,15,9,24,CorinthiansVasco,0
976,976,5981,2017,24,17/9/2017,Athletico-PR,Fluminense,3,3,0,0,3,3,0,6,6,15,13,28,Athletico-PRFluminense,0
977,977,5982,2017,24,17/9/2017,Vitoria,Sao Paulo,3,2,0,0,3,2,0,5,5,21,16,37,VitoriaSao Paulo,0
978,978,5983,2017,24,17/9/2017,Flamengo,Sport,0,3,0,1,0,4,1,3,4,13,18,31,FlamengoSport,0
979,979,5984,2017,24,17/9/2017,Cruzeiro,Bahia,5,1,1,0,6,1,1,6,7,12,19,31,CruzeiroBahia,0
980,980,5985,2017,24,18/9/2017,Palmeiras,Coritiba,3,3,0,0,3,3,0,6,6,18,17,35,PalmeirasCoritiba,0
981,981,5986,2017,25,23/9/2017,Flamengo,Avai,2,0,0,0,2,0,0,2,2,14,16,30,FlamengoAvai,0
982,982,5987,2017,25,23/9/2017,Santos,Athletico-PR,1,1,0,0,1,1,0,2,2,7,14,21,SantosAthletico-PR,0
983,983,5988,2017,25,24/9/2017,Sao Paulo,Corinthians,2,4,0,0,2,4,0,6,6,13,12,25,Sao PauloCorinthians,1
984,984,5989,2017,25,24/9/2017,Chapecoense,Ponte Preta,4,3,0,0,4,3,0,7,7,16,19,35,ChapecoensePonte Preta,0
985,985,5990,2017,25,24/9/2017,Coritiba,Botafogo-RJ,2,3,0,0,2,3,0,5,5,20,19,39,CoritibaBotafogo-RJ,0
986,986,5991,2017,25,24/9/2017,Atletico-GO,Cruzeiro,4,2,0,0,4,2,0,6,6,16,18,34,Atletico-GOCruzeiro,0
987,987,5992,2017,25,24/9/2017,Fluminense,Palmeiras,2,2,0,0,2,2,0,4,4,26,9,35,FluminensePalmeiras,0
988,988,5993,2017,25,24/9/2017,Atletico-MG,Vitoria,1,2,0,0,1,2,0,3,3,10,21,31,Atletico-MGVitoria,0
989,989,5994,2017,25,24/9/2017,Bahia,Gremio,4,5,0,0,4,5,0,9,9,18,17,35,BahiaGremio,0
990,990,5995,2017,25,25/9/2017,Sport,Vasco,1,4,1,0,2,4,1,5,6,13,16,29,SportVasco,0
991,991,5996,2017,26,30/9/2017,Vasco,Chapecoense,3,0,0,0,3,0,0,3,3,15,22,37,VascoChapecoense,0
992,992,5997,2017,26,30/9/2017,Bahia,Coritiba,4,5,0,0,4,5,0,9,9,13,18,31,BahiaCoritiba,0
993,993,5998,2017,26,30/9/2017,Palmeiras,Santos,3,5,0,0,3,5,0,8,8,18,22,40,PalmeirasSantos,1
994,994,5999,2017,26,1/10/2017,Cruzeiro,Corinthians,3,4,0,0,3,4,0,7,7,15,14,29,CruzeiroCorinthians,0
995,995,6000,2017,26,1/10/2017,Botafogo-RJ,Vitoria,2,2,1,0,3,2,1,4,5,11,21,32,Botafogo-RJVitoria,0
996,996,6001,2017,26,1/10/2017,Sao Paulo,Sport,0,2,0,0,0,2,0,2,2,12,15,27,Sao PauloSport,0
997,997,6002,2017,26,1/10/2017,Gremio,Fluminense,1,2,0,0,1,2,0,3,3,12,18,30,GremioFluminense,0
998,998,6003,2017,26,1/10/2017,Avai,Atletico-GO,2,2,0,0,2,2,0,4,4,14,24,38,AvaiAtletico-GO,0
999,999,6004,2017,26,1/10/2017,Athletico-PR,Atletico-MG,1,4,0,0,1,4,0,5,5,17,16,33,Athletico-PRAtletico-MG,0
1000,1000,6005,2017,26,2/10/2017,Ponte Preta,Flamengo,5,3,1,0,6,3,1,8,9,23,17,40,Ponte PretaFlamengo,0
1001,1001,6006,2017,28,7/10/2017,Cruzeiro,Ponte Preta,5,1,0,1,5,2,1,6,7,8,12,20,CruzeiroPonte Preta,0
1002,1002,6007,2017,28,14/10/2017,Vasco,Botafogo-RJ,5,3,0,0,5,3,0,8,8,16,13,29,VascoBotafogo-RJ,1
1003,1003,6008,2017,28,14/10/2017,Sao Paulo,Athletico-PR,1,2,0,1,1,3,1,3,4,6,12,18,Sao PauloAthletico-PR,0
1004,1004,6009,2017,28,15/10/2017,Chapecoense,Flamengo,2,2,0,0,2,2,0,4,4,23,17,40,ChapecoenseFlamengo,0
1005,1005,6010,2017,28,15/10/2017,Atletico-GO,Palmeiras,2,1,1,0,3,1,1,3,4,18,13,31,Atletico-GOPalmeiras,0
1006,1006,6011,2017,28,15/10/2017,Fluminense,Avai,2,2,0,0,2,2,0,4,4,18,12,30,FluminenseAvai,0
1007,1007,6012,2017,28,15/10/2017,Sport,Atletico-MG,2,2,0,0,2,2,0,4,4,19,14,33,SportAtletico-MG,0
1008,1008,6013,2017,28,15/10/2017,Coritiba,Gremio,4,3,0,0,4,3,0,7,7,14,16,30,CoritibaGremio,0
1009,1009,6014,2017,28,15/10/2017,Bahia,Corinthians,0,2,0,0,0,2,0,2,2,11,16,27,BahiaCorinthians,0
1010,1010,6015,2017,28,16/10/2017,Santos,Vitoria,2,4,0,0,2,4,0,6,6,12,15,27,SantosVitoria,0
1011,1011,6016,2017,27,11/10/2017,Athletico-PR,Atletico-GO,3,2,0,0,3,2,0,5,5,15,17,32,Athletico-PRAtletico-GO,0
1012,1012,6017,2017,27,11/10/2017,Botafogo-RJ,Chapecoense,1,3,0,0,1,3,0,4,4,12,20,32,Botafogo-RJChapecoense,0
1013,1013,6018,2017,27,11/10/2017,Corinthians,Coritiba,1,3,0,0,1,3,0,4,4,8,16,24,CorinthiansCoritiba,0
3005,3005,6019,2017,27,11/10/2017,Gremio,Cruzeiro,0,0,0,0,0,0,0,0,0,15,13,28,GremioCruzeiro,0
1014,1014,6020,2017,27,11/10/2017,Avai,Vasco,5,3,1,1,6,4,2,8,10,23,28,51,AvaiVasco,0
1015,1015,6021,2017,27,11/10/2017,Atletico-MG,Sao Paulo,1,3,0,0,1,3,0,4,4,16,12,28,Atletico-MGSao Paulo,0
1016,1016,6022,2017,27,12/10/2017,Vitoria,Sport,2,3,1,0,3,3,1,5,6,18,13,31,VitoriaSport,0
1017,1017,6023,2017,27,12/10/2017,Flamengo,Fluminense,2,4,0,0,2,4,0,6,6,17,16,33,FlamengoFluminense,0
1018,1018,6024,2017,27,12/10/2017,Ponte Preta,Santos,3,2,1,0,4,2,1,5,6,20,11,31,Ponte PretaSantos,1
1019,1019,6025,2017,27,12/10/2017,Palmeiras,Bahia,1,2,0,0,1,2,0,3,3,23,24,47,PalmeirasBahia,0
1020,1020,6026,2017,29,18/10/2017,Atletico-GO,Vasco,2,2,1,0,3,2,1,4,5,23,10,33,Atletico-GOVasco,0
1021,1021,6027,2017,29,18/10/2017,Coritiba,Cruzeiro,1,1,0,0,1,1,0,2,2,7,9,16,CoritibaCruzeiro,0
1022,1022,6028,2017,29,18/10/2017,Atletico-MG,Chapecoense,2,3,1,0,3,3,1,5,6,16,15,31,Atletico-MGChapecoense,0
1023,1023,6029,2017,29,18/10/2017,Avai,Botafogo-RJ,2,4,0,0,2,4,0,6,6,20,22,42,AvaiBotafogo-RJ,0
1024,1024,6030,2017,29,18/10/2017,Fluminense,Sao Paulo,2,0,0,0,2,0,0,2,2,23,12,35,FluminenseSao Paulo,0
1025,1025,6031,2017,29,18/10/2017,Corinthians,Gremio,1,1,0,0,1,1,0,2,2,13,14,27,CorinthiansGremio,0
1026,1026,6032,2017,29,19/10/2017,Vitoria,Athletico-PR,0,3,0,0,0,3,0,3,3,11,12,23,VitoriaAthletico-PR,0
1027,1027,6033,2017,29,19/10/2017,Palmeiras,Ponte Preta,0,4,0,0,0,4,0,4,4,14,18,32,PalmeirasPonte Preta,1
1028,1028,6034,2017,29,19/10/2017,Flamengo,Bahia,5,4,0,0,5,4,0,9,9,23,11,34,FlamengoBahia,0
1029,1029,6035,2017,29,19/10/2017,Sport,Santos,1,5,0,0,1,5,0,6,6,17,23,40,SportSantos,0
1030,1030,6036,2017,30,21/10/2017,Vasco,Coritiba,1,2,1,0,2,2,1,3,4,10,15,25,VascoCoritiba,0
1031,1031,6037,2017,30,22/10/2017,Santos,Atletico-GO,1,1,0,0,1,1,0,2,2,15,14,29,SantosAtletico-GO,0
1032,1032,6038,2017,30,22/10/2017,Bahia,Vitoria,2,3,0,0,2,3,0,5,5,12,17,29,BahiaVitoria,1
1033,1033,6039,2017,30,22/10/2017,Gremio,Palmeiras,2,1,0,0,2,1,0,3,3,17,19,36,GremioPalmeiras,0
1034,1034,6040,2017,30,22/10/2017,Sao Paulo,Flamengo,1,1,0,0,1,1,0,2,2,14,12,26,Sao PauloFlamengo,0
1035,1035,6041,2017,30,22/10/2017,Athletico-PR,Sport,0,2,0,0,0,2,0,2,2,15,13,28,Athletico-PRSport,0
1036,1036,6042,2017,30,22/10/2017,Cruzeiro,Atletico-MG,2,4,0,0,2,4,0,6,6,23,14,37,CruzeiroAtletico-MG,1
1037,1037,6043,2017,30,22/10/2017,Chapecoense,Fluminense,1,1,0,0,1,1,0,2,2,22,12,34,ChapecoenseFluminense,0
1038,1038,6044,2017,30,22/10/2017,Ponte Preta,Avai,5,2,0,0,5,2,0,7,7,19,19,38,Ponte PretaAvai,0
1039,1039,6045,2017,30,23/10/2017,Botafogo-RJ,Corinthians,3,2,0,0,3,2,0,5,5,19,14,33,Botafogo-RJCorinthians,0
1040,1040,6046,2017,31,28/10/2017,Sao Paulo,Santos,1,6,0,0,1,6,0,7,7,12,31,43,Sao PauloSantos,1
1041,1041,6047,2017,31,28/10/2017,Flamengo,Vasco,1,1,0,0,1,1,0,2,2,16,12,28,FlamengoVasco,1
1042,1042,6048,2017,31,28/10/2017,Athletico-PR,Chapecoense,1,4,0,0,1,4,0,5,5,6,20,26,Athletico-PRChapecoense,0
1043,1043,6049,2017,31,29/10/2017,Ponte Preta,Corinthians,4,1,0,0,4,1,0,5,5,19,12,31,Ponte PretaCorinthians,1
1044,1044,6050,2017,31,29/10/2017,Fluminense,Bahia,1,3,0,1,1,4,1,4,5,19,17,36,FluminenseBahia,0
1045,1045,6051,2017,31,29/10/2017,Atletico-MG,Botafogo-RJ,1,2,0,0,1,2,0,3,3,21,16,37,Atletico-MGBotafogo-RJ,0
1046,1046,6052,2017,31,29/10/2017,Vitoria,Atletico-GO,1,3,0,0,1,3,0,4,4,19,18,37,VitoriaAtletico-GO,0
1047,1047,6053,2017,31,29/10/2017,Sport,Coritiba,3,6,0,0,3,6,0,9,9,21,21,42,SportCoritiba,0
1048,1048,6054,2017,31,29/10/2017,Avai,Gremio,1,2,0,0,1,2,0,3,3,13,19,32,AvaiGremio,0
1049,1049,6055,2017,31,30/10/2017,Palmeiras,Cruzeiro,0,2,0,0,0,2,0,2,2,9,9,18,PalmeirasCruzeiro,0
1050,1050,6056,2017,32,4/11/2017,Santos,Atletico-MG,1,3,0,0,1,3,0,4,4,12,18,30,SantosAtletico-MG,0
1051,1051,6057,2017,32,4/11/2017,Botafogo-RJ,Fluminense,3,4,0,0,3,4,0,7,7,16,16,32,Botafogo-RJFluminense,1
1052,1052,6058,2017,32,4/11/2017,Atletico-GO,Sao Paulo,2,0,0,0,2,0,0,2,2,17,9,26,Atletico-GOSao Paulo,0
1053,1053,6059,2017,32,4/11/2017,Coritiba,Avai,1,2,0,0,1,2,0,3,3,15,6,21,CoritibaAvai,0
1054,1054,6060,2017,32,5/11/2017,Corinthians,Palmeiras,6,5,0,1,6,6,1,11,12,21,11,32,CorinthiansPalmeiras,1
1055,1055,6061,2017,32,5/11/2017,Cruzeiro,Athletico-PR,1,2,0,0,1,2,0,3,3,9,13,22,CruzeiroAthletico-PR,0
3006,3006,6062,2017,32,5/11/2017,Gremio,Flamengo,0,0,0,0,0,0,0,0,0,12,14,26,GremioFlamengo,0
1056,1056,6063,2017,32,5/11/2017,Bahia,Ponte Preta,1,2,0,0,1,2,0,3,3,16,18,34,BahiaPonte Preta,0
1057,1057,6064,2017,32,5/11/2017,Vasco,Vitoria,3,4,0,0,3,4,0,7,7,17,23,40,VascoVitoria,0
1058,1058,6065,2017,32,5/11/2017,Chapecoense,Sport,3,3,0,1,3,4,1,6,7,21,16,37,ChapecoenseSport,0
1059,1059,6066,2017,33,8/11/2017,Ponte Preta,Gremio,4,3,1,0,5,3,1,7,8,19,14,33,Ponte PretaGremio,0
1060,1060,6067,2017,33,8/11/2017,Avai,Bahia,2,2,0,0,2,2,0,4,4,18,25,43,AvaiBahia,0
1061,1061,6068,2017,33,8/11/2017,Sport,Botafogo-RJ,2,4,0,0,2,4,0,6,6,13,20,33,SportBotafogo-RJ,0
1062,1062,6069,2017,33,8/11/2017,Athletico-PR,Corinthians,2,1,0,0,2,1,0,3,3,11,11,22,Athletico-PRCorinthians,0
1063,1063,6070,2017,33,8/11/2017,Santos,Vasco,2,5,0,0,2,5,0,7,7,14,14,28,SantosVasco,0
1064,1064,6071,2017,33,8/11/2017,Flamengo,Cruzeiro,2,3,0,0,2,3,0,5,5,17,10,27,FlamengoCruzeiro,0
1065,1065,6072,2017,33,8/11/2017,Vitoria,Palmeiras,4,1,1,0,5,1,1,5,6,20,10,30,VitoriaPalmeiras,0
1066,1066,6073,2017,33,9/11/2017,Sao Paulo,Chapecoense,1,2,0,0,1,2,0,3,3,8,14,22,Sao PauloChapecoense,0
1067,1067,6074,2017,33,9/11/2017,Atletico-MG,Atletico-GO,6,5,0,0,6,5,0,11,11,19,13,32,Atletico-MGAtletico-GO,0
1068,1068,6075,2017,33,9/11/2017,Fluminense,Coritiba,3,4,0,0,3,4,0,7,7,11,20,31,FluminenseCoritiba,0
1069,1069,6076,2017,34,11/11/2017,Botafogo-RJ,Athletico-PR,0,1,0,0,0,1,0,1,1,13,14,27,Botafogo-RJAthletico-PR,0
1070,1070,6077,2017,34,11/11/2017,Corinthians,Avai,3,3,0,0,3,3,0,6,6,15,12,27,CorinthiansAvai,0
1071,1071,6078,2017,34,12/11/2017,Vasco,Sao Paulo,2,2,0,1,2,3,1,4,5,15,15,30,VascoSao Paulo,0
1072,1072,6079,2017,34,12/11/2017,Palmeiras,Flamengo,0,1,0,0,0,1,0,1,1,12,18,30,PalmeirasFlamengo,0
1073,1073,6080,2017,34,12/11/2017,Atletico-GO,Sport,0,3,0,0,0,3,0,3,3,20,15,35,Atletico-GOSport,0
1074,1074,6081,2017,34,12/11/2017,Gremio,Vitoria,0,2,0,1,0,3,1,2,3,14,16,30,GremioVitoria,0
1075,1075,6082,2017,34,12/11/2017,Bahia,Atletico-MG,1,4,0,0,1,4,0,5,5,12,13,25,BahiaAtletico-MG,0
1076,1076,6083,2017,34,12/11/2017,Cruzeiro,Fluminense,4,3,0,1,4,4,1,7,8,13,8,21,CruzeiroFluminense,0
1077,1077,6084,2017,34,12/11/2017,Coritiba,Ponte Preta,2,2,0,0,2,2,0,4,4,17,15,32,CoritibaPonte Preta,0
1078,1078,6085,2017,34,13/11/2017,Chapecoense,Santos,0,3,0,0,0,3,0,3,3,10,16,26,ChapecoenseSantos,0
1079,1079,6086,2017,35,15/11/2017,Ponte Preta,Athletico-PR,1,3,0,0,1,3,0,4,4,12,10,22,Ponte PretaAthletico-PR,0
1080,1080,6087,2017,35,15/11/2017,Cruzeiro,Avai,4,2,0,0,4,2,0,6,6,10,9,19,CruzeiroAvai,0
1081,1081,6088,2017,35,15/11/2017,Gremio,Sao Paulo,1,3,0,0,1,3,0,4,4,16,12,28,GremioSao Paulo,0
1082,1082,6089,2017,35,15/11/2017,Vasco,Atletico-MG,1,0,0,0,1,0,0,1,1,12,17,29,VascoAtletico-MG,0
1083,1083,6090,2017,35,15/11/2017,Corinthians,Fluminense,1,6,0,0,1,6,0,7,7,12,26,38,CorinthiansFluminense,0
1084,1084,6091,2017,35,16/11/2017,Botafogo-RJ,Atletico-GO,1,3,0,0,1,3,0,4,4,12,17,29,Botafogo-RJAtletico-GO,0
1085,1085,6092,2017,35,16/11/2017,Chapecoense,Vitoria,1,4,0,0,1,4,0,5,5,17,18,35,ChapecoenseVitoria,0
1086,1086,6093,2017,35,16/11/2017,Palmeiras,Sport,0,2,0,0,0,2,0,2,2,7,15,22,PalmeirasSport,0
1087,1087,6094,2017,35,16/11/2017,Coritiba,Flamengo,3,5,0,0,3,5,0,8,8,20,12,32,CoritibaFlamengo,0
1088,1088,6095,2017,35,16/11/2017,Bahia,Santos,3,2,0,0,3,2,0,5,5,17,16,33,BahiaSantos,0
1089,1089,6096,2017,36,19/11/2017,Sport,Bahia,4,3,0,0,4,3,0,7,7,21,16,37,SportBahia,0
1090,1090,6097,2017,36,19/11/2017,Flamengo,Corinthians,4,4,0,0,4,4,0,8,8,20,16,36,FlamengoCorinthians,0
1091,1091,6098,2017,36,19/11/2017,Vitoria,Cruzeiro,3,2,0,0,3,2,0,5,5,20,7,27,VitoriaCruzeiro,0
1092,1092,6099,2017,36,19/11/2017,Atletico-GO,Chapecoense,4,4,0,0,4,4,0,8,8,12,23,35,Atletico-GOChapecoense,0
1093,1093,6100,2017,36,19/11/2017,Sao Paulo,Botafogo-RJ,2,3,0,0,2,3,0,5,5,13,17,30,Sao PauloBotafogo-RJ,0
1094,1094,6101,2017,36,19/11/2017,Athletico-PR,Vasco,1,2,0,0,1,2,0,3,3,8,8,16,Athletico-PRVasco,0
1095,1095,6102,2017,36,19/11/2017,Atletico-MG,Coritiba,2,5,0,0,2,5,0,7,7,10,15,25,Atletico-MGCoritiba,0
1096,1096,6103,2017,36,19/11/2017,Santos,Gremio,2,2,0,0,2,2,0,4,4,22,14,36,SantosGremio,0
1097,1097,6104,2017,36,20/11/2017,Fluminense,Ponte Preta,2,2,0,1,2,3,1,4,5,16,15,31,FluminensePonte Preta,0
1098,1098,6105,2017,36,20/11/2017,Avai,Palmeiras,2,2,0,0,2,2,0,4,4,9,10,19,AvaiPalmeiras,0
1099,1099,6106,2017,37,25/11/2017,Fluminense,Sport,4,2,0,0,4,2,0,6,6,9,19,28,FluminenseSport,0
1100,1100,6107,2017,37,26/11/2017,Avai,Athletico-PR,3,1,0,0,3,1,0,4,4,19,15,34,AvaiAthletico-PR,0
1101,1101,6108,2017,37,26/11/2017,Corinthians,Atletico-MG,4,1,0,0,4,1,0,5,5,15,10,25,CorinthiansAtletico-MG,0
1102,1102,6109,2017,37,26/11/2017,Ponte Preta,Vitoria,3,6,1,0,4,6,1,9,10,11,19,30,Ponte PretaVitoria,0
1103,1103,6110,2017,37,26/11/2017,Coritiba,Sao Paulo,4,1,0,0,4,1,0,5,5,16,12,28,CoritibaSao Paulo,0
1104,1104,6111,2017,37,26/11/2017,Cruzeiro,Vasco,3,2,0,0,3,2,0,5,5,16,20,36,CruzeiroVasco,0
1105,1105,6112,2017,37,26/11/2017,Gremio,Atletico-GO,2,3,0,0,2,3,0,5,5,14,16,30,GremioAtletico-GO,0
1106,1106,6113,2017,37,26/11/2017,Flamengo,Santos,3,4,0,0,3,4,0,7,7,14,17,31,FlamengoSantos,0
1107,1107,6114,2017,37,26/11/2017,Bahia,Chapecoense,5,3,1,0,6,3,1,8,9,16,21,37,BahiaChapecoense,0
1108,1108,6115,2017,37,27/11/2017,Palmeiras,Botafogo-RJ,3,4,0,0,3,4,0,7,7,19,17,36,PalmeirasBotafogo-RJ,0
1109,1109,6116,2017,38,3/12/2017,Atletico-MG,Gremio,7,1,1,0,8,1,1,8,9,17,20,37,Atletico-MGGremio,0
1110,1110,6117,2017,38,3/12/2017,Botafogo-RJ,Cruzeiro,1,5,0,1,1,6,1,6,7,13,28,41,Botafogo-RJCruzeiro,0
1111,1111,6118,2017,38,3/12/2017,Santos,Avai,2,1,0,0,2,1,0,3,3,17,11,28,SantosAvai,0
1112,1112,6119,2017,38,3/12/2017,Sport,Corinthians,3,2,0,0,3,2,0,5,5,19,18,37,SportCorinthians,0
1113,1113,6120,2017,38,3/12/2017,Vitoria,Flamengo,3,3,2,0,5,3,2,6,8,17,13,30,VitoriaFlamengo,0
1114,1114,6121,2017,38,3/12/2017,Atletico-GO,Fluminense,1,4,0,0,1,4,0,5,5,16,18,34,Atletico-GOFluminense,0
1115,1115,6122,2017,38,3/12/2017,Sao Paulo,Bahia,4,4,1,1,5,5,2,8,10,20,29,49,Sao PauloBahia,0
1116,1116,6123,2017,38,3/12/2017,Chapecoense,Coritiba,3,2,0,0,3,2,0,5,5,18,11,29,ChapecoenseCoritiba,0
1117,1117,6124,2017,38,3/12/2017,Vasco,Ponte Preta,5,5,0,0,5,5,0,10,10,18,16,34,VascoPonte Preta,0
1118,1118,6125,2017,38,3/12/2017,Athletico-PR,Palmeiras,3,5,0,0,3,5,0,8,8,16,14,30,Athletico-PRPalmeiras,0
1119,1119,6126,2018,1,14/4/2018,Cruzeiro,Gremio,3,1,0,1,3,2,1,4,5,20,15,35,CruzeiroGremio,0
1120,1120,6127,2018,1,14/4/2018,Vitoria,Flamengo,3,2,0,1,3,3,1,5,6,24,10,34,VitoriaFlamengo,0
1121,1121,6128,2018,1,14/4/2018,Santos,Ceara,0,1,0,0,0,1,0,1,1,7,5,12,SantosCeara,0
1122,1122,6129,2018,1,15/4/2018,America-MG,Sport,1,3,0,0,1,3,0,4,4,11,12,23,America-MGSport,0
1123,1123,6130,2018,1,15/4/2018,Vasco,Atletico-MG,4,3,0,0,4,3,0,7,7,11,18,29,VascoAtletico-MG,0
1124,1124,6131,2018,1,15/4/2018,Internacional,Bahia,2,0,0,0,2,0,0,2,2,16,18,34,InternacionalBahia,0
3007,3007,6132,2018,1,15/4/2018,Corinthians,Fluminense,0,0,0,0,0,0,0,0,0,14,15,29,CorinthiansFluminense,0
1125,1125,6133,2018,1,15/4/2018,Athletico-PR,Chapecoense,1,3,0,0,1,3,0,4,4,10,16,26,Athletico-PRChapecoense,0
1126,1126,6134,2018,1,16/4/2018,Sao Paulo,Parana,4,2,0,0,4,2,0,6,6,20,15,35,Sao PauloParana,0
1127,1127,6135,2018,1,16/4/2018,Botafogo-RJ,Palmeiras,1,4,0,0,1,4,0,5,5,7,23,30,Botafogo-RJPalmeiras,0
1128,1128,6136,2018,2,21/4/2018,Bahia,Santos,4,3,0,0,4,3,0,7,7,29,21,50,BahiaSantos,0
1129,1129,6137,2018,2,21/4/2018,Flamengo,America-MG,1,1,0,0,1,1,0,2,2,15,17,32,FlamengoAmerica-MG,0
1130,1130,6138,2018,2,22/4/2018,Parana,Corinthians,1,1,0,0,1,1,0,2,2,16,16,32,ParanaCorinthians,0
1131,1131,6139,2018,2,22/4/2018,Ceara,Sao Paulo,1,1,0,0,1,1,0,2,2,12,7,19,CearaSao Paulo,0
1132,1132,6140,2018,2,22/4/2018,Atletico-MG,Vitoria,2,4,0,0,2,4,0,6,6,22,19,41,Atletico-MGVitoria,0
1133,1133,6141,2018,2,22/4/2018,Fluminense,Cruzeiro,3,2,1,0,4,2,1,5,6,13,19,32,FluminenseCruzeiro,0
1134,1134,6142,2018,2,22/4/2018,Chapecoense,Vasco,1,2,0,0,1,2,0,3,3,13,8,21,ChapecoenseVasco,0
1135,1135,6143,2018,2,22/4/2018,Palmeiras,Internacional,2,2,0,0,2,2,0,4,4,14,15,29,PalmeirasInternacional,0
1136,1136,6144,2018,2,22/4/2018,Gremio,Athletico-PR,3,3,0,1,3,4,1,6,7,9,15,24,GremioAthletico-PR,0
1137,1137,6145,2018,2,23/4/2018,Sport,Botafogo-RJ,1,3,0,0,1,3,0,4,4,14,15,29,SportBotafogo-RJ,0
1138,1138,6146,2018,3,28/4/2018,Botafogo-RJ,Gremio,1,1,0,0,1,1,0,2,2,14,12,26,Botafogo-RJGremio,0
1139,1139,6147,2018,3,29/4/2018,Bahia,Athletico-PR,2,2,0,0,2,2,0,4,4,22,12,34,BahiaAthletico-PR,0
1140,1140,6148,2018,3,29/4/2018,Ceara,Flamengo,1,2,0,0,1,2,0,3,3,18,12,30,CearaFlamengo,0
1141,1141,6149,2018,3,29/4/2018,Palmeiras,Chapecoense,4,6,0,0,4,6,0,10,10,17,17,34,PalmeirasChapecoense,0
1142,1142,6150,2018,3,29/4/2018,Parana,Sport,1,1,0,0,1,1,0,2,2,14,15,29,ParanaSport,0
1143,1143,6151,2018,3,29/4/2018,Atletico-MG,Corinthians,4,3,0,0,4,3,0,7,7,25,15,40,Atletico-MGCorinthians,0
1144,1144,6152,2018,3,29/4/2018,Fluminense,Sao Paulo,3,2,0,0,3,2,0,5,5,17,16,33,FluminenseSao Paulo,0
1145,1145,6153,2018,3,29/4/2018,Internacional,Cruzeiro,4,3,0,0,4,3,0,7,7,15,14,29,InternacionalCruzeiro,0
1146,1146,6154,2018,3,30/4/2018,America-MG,Vitoria,2,2,1,0,3,2,1,4,5,14,12,26,America-MGVitoria,0
1147,1147,6155,2018,3,27/9/2018,Santos,Vasco,1,3,0,1,1,4,1,4,5,11,17,28,SantosVasco,0
1148,1148,6156,2018,4,5/5/2018,Vasco,America-MG,4,4,0,0,4,4,0,8,8,14,24,38,VascoAmerica-MG,0
1149,1149,6157,2018,4,5/5/2018,Sao Paulo,Atletico-MG,4,4,0,0,4,4,0,8,8,17,14,31,Sao PauloAtletico-MG,0
1150,1150,6158,2018,4,6/5/2018,Corinthians,Ceara,2,4,0,0,2,4,0,6,6,12,20,32,CorinthiansCeara,0
1151,1151,6159,2018,4,6/5/2018,Flamengo,Internacional,5,4,0,1,5,5,1,9,10,12,15,27,FlamengoInternacional,0
1152,1152,6160,2018,4,6/5/2018,Cruzeiro,Botafogo-RJ,1,4,0,0,1,4,0,5,5,19,12,31,CruzeiroBotafogo-RJ,0
1153,1153,6161,2018,4,6/5/2018,Athletico-PR,Palmeiras,1,2,0,0,1,2,0,3,3,10,15,25,Athletico-PRPalmeiras,0
1154,1154,6162,2018,4,6/5/2018,Vitoria,Fluminense,2,1,0,0,2,1,0,3,3,18,7,25,VitoriaFluminense,0
1155,1155,6163,2018,4,6/5/2018,Gremio,Santos,1,3,0,0,1,3,0,4,4,15,22,37,GremioSantos,0
1156,1156,6164,2018,4,6/5/2018,Sport,Bahia,1,2,0,1,1,3,1,3,4,18,21,39,SportBahia,0
1157,1157,6165,2018,4,7/5/2018,Chapecoense,Parana,1,2,0,1,1,3,1,3,4,10,16,26,ChapecoenseParana,0
1158,1158,6166,2018,5,12/5/2018,Gremio,Internacional,3,4,0,0,3,4,0,7,7,13,24,37,GremioInternacional,1
1159,1159,6167,2018,5,13/5/2018,Cruzeiro,Sport,2,3,0,0,2,3,0,5,5,18,16,34,CruzeiroSport,0
1160,1160,6168,2018,5,13/5/2018,Athletico-PR,Atletico-MG,2,2,0,0,2,2,0,4,4,15,16,31,Athletico-PRAtletico-MG,0
1161,1161,6169,2018,5,13/5/2018,Vasco,Vitoria,2,3,0,0,2,3,0,5,5,16,19,35,VascoVitoria,0
1162,1162,6170,2018,5,13/5/2018,Corinthians,Palmeiras,2,3,0,0,2,3,0,5,5,15,21,36,CorinthiansPalmeiras,1
1163,1163,6171,2018,5,13/5/2018,Bahia,Sao Paulo,5,3,0,0,5,3,0,8,8,20,14,34,BahiaSao Paulo,0
1164,1164,6172,2018,5,13/5/2018,Chapecoense,Flamengo,2,3,0,0,2,3,0,5,5,18,17,35,ChapecoenseFlamengo,0
1165,1165,6173,2018,5,13/5/2018,Santos,Parana,1,2,0,0,1,2,0,3,3,12,14,26,SantosParana,0
1166,1166,6174,2018,5,14/5/2018,Botafogo-RJ,Fluminense,2,2,0,0,2,2,0,4,4,12,12,24,Botafogo-RJFluminense,1
1167,1167,6175,2018,5,14/5/2018,Ceara,America-MG,1,3,0,0,1,3,0,4,4,16,18,34,CearaAmerica-MG,0
1168,1168,6176,2018,6,19/5/2018,Atletico-MG,Cruzeiro,3,2,0,1,3,3,1,5,6,13,15,28,Atletico-MGCruzeiro,1
1169,1169,6177,2018,6,19/5/2018,Flamengo,Vasco,2,3,2,2,4,5,4,5,9,16,24,40,FlamengoVasco,1
1170,1170,6178,2018,6,19/5/2018,Palmeiras,Bahia,3,2,0,0,3,2,0,5,5,17,13,30,PalmeirasBahia,0
1171,1171,6179,2018,6,20/5/2018,Vitoria,Ceara,4,0,0,0,4,0,0,4,4,11,17,28,VitoriaCeara,0
1172,1172,6180,2018,6,20/5/2018,Sao Paulo,Santos,4,2,1,0,5,2,1,6,7,13,6,19,Sao PauloSantos,1
1173,1173,6181,2018,6,20/5/2018,America-MG,Botafogo-RJ,2,4,0,0,2,4,0,6,6,20,11,31,America-MGBotafogo-RJ,0
1174,1174,6182,2018,6,20/5/2018,Parana,Gremio,2,1,0,0,2,1,0,3,3,16,18,34,ParanaGremio,0
1175,1175,6183,2018,6,20/5/2018,Sport,Corinthians,2,3,0,0,2,3,0,5,5,18,17,35,SportCorinthians,0
1176,1176,6184,2018,6,20/5/2018,Fluminense,Athletico-PR,1,2,0,0,1,2,0,3,3,13,18,31,FluminenseAthletico-PR,0
1177,1177,6185,2018,6,21/5/2018,Internacional,Chapecoense,1,2,0,0,1,2,0,3,3,14,15,29,InternacionalChapecoense,0
1178,1178,6186,2018,7,26/5/2018,Fluminense,Chapecoense,1,1,0,0,1,1,0,2,2,21,14,35,FluminenseChapecoense,0
1179,1179,6187,2018,7,26/5/2018,Palmeiras,Sport,3,3,0,1,3,4,1,6,7,17,10,27,PalmeirasSport,0
1180,1180,6188,2018,7,26/5/2018,Atletico-MG,Flamengo,1,4,0,0,1,4,0,5,5,15,13,28,Atletico-MGFlamengo,0
1181,1181,6189,2018,7,27/5/2018,Parana,Athletico-PR,3,1,0,0,3,1,0,4,4,8,14,22,ParanaAthletico-PR,1
1182,1182,6190,2018,7,27/5/2018,Internacional,Corinthians,3,1,0,0,3,1,0,4,4,13,10,23,InternacionalCorinthians,0
1183,1183,6191,2018,7,27/5/2018,Bahia,Vasco,1,6,0,1,1,7,1,7,8,20,16,36,BahiaVasco,0
1184,1184,6192,2018,7,27/5/2018,Santos,Cruzeiro,1,4,0,0,1,4,0,5,5,12,12,24,SantosCruzeiro,0
1185,1185,6193,2018,7,27/5/2018,Botafogo-RJ,Vitoria,1,4,0,0,1,4,0,5,5,10,18,28,Botafogo-RJVitoria,0
1186,1186,6194,2018,7,27/5/2018,Ceara,Gremio,4,2,0,0,4,2,0,6,6,15,13,28,CearaGremio,0
1187,1187,6195,2018,7,27/5/2018,America-MG,Sao Paulo,4,3,0,0,4,3,0,7,7,22,19,41,America-MGSao Paulo,0
1188,1188,6196,2018,8,30/5/2018,Vasco,Parana,3,3,1,1,4,4,2,6,8,24,18,42,VascoParana,0
1189,1189,6197,2018,8,30/5/2018,Vitoria,Internacional,3,2,0,0,3,2,0,5,5,14,12,26,VitoriaInternacional,0
1190,1190,6198,2018,8,30/5/2018,Sport,Atletico-MG,4,2,0,0,4,2,0,6,6,14,10,24,SportAtletico-MG,0
1191,1191,6199,2018,8,30/5/2018,Chapecoense,Ceara,2,3,0,0,2,3,0,5,5,17,13,30,ChapecoenseCeara,0
1192,1192,6200,2018,8,30/5/2018,Sao Paulo,Botafogo-RJ,2,3,0,0,2,3,0,5,5,19,16,35,Sao PauloBotafogo-RJ,0
1193,1193,6201,2018,8,30/5/2018,Gremio,Fluminense,1,5,0,0,1,5,0,6,6,19,13,32,GremioFluminense,0
1194,1194,6202,2018,8,30/5/2018,Cruzeiro,Palmeiras,3,6,0,0,3,6,0,9,9,26,18,44,CruzeiroPalmeiras,0
1195,1195,6203,2018,8,31/5/2018,Flamengo,Bahia,0,2,0,0,0,2,0,2,2,10,7,17,FlamengoBahia,0
1196,1196,6204,2018,8,31/5/2018,Corinthians,America-MG,2,3,0,2,2,5,2,5,7,14,13,27,CorinthiansAmerica-MG,0
1197,1197,6205,2018,8,31/5/2018,Athletico-PR,Santos,1,1,0,0,1,1,0,2,2,14,6,20,Athletico-PRSantos,0
1198,1198,6206,2018,9,2/6/2018,Internacional,Sport,3,3,0,0,3,3,0,6,6,14,14,28,InternacionalSport,0
1199,1199,6207,2018,9,2/6/2018,Atletico-MG,Chapecoense,2,4,0,1,2,5,1,6,7,15,19,34,Atletico-MGChapecoense,0
1200,1200,6208,2018,9,2/6/2018,Vasco,Botafogo-RJ,2,4,0,0,2,4,0,6,6,12,16,28,VascoBotafogo-RJ,1
1201,1201,6209,2018,9,2/6/2018,Palmeiras,Sao Paulo,4,4,0,0,4,4,0,8,8,22,23,45,PalmeirasSao Paulo,1
1202,1202,6210,2018,9,3/6/2018,Flamengo,Corinthians,3,1,0,0,3,1,0,4,4,14,18,32,FlamengoCorinthians,0
1203,1203,6211,2018,9,3/6/2018,Bahia,Gremio,2,5,0,0,2,5,0,7,7,18,16,34,BahiaGremio,0
1204,1204,6212,2018,9,3/6/2018,America-MG,Athletico-PR,1,2,0,0,1,2,0,3,3,9,15,24,America-MGAthletico-PR,0
1205,1205,6213,2018,9,3/6/2018,Santos,Vitoria,0,4,0,0,0,4,0,4,4,12,16,28,SantosVitoria,0
1206,1206,6214,2018,9,3/6/2018,Ceara,Cruzeiro,2,4,0,0,2,4,0,6,6,13,15,28,CearaCruzeiro,0
1207,1207,6215,2018,9,4/6/2018,Parana,Fluminense,6,3,0,0,6,3,0,9,9,14,16,30,ParanaFluminense,0
1208,1208,6216,2018,10,5/6/2018,Sao Paulo,Internacional,4,2,0,0,4,2,0,6,6,30,8,38,Sao PauloInternacional,0
1209,1209,6217,2018,10,6/6/2018,Vitoria,Chapecoense,3,2,0,0,3,2,0,5,5,20,15,35,VitoriaChapecoense,0
1210,1210,6218,2018,10,6/6/2018,Botafogo-RJ,Ceara,0,3,0,0,0,3,0,3,3,17,17,34,Botafogo-RJCeara,0
1211,1211,6219,2018,10,6/6/2018,Corinthians,Santos,3,2,0,0,3,2,0,5,5,12,15,27,CorinthiansSantos,1
1212,1212,6220,2018,10,6/6/2018,Sport,Athletico-PR,2,4,0,0,2,4,0,6,6,13,20,33,SportAthletico-PR,0
1213,1213,6221,2018,10,6/6/2018,Gremio,Palmeiras,2,5,0,0,2,5,0,7,7,13,30,43,GremioPalmeiras,0
1214,1214,6222,2018,10,6/6/2018,Cruzeiro,Vasco,1,1,0,0,1,1,0,2,2,8,14,22,CruzeiroVasco,0
1215,1215,6223,2018,10,7/6/2018,Parana,Bahia,4,2,0,0,4,2,0,6,6,17,18,35,ParanaBahia,0
1216,1216,6224,2018,10,7/6/2018,Fluminense,Flamengo,5,2,0,0,5,2,0,7,7,16,7,23,FluminenseFlamengo,1
1217,1217,6225,2018,10,7/6/2018,America-MG,Atletico-MG,2,2,0,0,2,2,0,4,4,13,7,20,America-MGAtletico-MG,1
1218,1218,6226,2018,11,9/6/2018,Athletico-PR,Sao Paulo,3,3,0,0,3,3,0,6,6,15,18,33,Athletico-PRSao Paulo,0
1219,1219,6227,2018,11,9/6/2018,Chapecoense,Cruzeiro,2,3,0,0,2,3,0,5,5,22,17,39,ChapecoenseCruzeiro,0
1220,1220,6228,2018,11,9/6/2018,Vasco,Sport,4,3,0,0,4,3,0,7,7,27,10,37,VascoSport,0
1221,1221,6229,2018,11,9/6/2018,Corinthians,Vitoria,2,2,0,0,2,2,0,4,4,14,19,33,CorinthiansVitoria,0
1222,1222,6230,2018,11,10/6/2018,Atletico-MG,Fluminense,2,2,0,0,2,2,0,4,4,15,9,24,Atletico-MGFluminense,0
1223,1223,6231,2018,11,10/6/2018,Bahia,Botafogo-RJ,4,3,0,1,4,4,1,7,8,24,9,33,BahiaBotafogo-RJ,0
1224,1224,6232,2018,11,10/6/2018,Gremio,America-MG,2,3,0,0,2,3,0,5,5,14,13,27,GremioAmerica-MG,0
1225,1225,6233,2018,11,10/6/2018,Ceara,Palmeiras,3,2,0,0,3,2,0,5,5,15,12,27,CearaPalmeiras,0
1226,1226,6234,2018,11,10/6/2018,Flamengo,Parana,2,0,0,0,2,0,0,2,2,11,8,19,FlamengoParana,0
1227,1227,6235,2018,11,10/6/2018,Santos,Internacional,3,4,1,0,4,4,1,7,8,10,20,30,SantosInternacional,0
1228,1228,6236,2018,12,12/6/2018,Sao Paulo,Vitoria,4,3,1,1,5,4,2,7,9,24,17,41,Sao PauloVitoria,0
1229,1229,6237,2018,12,13/6/2018,America-MG,Chapecoense,5,0,0,0,5,0,0,5,5,13,15,28,America-MGChapecoense,0
1230,1230,6238,2018,12,13/6/2018,Fluminense,Santos,2,3,0,0,2,3,0,5,5,16,12,28,FluminenseSantos,0
1231,1231,6239,2018,12,13/6/2018,Sport,Gremio,3,2,0,0,3,2,0,5,5,14,16,30,SportGremio,0
1232,1232,6240,2018,12,13/6/2018,Parana,Cruzeiro,8,2,0,0,8,2,0,10,10,23,23,46,ParanaCruzeiro,0
1233,1233,6241,2018,12,13/6/2018,Palmeiras,Flamengo,4,6,3,3,7,9,6,10,16,21,18,39,PalmeirasFlamengo,0
1234,1234,6242,2018,12,13/6/2018,Botafogo-RJ,Athletico-PR,0,2,0,0,0,2,0,2,2,11,9,20,Botafogo-RJAthletico-PR,0
1235,1235,6243,2018,12,13/6/2018,Bahia,Corinthians,2,1,0,0,2,1,0,3,3,19,11,30,BahiaCorinthians,0
1236,1236,6244,2018,12,13/6/2018,Internacional,Vasco,2,0,0,0,2,0,0,2,2,13,11,24,InternacionalVasco,0
1237,1237,6245,2018,12,13/6/2018,Atletico-MG,Ceara,1,0,0,0,1,0,0,1,1,10,10,20,Atletico-MGCeara,0
3008,3008,6246,2018,13,18/7/2018,Ceara,Sport,0,0,0,0,0,0,0,0,0,15,12,27,CearaSport,0
1238,1238,6247,2018,13,18/7/2018,Vitoria,Parana,2,2,0,0,2,2,0,4,4,24,22,46,VitoriaParana,0
1239,1239,6248,2018,13,18/7/2018,Corinthians,Botafogo-RJ,2,3,0,0,2,3,0,5,5,19,13,32,CorinthiansBotafogo-RJ,0
1240,1240,6249,2018,13,18/7/2018,Gremio,Atletico-MG,1,2,0,0,1,2,0,3,3,10,19,29,GremioAtletico-MG,0
1241,1241,6250,2018,13,18/7/2018,Flamengo,Sao Paulo,3,4,0,1,3,5,1,7,8,11,17,28,FlamengoSao Paulo,0
1242,1242,6251,2018,13,19/7/2018,Chapecoense,Bahia,1,2,0,0,1,2,0,3,3,12,19,31,ChapecoenseBahia,0
1243,1243,6252,2018,13,19/7/2018,Cruzeiro,America-MG,3,1,0,0,3,1,0,4,4,11,8,19,CruzeiroAmerica-MG,1
1244,1244,6253,2018,13,19/7/2018,Vasco,Fluminense,4,2,0,0,4,2,0,6,6,21,21,42,VascoFluminense,1
1245,1245,6254,2018,13,19/7/2018,Santos,Palmeiras,4,6,0,0,4,6,0,10,10,15,16,31,SantosPalmeiras,1
1246,1246,6255,2018,13,19/7/2018,Athletico-PR,Internacional,4,5,1,0,5,5,1,9,10,11,16,27,Athletico-PRInternacional,0
1247,1247,6256,2018,14,21/7/2018,Flamengo,Botafogo-RJ,0,1,0,1,0,2,1,1,2,17,15,32,FlamengoBotafogo-RJ,1
1248,1248,6257,2018,14,21/7/2018,Sao Paulo,Corinthians,2,7,0,0,2,7,0,9,9,9,21,30,Sao PauloCorinthians,1
1249,1249,6258,2018,14,22/7/2018,Vasco,Gremio,5,6,1,0,6,6,1,11,12,12,17,29,VascoGremio,0
1250,1250,6259,2018,14,22/7/2018,Palmeiras,Atletico-MG,2,2,0,1,2,3,1,4,5,20,18,38,PalmeirasAtletico-MG,0
1251,1251,6260,2018,14,22/7/2018,Parana,America-MG,3,3,0,0,3,3,0,6,6,23,10,33,ParanaAmerica-MG,0
1252,1252,6261,2018,14,22/7/2018,Bahia,Vitoria,3,5,0,1,3,6,1,8,9,18,26,44,BahiaVitoria,1
1253,1253,6262,2018,14,22/7/2018,Sport,Fluminense,1,5,0,0,1,5,0,6,6,14,17,31,SportFluminense,0
1254,1254,6263,2018,14,22/7/2018,Cruzeiro,Athletico-PR,1,3,0,1,1,4,1,4,5,7,14,21,CruzeiroAthletico-PR,0
1255,1255,6264,2018,14,22/7/2018,Chapecoense,Santos,1,4,0,0,1,4,0,5,5,10,13,23,ChapecoenseSantos,0
1256,1256,6265,2018,14,23/7/2018,Internacional,Ceara,2,3,0,0,2,3,0,5,5,12,13,25,InternacionalCeara,0
1257,1257,6266,2018,15,25/7/2018,Fluminense,Palmeiras,2,2,0,1,2,3,1,4,5,18,16,34,FluminensePalmeiras,0
1258,1258,6267,2018,15,25/7/2018,Atletico-MG,Parana,1,1,1,0,2,1,1,2,3,16,15,31,Atletico-MGParana,0
1259,1259,6268,2018,15,25/7/2018,Corinthians,Cruzeiro,0,2,0,0,0,2,0,2,2,9,10,19,CorinthiansCruzeiro,0
1260,1260,6269,2018,15,25/7/2018,Santos,Flamengo,1,1,0,0,1,1,0,2,2,17,14,31,SantosFlamengo,0
1261,1261,6270,2018,15,26/7/2018,Botafogo-RJ,Chapecoense,2,3,0,0,2,3,0,5,5,20,16,36,Botafogo-RJChapecoense,0
1262,1262,6271,2018,15,26/7/2018,Vitoria,Sport,2,2,0,0,2,2,0,4,4,17,14,31,VitoriaSport,0
1263,1263,6272,2018,15,26/7/2018,Gremio,Sao Paulo,4,5,0,0,4,5,0,9,9,23,19,42,GremioSao Paulo,0
1264,1264,6273,2018,15,26/7/2018,America-MG,Internacional,2,2,1,1,3,3,2,4,6,12,9,21,America-MGInternacional,0
1265,1265,6274,2018,15,29/8/2018,Ceara,Bahia,3,4,0,0,3,4,0,7,7,16,25,41,CearaBahia,0
1266,1266,6275,2018,15,29/8/2018,Athletico-PR,Vasco,1,2,0,0,1,2,0,3,3,15,14,29,Athletico-PRVasco,0
1267,1267,6276,2018,16,28/7/2018,Ceara,Fluminense,5,1,0,0,5,1,0,6,6,22,13,35,CearaFluminense,0
1268,1268,6277,2018,16,29/7/2018,Palmeiras,Parana,2,2,0,0,2,2,0,4,4,20,17,37,PalmeirasParana,0
1269,1269,6278,2018,16,29/7/2018,Vasco,Corinthians,4,0,0,0,4,0,0,4,4,17,11,28,VascoCorinthians,0
1270,1270,6279,2018,16,29/7/2018,Flamengo,Sport,1,1,0,0,1,1,0,2,2,12,11,23,FlamengoSport,0
1271,1271,6280,2018,16,29/7/2018,Athletico-PR,Vitoria,3,5,0,0,3,5,0,8,8,20,17,37,Athletico-PRVitoria,0
1272,1272,6281,2018,16,29/7/2018,Internacional,Botafogo-RJ,1,2,0,0,1,2,0,3,3,13,14,27,InternacionalBotafogo-RJ,0
1273,1273,6282,2018,16,29/7/2018,Cruzeiro,Sao Paulo,2,1,0,0,2,1,0,3,3,11,11,22,CruzeiroSao Paulo,0
1274,1274,6283,2018,16,29/7/2018,Santos,America-MG,2,2,0,0,2,2,0,4,4,8,13,21,SantosAmerica-MG,0
1275,1275,6284,2018,16,29/7/2018,Chapecoense,Gremio,1,3,0,0,1,3,0,4,4,12,15,27,ChapecoenseGremio,0
1276,1276,6285,2018,16,30/7/2018,Bahia,Atletico-MG,4,2,0,0,4,2,0,6,6,15,18,33,BahiaAtletico-MG,0
1277,1277,6286,2018,17,4/8/2018,Botafogo-RJ,Santos,1,5,0,0,1,5,0,6,6,12,19,31,Botafogo-RJSantos,0
1278,1278,6287,2018,17,4/8/2018,Gremio,Flamengo,3,4,0,0,3,4,0,7,7,21,17,38,GremioFlamengo,0
1279,1279,6288,2018,17,4/8/2018,Corinthians,Athletico-PR,2,2,0,0,2,2,0,4,4,8,13,21,CorinthiansAthletico-PR,0
1280,1280,6289,2018,17,5/8/2018,Vitoria,Cruzeiro,3,5,0,0,3,5,0,8,8,19,20,39,VitoriaCruzeiro,0
1281,1281,6290,2018,17,5/8/2018,Parana,Ceara,4,2,0,0,4,2,0,6,6,15,21,36,ParanaCeara,0
1282,1282,6291,2018,17,5/8/2018,America-MG,Palmeiras,1,2,0,0,1,2,0,3,3,16,18,34,America-MGPalmeiras,0
1283,1283,6292,2018,17,5/8/2018,Sao Paulo,Vasco,2,2,0,0,2,2,0,4,4,27,9,36,Sao PauloVasco,0
1284,1284,6293,2018,17,5/8/2018,Fluminense,Bahia,4,2,0,0,4,2,0,6,6,12,18,30,FluminenseBahia,0
1285,1285,6294,2018,17,5/8/2018,Sport,Chapecoense,1,1,0,0,1,1,0,2,2,14,20,34,SportChapecoense,0
1286,1286,6295,2018,17,6/8/2018,Atletico-MG,Internacional,1,1,0,0,1,1,0,2,2,13,13,26,Atletico-MGInternacional,0
1287,1287,6296,2018,20,8/8/2018,Ceara,Santos,3,2,0,0,3,2,0,5,5,11,13,24,CearaSantos,0
1288,1288,6297,2018,20,22/8/2018,Bahia,Internacional,1,2,0,0,1,2,0,3,3,15,18,33,BahiaInternacional,0
1289,1289,6298,2018,20,22/8/2018,Parana,Sao Paulo,3,1,0,0,3,1,0,4,4,14,12,26,ParanaSao Paulo,0
1290,1290,6299,2018,20,22/8/2018,Palmeiras,Botafogo-RJ,2,5,0,1,2,6,1,7,8,14,17,31,PalmeirasBotafogo-RJ,0
1291,1291,6300,2018,20,22/8/2018,Sport,America-MG,2,2,0,0,2,2,0,4,4,9,21,30,SportAmerica-MG,0
1292,1292,6301,2018,20,22/8/2018,Fluminense,Corinthians,1,2,0,1,1,3,1,3,4,12,8,20,FluminenseCorinthians,0
1293,1293,6302,2018,20,22/8/2018,Gremio,Cruzeiro,2,4,0,0,2,4,0,6,6,13,16,29,GremioCruzeiro,0
1294,1294,6303,2018,20,23/8/2018,Flamengo,Vitoria,2,2,0,0,2,2,0,4,4,18,19,37,FlamengoVitoria,0
1295,1295,6304,2018,20,23/8/2018,Atletico-MG,Vasco,2,4,0,0,2,4,0,6,6,16,15,31,Atletico-MGVasco,0
1296,1296,6305,2018,20,13/9/2018,Chapecoense,Athletico-PR,1,3,0,0,1,3,0,4,4,19,18,37,ChapecoenseAthletico-PR,0
1297,1297,6306,2018,18,11/8/2018,Ceara,Athletico-PR,3,3,0,0,3,3,0,6,6,15,14,29,CearaAthletico-PR,0
1298,1298,6307,2018,18,11/8/2018,Bahia,America-MG,1,4,0,0,1,4,0,5,5,11,13,24,BahiaAmerica-MG,0
1299,1299,6308,2018,18,12/8/2018,Parana,Botafogo-RJ,3,4,1,1,4,5,2,7,9,11,9,20,ParanaBotafogo-RJ,0
1300,1300,6309,2018,18,12/8/2018,Atletico-MG,Santos,2,0,0,0,2,0,0,2,2,17,8,25,Atletico-MGSantos,0
1301,1301,6310,2018,18,12/8/2018,Sport,Sao Paulo,1,3,0,0,1,3,0,4,4,7,15,22,SportSao Paulo,0
1302,1302,6311,2018,18,12/8/2018,Flamengo,Cruzeiro,3,3,0,0,3,3,0,6,6,28,17,45,FlamengoCruzeiro,0
1303,1303,6312,2018,18,12/8/2018,Chapecoense,Corinthians,1,2,1,0,2,2,1,3,4,18,20,38,ChapecoenseCorinthians,0
1304,1304,6313,2018,18,12/8/2018,Gremio,Vitoria,1,3,0,0,1,3,0,4,4,20,17,37,GremioVitoria,0
1305,1305,6314,2018,18,12/8/2018,Palmeiras,Vasco,1,2,0,0,1,2,0,3,3,17,16,33,PalmeirasVasco,0
1306,1306,6315,2018,18,13/8/2018,Fluminense,Internacional,3,3,0,0,3,3,0,6,6,8,17,25,FluminenseInternacional,0
1307,1307,6316,2018,19,18/8/2018,Santos,Sport,3,3,0,1,3,4,1,6,7,20,21,41,SantosSport,0
1308,1308,6317,2018,19,18/8/2018,Corinthians,Gremio,1,1,0,0,1,1,0,2,2,8,8,16,CorinthiansGremio,0
1309,1309,6318,2018,19,19/8/2018,Athletico-PR,Flamengo,3,1,0,0,3,1,0,4,4,15,10,25,Athletico-PRFlamengo,0
1310,1310,6319,2018,19,19/8/2018,Internacional,Parana,3,5,0,0,3,5,0,8,8,16,16,32,InternacionalParana,0
1311,1311,6320,2018,19,19/8/2018,Vitoria,Palmeiras,2,1,0,0,2,1,0,3,3,25,18,43,VitoriaPalmeiras,0
1312,1312,6321,2018,19,19/8/2018,Botafogo-RJ,Atletico-MG,2,4,0,0,2,4,0,6,6,13,12,25,Botafogo-RJAtletico-MG,0
1313,1313,6322,2018,19,19/8/2018,Cruzeiro,Bahia,2,2,0,0,2,2,0,4,4,14,13,27,CruzeiroBahia,0
1314,1314,6323,2018,19,19/8/2018,America-MG,Fluminense,2,0,1,0,3,0,1,2,3,13,8,21,America-MGFluminense,0
1315,1315,6324,2018,19,19/8/2018,Sao Paulo,Chapecoense,2,1,0,0,2,1,0,3,3,17,20,37,Sao PauloChapecoense,0
1316,1316,6325,2018,19,20/8/2018,Vasco,Ceara,1,1,0,1,1,2,1,2,3,16,21,37,VascoCeara,0
1317,1317,6326,2018,21,25/8/2018,Santos,Bahia,1,2,0,0,1,2,0,3,3,25,17,42,SantosBahia,0
1318,1318,6327,2018,21,25/8/2018,Corinthians,Parana,3,4,0,1,3,5,1,7,8,18,20,38,CorinthiansParana,0
1319,1319,6328,2018,21,25/8/2018,Athletico-PR,Gremio,2,2,0,0,2,2,0,4,4,18,17,35,Athletico-PRGremio,0
1320,1320,6329,2018,21,25/8/2018,Cruzeiro,Fluminense,4,3,0,0,4,3,0,7,7,17,14,31,CruzeiroFluminense,0
1321,1321,6330,2018,21,25/8/2018,Botafogo-RJ,Sport,2,2,0,0,2,2,0,4,4,21,13,34,Botafogo-RJSport,0
1322,1322,6331,2018,21,26/8/2018,Sao Paulo,Ceara,3,6,0,1,3,7,1,9,10,13,21,34,Sao PauloCeara,0
1323,1323,6332,2018,21,26/8/2018,America-MG,Flamengo,3,2,0,1,3,3,1,5,6,12,9,21,America-MGFlamengo,0
1324,1324,6333,2018,21,26/8/2018,Internacional,Palmeiras,2,3,0,0,2,3,0,5,5,14,24,38,InternacionalPalmeiras,0
1325,1325,6334,2018,21,26/8/2018,Vitoria,Atletico-MG,2,3,0,0,2,3,0,5,5,17,12,29,VitoriaAtletico-MG,0
1326,1326,6335,2018,21,26/8/2018,Vasco,Chapecoense,3,2,0,0,3,2,0,5,5,18,20,38,VascoChapecoense,0
1327,1327,6336,2018,22,1/9/2018,Vitoria,America-MG,5,1,0,1,5,2,1,6,7,21,10,31,VitoriaAmerica-MG,0
1328,1328,6337,2018,22,1/9/2018,Gremio,Botafogo-RJ,2,3,0,0,2,3,0,5,5,12,19,31,GremioBotafogo-RJ,0
1329,1329,6338,2018,22,1/9/2018,Vasco,Santos,1,1,0,0,1,1,0,2,2,12,11,23,VascoSantos,0
1330,1330,6339,2018,22,1/9/2018,Corinthians,Atletico-MG,1,3,0,0,1,3,0,4,4,16,21,37,CorinthiansAtletico-MG,0
1331,1331,6340,2018,22,2/9/2018,Flamengo,Ceara,2,2,0,0,2,2,0,4,4,16,14,30,FlamengoCeara,0
1332,1332,6341,2018,22,2/9/2018,Athletico-PR,Bahia,2,2,0,0,2,2,0,4,4,14,9,23,Athletico-PRBahia,0
1333,1333,6342,2018,22,2/9/2018,Sport,Parana,3,2,0,0,3,2,0,5,5,19,12,31,SportParana,0
1334,1334,6343,2018,22,2/9/2018,Sao Paulo,Fluminense,2,2,1,0,3,2,1,4,5,14,16,30,Sao PauloFluminense,0
1335,1335,6344,2018,22,2/9/2018,Cruzeiro,Internacional,3,2,0,0,3,2,0,5,5,16,14,30,CruzeiroInternacional,0
1336,1336,6345,2018,22,2/9/2018,Chapecoense,Palmeiras,4,4,0,0,4,4,0,8,8,14,23,37,ChapecoensePalmeiras,0
1337,1337,6346,2018,23,5/9/2018,Bahia,Sport,1,1,0,0,1,1,0,2,2,19,19,38,BahiaSport,0
1338,1338,6347,2018,23,5/9/2018,Botafogo-RJ,Cruzeiro,3,3,0,0,3,3,0,6,6,13,17,30,Botafogo-RJCruzeiro,0
1339,1339,6348,2018,23,5/9/2018,Ceara,Corinthians,6,2,0,0,6,2,0,8,8,19,19,38,CearaCorinthians,0
1340,1340,6349,2018,23,5/9/2018,Palmeiras,Athletico-PR,2,3,0,0,2,3,0,5,5,16,18,34,PalmeirasAthletico-PR,0
1341,1341,6350,2018,23,5/9/2018,Parana,Chapecoense,2,2,0,0,2,2,0,4,4,24,19,43,ParanaChapecoense,0
1342,1342,6351,2018,23,5/9/2018,Atletico-MG,Sao Paulo,3,1,0,0,3,1,0,4,4,17,18,35,Atletico-MGSao Paulo,0
1343,1343,6352,2018,23,5/9/2018,Internacional,Flamengo,4,1,0,0,4,1,0,5,5,13,13,26,InternacionalFlamengo,0
1344,1344,6353,2018,23,6/9/2018,Santos,Gremio,2,1,0,0,2,1,0,3,3,14,8,22,SantosGremio,0
1345,1345,6354,2018,23,6/9/2018,Fluminense,Vitoria,1,1,0,0,1,1,0,2,2,11,8,19,FluminenseVitoria,0
1346,1346,6355,2018,23,6/9/2018,America-MG,Vasco,1,1,0,0,1,1,0,2,2,19,12,31,America-MGVasco,0
1347,1347,6356,2018,24,8/9/2018,Sport,Cruzeiro,3,1,0,0,3,1,0,4,4,22,19,41,SportCruzeiro,0
1348,1348,6357,2018,24,8/9/2018,Sao Paulo,Bahia,3,2,0,0,3,2,0,5,5,16,19,35,Sao PauloBahia,0
1349,1349,6358,2018,24,8/9/2018,Flamengo,Chapecoense,2,2,0,0,2,2,0,4,4,17,13,30,FlamengoChapecoense,0
1350,1350,6359,2018,24,9/9/2018,America-MG,Ceara,1,1,0,0,1,1,0,2,2,16,10,26,America-MGCeara,0
1351,1351,6360,2018,24,9/9/2018,Palmeiras,Corinthians,2,3,0,0,2,3,0,5,5,14,16,30,PalmeirasCorinthians,1
1352,1352,6361,2018,24,9/9/2018,Fluminense,Botafogo-RJ,3,4,0,0,3,4,0,7,7,21,14,35,FluminenseBotafogo-RJ,1
1353,1353,6362,2018,24,9/9/2018,Internacional,Gremio,5,5,0,0,5,5,0,10,10,17,15,32,InternacionalGremio,1
1354,1354,6363,2018,24,9/9/2018,Parana,Santos,4,3,0,0,4,3,0,7,7,15,18,33,ParanaSantos,0
1355,1355,6364,2018,24,9/9/2018,Vitoria,Vasco,4,1,1,1,5,2,2,5,7,19,19,38,VitoriaVasco,0
1356,1356,6365,2018,24,10/9/2018,Atletico-MG,Athletico-PR,4,5,0,1,4,6,1,9,10,13,14,27,Atletico-MGAthletico-PR,0
1357,1357,6366,2018,25,15/9/2018,Ceara,Vitoria,2,4,0,0,2,4,0,6,6,23,21,44,CearaVitoria,0
1358,1358,6367,2018,25,15/9/2018,Gremio,Parana,1,1,0,0,1,1,0,2,2,11,13,24,GremioParana,0
1359,1359,6368,2018,25,15/9/2018,Vasco,Flamengo,3,2,0,1,3,3,1,5,6,19,13,32,VascoFlamengo,1
1360,1360,6369,2018,25,16/9/2018,Botafogo-RJ,America-MG,1,1,1,1,2,2,2,2,4,13,18,31,Botafogo-RJAmerica-MG,0
1361,1361,6370,2018,25,16/9/2018,Cruzeiro,Atletico-MG,3,1,0,0,3,1,0,4,4,19,16,35,CruzeiroAtletico-MG,1
1362,1362,6371,2018,25,16/9/2018,Bahia,Palmeiras,1,2,0,0,1,2,0,3,3,14,11,25,BahiaPalmeiras,0
1363,1363,6372,2018,25,16/9/2018,Athletico-PR,Fluminense,3,2,0,0,3,2,0,5,5,15,14,29,Athletico-PRFluminense,0
1364,1364,6373,2018,25,16/9/2018,Santos,Sao Paulo,7,4,0,0,7,4,0,11,11,15,15,30,SantosSao Paulo,1
1365,1365,6374,2018,25,16/9/2018,Corinthians,Sport,2,1,0,0,2,1,0,3,3,16,19,35,CorinthiansSport,0
1366,1366,6375,2018,25,17/9/2018,Chapecoense,Internacional,4,3,0,1,4,4,1,7,8,14,15,29,ChapecoenseInternacional,0
1367,1367,6376,2018,26,22/9/2018,Sao Paulo,America-MG,1,1,0,0,1,1,0,2,2,14,12,26,Sao PauloAmerica-MG,0
1368,1368,6377,2018,26,23/9/2018,Gremio,Ceara,3,1,0,0,3,1,0,4,4,12,9,21,GremioCeara,0
1369,1369,6378,2018,26,23/9/2018,Athletico-PR,Parana,0,4,0,0,0,4,0,4,4,15,11,26,Athletico-PRParana,1
1370,1370,6379,2018,26,23/9/2018,Flamengo,Atletico-MG,2,2,0,0,2,2,0,4,4,26,15,41,FlamengoAtletico-MG,0
1371,1371,6380,2018,26,23/9/2018,Corinthians,Internacional,0,2,0,0,0,2,0,2,2,13,11,24,CorinthiansInternacional,0
1372,1372,6381,2018,26,23/9/2018,Sport,Palmeiras,2,2,0,0,2,2,0,4,4,16,16,32,SportPalmeiras,0
1373,1373,6382,2018,26,23/9/2018,Vitoria,Botafogo-RJ,1,4,0,0,1,4,0,5,5,15,17,32,VitoriaBotafogo-RJ,0
1374,1374,6383,2018,26,23/9/2018,Cruzeiro,Santos,2,2,0,0,2,2,0,4,4,17,12,29,CruzeiroSantos,0
1375,1375,6384,2018,26,24/9/2018,Chapecoense,Fluminense,3,3,1,0,4,3,1,6,7,19,19,38,ChapecoenseFluminense,0
1376,1376,6385,2018,26,24/9/2018,Vasco,Bahia,5,2,0,1,5,3,1,7,8,12,15,27,VascoBahia,0
1377,1377,6386,2018,27,29/9/2018,Fluminense,Gremio,1,2,0,0,1,2,0,3,3,10,13,23,FluminenseGremio,0
1378,1378,6387,2018,27,29/9/2018,America-MG,Corinthians,0,1,0,0,0,1,0,1,1,8,4,12,America-MGCorinthians,0
1379,1379,6388,2018,27,29/9/2018,Bahia,Flamengo,2,1,0,0,2,1,0,3,3,16,17,33,BahiaFlamengo,0
1380,1380,6389,2018,27,30/9/2018,Palmeiras,Cruzeiro,5,6,0,0,5,6,0,11,11,15,19,34,PalmeirasCruzeiro,0
1381,1381,6390,2018,27,30/9/2018,Atletico-MG,Sport,1,4,0,1,1,5,1,5,6,18,16,34,Atletico-MGSport,0
1382,1382,6391,2018,27,30/9/2018,Santos,Athletico-PR,2,6,0,0,2,6,0,8,8,8,17,25,SantosAthletico-PR,0
1383,1383,6392,2018,27,30/9/2018,Botafogo-RJ,Sao Paulo,1,2,0,0,1,2,0,3,3,20,18,38,Botafogo-RJSao Paulo,0
1384,1384,6393,2018,27,30/9/2018,Internacional,Vitoria,3,6,0,1,3,7,1,9,10,19,18,37,InternacionalVitoria,0
1385,1385,6394,2018,27,30/9/2018,Ceara,Chapecoense,4,5,0,0,4,5,0,9,9,15,20,35,CearaChapecoense,0
1386,1386,6395,2018,27,1/10/2018,Parana,Vasco,1,0,0,1,1,1,1,1,2,15,11,26,ParanaVasco,0
1387,1387,6396,2018,28,5/10/2018,Sport,Internacional,4,1,0,0,4,1,0,5,5,10,10,20,SportInternacional,0
1388,1388,6397,2018,28,5/10/2018,Corinthians,Flamengo,2,1,0,0,2,1,0,3,3,9,18,27,CorinthiansFlamengo,0
1389,1389,6398,2018,28,5/10/2018,Vitoria,Santos,3,2,1,0,4,2,1,5,6,17,24,41,VitoriaSantos,0
1390,1390,6399,2018,28,6/10/2018,Athletico-PR,America-MG,3,3,0,0,3,3,0,6,6,10,13,23,Athletico-PRAmerica-MG,0
1391,1391,6400,2018,28,6/10/2018,Chapecoense,Atletico-MG,3,3,0,0,3,3,0,6,6,20,15,35,ChapecoenseAtletico-MG,0
1392,1392,6401,2018,28,6/10/2018,Sao Paulo,Palmeiras,2,3,0,0,2,3,0,5,5,21,17,38,Sao PauloPalmeiras,1
1393,1393,6402,2018,28,6/10/2018,Gremio,Bahia,2,4,0,1,2,5,1,6,7,13,25,38,GremioBahia,0
1394,1394,6403,2018,28,8/10/2018,Fluminense,Parana,1,2,0,0,1,2,0,3,3,8,18,26,FluminenseParana,0
1395,1395,6404,2018,28,9/10/2018,Botafogo-RJ,Vasco,3,2,0,0,3,2,0,5,5,13,13,26,Botafogo-RJVasco,1
1396,1396,6405,2018,28,24/10/2018,Cruzeiro,Ceara,1,3,0,0,1,3,0,4,4,7,18,25,CruzeiroCeara,0
1397,1397,6406,2018,29,13/10/2018,Flamengo,Fluminense,2,3,0,0,2,3,0,5,5,16,15,31,FlamengoFluminense,0
1398,1398,6407,2018,29,13/10/2018,Santos,Corinthians,3,3,0,0,3,3,0,6,6,19,19,38,SantosCorinthians,1
1399,1399,6408,2018,29,13/10/2018,Bahia,Parana,3,3,0,0,3,3,0,6,6,5,10,15,BahiaParana,0
1400,1400,6409,2018,29,14/10/2018,Chapecoense,Vitoria,3,2,0,0,3,2,0,5,5,14,20,34,ChapecoenseVitoria,0
1401,1401,6410,2018,29,14/10/2018,Vasco,Cruzeiro,6,2,0,1,6,3,1,8,9,14,17,31,VascoCruzeiro,0
1402,1402,6411,2018,29,14/10/2018,Internacional,Sao Paulo,0,4,0,1,0,5,1,4,5,16,23,39,InternacionalSao Paulo,0
1403,1403,6412,2018,29,14/10/2018,Palmeiras,Gremio,4,2,0,0,4,2,0,6,6,16,16,32,PalmeirasGremio,0
1404,1404,6413,2018,29,14/10/2018,Atletico-MG,America-MG,1,0,0,0,1,0,0,1,1,16,15,31,Atletico-MGAmerica-MG,1
1405,1405,6414,2018,29,14/10/2018,Athletico-PR,Sport,0,3,0,0,0,3,0,3,3,13,12,25,Athletico-PRSport,0
1406,1406,6415,2018,29,15/10/2018,Ceara,Botafogo-RJ,1,3,0,0,1,3,0,4,4,13,10,23,CearaBotafogo-RJ,0
3009,3009,6416,2018,30,20/10/2018,America-MG,Gremio,0,0,0,0,0,0,0,0,0,17,8,25,America-MGGremio,0
1407,1407,6417,2018,30,20/10/2018,Botafogo-RJ,Bahia,2,1,0,0,2,1,0,3,3,10,21,31,Botafogo-RJBahia,0
1408,1408,6418,2018,30,20/10/2018,Sao Paulo,Athletico-PR,3,2,0,0,3,2,0,5,5,20,15,35,Sao PauloAthletico-PR,0
1409,1409,6419,2018,30,20/10/2018,Sport,Vasco,0,3,0,0,0,3,0,3,3,16,18,34,SportVasco,0
1410,1410,6420,2018,30,21/10/2018,Vitoria,Corinthians,1,4,0,0,1,4,0,5,5,18,23,41,VitoriaCorinthians,0
1411,1411,6421,2018,30,21/10/2018,Fluminense,Atletico-MG,2,2,1,0,3,2,1,4,5,14,19,33,FluminenseAtletico-MG,0
1412,1412,6422,2018,30,21/10/2018,Palmeiras,Ceara,5,2,1,0,6,2,1,7,8,14,13,27,PalmeirasCeara,0
1413,1413,6423,2018,30,21/10/2018,Cruzeiro,Chapecoense,2,1,0,0,2,1,0,3,3,9,15,24,CruzeiroChapecoense,0
1414,1414,6424,2018,30,21/10/2018,Parana,Flamengo,1,0,1,0,2,0,1,1,2,17,13,30,ParanaFlamengo,0
1415,1415,6425,2018,30,22/10/2018,Internacional,Santos,1,3,0,0,1,3,0,4,4,14,15,29,InternacionalSantos,0
1416,1416,6426,2018,31,26/10/2018,Vitoria,Sao Paulo,1,2,0,1,1,3,1,3,4,8,24,32,VitoriaSao Paulo,0
1417,1417,6427,2018,31,26/10/2018,Vasco,Internacional,3,5,0,1,3,6,1,8,9,17,20,37,VascoInternacional,0
1418,1418,6428,2018,31,27/10/2018,Santos,Fluminense,2,3,0,0,2,3,0,5,5,15,17,32,SantosFluminense,0
1419,1419,6429,2018,31,27/10/2018,Gremio,Sport,2,2,0,0,2,2,0,4,4,10,16,26,GremioSport,0
1420,1420,6430,2018,31,27/10/2018,Corinthians,Bahia,3,3,0,0,3,3,0,6,6,11,15,26,CorinthiansBahia,0
1421,1421,6431,2018,31,27/10/2018,Chapecoense,America-MG,3,4,0,0,3,4,0,7,7,12,24,36,ChapecoenseAmerica-MG,0
1422,1422,6432,2018,31,27/10/2018,Flamengo,Palmeiras,2,5,0,0,2,5,0,7,7,19,17,36,FlamengoPalmeiras,0
1423,1423,6433,2018,31,27/10/2018,Cruzeiro,Parana,0,2,0,0,0,2,0,2,2,13,18,31,CruzeiroParana,0
1424,1424,6434,2018,31,27/10/2018,Athletico-PR,Botafogo-RJ,2,5,0,0,2,5,0,7,7,19,30,49,Athletico-PRBotafogo-RJ,0
1425,1425,6435,2018,31,29/10/2018,Ceara,Atletico-MG,2,4,0,0,2,4,0,6,6,13,21,34,CearaAtletico-MG,0
1426,1426,6436,2018,32,3/11/2018,Fluminense,Vasco,2,3,1,0,3,3,1,5,6,14,12,26,FluminenseVasco,1
1427,1427,6437,2018,32,3/11/2018,Atletico-MG,Gremio,4,1,0,0,4,1,0,5,5,12,12,24,Atletico-MGGremio,0
1428,1428,6438,2018,32,3/11/2018,Palmeiras,Santos,3,5,0,1,3,6,1,8,9,26,23,49,PalmeirasSantos,1
1429,1429,6439,2018,32,4/11/2018,America-MG,Cruzeiro,3,1,0,0,3,1,0,4,4,18,8,26,America-MGCruzeiro,1
1430,1430,6440,2018,32,4/11/2018,Parana,Vitoria,3,4,0,1,3,5,1,7,8,19,19,38,ParanaVitoria,0
1431,1431,6441,2018,32,4/11/2018,Sao Paulo,Flamengo,2,1,0,0,2,1,0,3,3,17,13,30,Sao PauloFlamengo,0
1432,1432,6442,2018,32,4/11/2018,Botafogo-RJ,Corinthians,1,2,0,0,1,2,0,3,3,25,19,44,Botafogo-RJCorinthians,0
1433,1433,6443,2018,32,4/11/2018,Internacional,Athletico-PR,2,3,0,0,2,3,0,5,5,9,20,29,InternacionalAthletico-PR,0
1434,1434,6444,2018,32,4/11/2018,Bahia,Chapecoense,1,1,0,0,1,1,0,2,2,15,22,37,BahiaChapecoense,0
1435,1435,6445,2018,32,5/11/2018,Sport,Ceara,3,3,0,0,3,3,0,6,6,13,16,29,SportCeara,0
1436,1436,6446,2018,33,10/11/2018,America-MG,Parana,3,1,1,1,4,2,2,4,6,10,10,20,America-MGParana,0
1437,1437,6447,2018,33,10/11/2018,Corinthians,Sao Paulo,1,3,1,0,2,3,1,4,5,10,18,28,CorinthiansSao Paulo,1
1438,1438,6448,2018,33,10/11/2018,Botafogo-RJ,Flamengo,4,6,0,0,4,6,0,10,10,30,16,46,Botafogo-RJFlamengo,1
1439,1439,6449,2018,33,10/11/2018,Athletico-PR,Cruzeiro,4,7,0,0,4,7,0,11,11,17,14,31,Athletico-PRCruzeiro,0
1440,1440,6450,2018,33,11/11/2018,Vitoria,Bahia,3,4,0,0,3,4,0,7,7,18,25,43,VitoriaBahia,1
1441,1441,6451,2018,33,11/11/2018,Ceara,Internacional,2,5,0,0,2,5,0,7,7,11,15,26,CearaInternacional,0
1442,1442,6452,2018,33,11/11/2018,Atletico-MG,Palmeiras,3,2,0,0,3,2,0,5,5,22,14,36,Atletico-MGPalmeiras,0
1443,1443,6453,2018,33,11/11/2018,Gremio,Vasco,2,4,0,0,2,4,0,6,6,12,17,29,GremioVasco,0
1444,1444,6454,2018,33,11/11/2018,Fluminense,Sport,0,2,0,0,0,2,0,2,2,18,16,34,FluminenseSport,0
1445,1445,6455,2018,33,12/11/2018,Santos,Chapecoense,2,1,0,0,2,1,0,3,3,15,24,39,SantosChapecoense,0
1446,1446,6456,2018,34,14/11/2018,Vasco,Athletico-PR,1,0,0,0,1,0,0,1,1,13,9,22,VascoAthletico-PR,0
1447,1447,6457,2018,34,14/11/2018,Bahia,Ceara,2,3,0,0,2,3,0,5,5,11,15,26,BahiaCeara,0
1448,1448,6458,2018,34,14/11/2018,Parana,Atletico-MG,4,3,2,0,6,3,2,7,9,19,14,33,ParanaAtletico-MG,0
1449,1449,6459,2018,34,14/11/2018,Sport,Vitoria,4,4,0,0,4,4,0,8,8,21,17,38,SportVitoria,0
1450,1450,6460,2018,34,14/11/2018,Palmeiras,Fluminense,6,5,0,1,6,6,1,11,12,20,24,44,PalmeirasFluminense,0
1451,1451,6461,2018,34,14/11/2018,Cruzeiro,Corinthians,2,2,0,1,2,3,1,4,5,13,6,19,CruzeiroCorinthians,0
1452,1452,6462,2018,34,15/11/2018,Chapecoense,Botafogo-RJ,1,2,0,0,1,2,0,3,3,12,14,26,ChapecoenseBotafogo-RJ,0
1453,1453,6463,2018,34,15/11/2018,Flamengo,Santos,3,5,0,0,3,5,0,8,8,22,18,40,FlamengoSantos,0
1454,1454,6464,2018,34,15/11/2018,Sao Paulo,Gremio,1,2,0,0,1,2,0,3,3,14,13,27,Sao PauloGremio,0
1455,1455,6465,2018,34,15/11/2018,Internacional,America-MG,1,2,0,0,1,2,0,3,3,19,20,39,InternacionalAmerica-MG,0
1456,1456,6466,2018,35,17/11/2018,Corinthians,Vasco,2,2,0,0,2,2,0,4,4,22,14,36,CorinthiansVasco,0
1457,1457,6467,2018,35,17/11/2018,Vitoria,Athletico-PR,3,3,1,0,4,3,1,6,7,15,23,38,VitoriaAthletico-PR,0
1458,1458,6468,2018,35,17/11/2018,Atletico-MG,Bahia,3,3,1,0,4,3,1,6,7,16,24,40,Atletico-MGBahia,0
1459,1459,6469,2018,35,18/11/2018,Parana,Palmeiras,4,2,0,0,4,2,0,6,6,22,8,30,ParanaPalmeiras,0
1460,1460,6470,2018,35,18/11/2018,America-MG,Santos,6,1,0,0,6,1,0,7,7,20,14,34,America-MGSantos,0
1461,1461,6471,2018,35,18/11/2018,Sport,Flamengo,1,1,0,1,1,2,1,2,3,9,13,22,SportFlamengo,0
1462,1462,6472,2018,35,18/11/2018,Botafogo-RJ,Internacional,2,4,0,2,2,6,2,6,8,13,18,31,Botafogo-RJInternacional,0
1463,1463,6473,2018,35,18/11/2018,Sao Paulo,Cruzeiro,2,2,0,0,2,2,0,4,4,14,17,31,Sao PauloCruzeiro,0
1464,1464,6474,2018,35,18/11/2018,Gremio,Chapecoense,2,2,0,0,2,2,0,4,4,12,21,33,GremioChapecoense,0
1465,1465,6475,2018,35,19/11/2018,Fluminense,Ceara,4,3,0,0,4,3,0,7,7,16,24,40,FluminenseCeara,0
1466,1466,6476,2018,36,21/11/2018,Internacional,Atletico-MG,1,2,0,0,1,2,0,3,3,10,17,27,InternacionalAtletico-MG,0
1467,1467,6477,2018,36,21/11/2018,Santos,Botafogo-RJ,2,2,0,0,2,2,0,4,4,19,16,35,SantosBotafogo-RJ,0
1468,1468,6478,2018,36,21/11/2018,Athletico-PR,Corinthians,2,4,0,0,2,4,0,6,6,18,14,32,Athletico-PRCorinthians,0
1469,1469,6479,2018,36,21/11/2018,Palmeiras,America-MG,0,6,0,0,0,6,0,6,6,13,20,33,PalmeirasAmerica-MG,0
1470,1470,6480,2018,36,21/11/2018,Flamengo,Gremio,2,3,0,0,2,3,0,5,5,17,14,31,FlamengoGremio,0
1471,1471,6481,2018,36,21/11/2018,Cruzeiro,Vitoria,2,1,0,0,2,1,0,3,3,18,15,33,CruzeiroVitoria,0
1472,1472,6482,2018,36,22/11/2018,Vasco,Sao Paulo,2,4,0,0,2,4,0,6,6,19,22,41,VascoSao Paulo,0
1473,1473,6483,2018,36,22/11/2018,Ceara,Parana,2,1,0,0,2,1,0,3,3,17,12,29,CearaParana,0
1474,1474,6484,2018,36,22/11/2018,Bahia,Fluminense,2,1,0,0,2,1,0,3,3,23,9,32,BahiaFluminense,0
1475,1475,6485,2018,36,22/11/2018,Chapecoense,Sport,2,1,0,0,2,1,0,3,3,22,13,35,ChapecoenseSport,0
1476,1476,6486,2018,37,24/11/2018,Santos,Atletico-MG,4,1,1,0,5,1,1,5,6,19,15,34,SantosAtletico-MG,0
1477,1477,6487,2018,37,25/11/2018,Athletico-PR,Ceara,3,4,0,0,3,4,0,7,7,19,18,37,Athletico-PRCeara,0
1478,1478,6488,2018,37,25/11/2018,Cruzeiro,Flamengo,6,3,0,0,6,3,0,9,9,10,9,19,CruzeiroFlamengo,0
1479,1479,6489,2018,37,25/11/2018,Vitoria,Gremio,2,4,0,0,2,4,0,6,6,15,20,35,VitoriaGremio,0
1480,1480,6490,2018,37,25/11/2018,Vasco,Palmeiras,4,5,1,0,5,5,1,9,10,17,18,35,VascoPalmeiras,0
1481,1481,6491,2018,37,25/11/2018,Internacional,Fluminense,3,2,0,1,3,3,1,5,6,12,17,29,InternacionalFluminense,0
1482,1482,6492,2018,37,25/11/2018,America-MG,Bahia,2,2,0,1,2,3,1,4,5,19,21,40,America-MGBahia,0
1483,1483,6493,2018,37,25/11/2018,Corinthians,Chapecoense,2,1,0,0,2,1,0,3,3,13,13,26,CorinthiansChapecoense,0
1484,1484,6494,2018,37,26/11/2018,Botafogo-RJ,Parana,1,3,0,0,1,3,0,4,4,13,16,29,Botafogo-RJParana,0
1485,1485,6495,2018,37,26/11/2018,Sao Paulo,Sport,2,3,0,1,2,4,1,5,6,14,21,35,Sao PauloSport,0
1486,1486,6496,2018,38,1/12/2018,Flamengo,Athletico-PR,4,1,1,1,5,2,2,5,7,17,17,34,FlamengoAthletico-PR,0
1487,1487,6497,2018,38,1/12/2018,Atletico-MG,Botafogo-RJ,4,3,0,0,4,3,0,7,7,15,17,32,Atletico-MGBotafogo-RJ,0
1488,1488,6498,2018,38,2/12/2018,Ceara,Vasco,3,2,1,0,4,2,1,5,6,17,11,28,CearaVasco,0
1489,1489,6499,2018,38,2/12/2018,Gremio,Corinthians,2,4,0,0,2,4,0,6,6,11,15,26,GremioCorinthians,0
1490,1490,6500,2018,38,2/12/2018,Bahia,Cruzeiro,4,1,0,0,4,1,0,5,5,18,15,33,BahiaCruzeiro,0
1491,1491,6501,2018,38,2/12/2018,Sport,Santos,3,1,0,0,3,1,0,4,4,21,21,42,SportSantos,0
1492,1492,6502,2018,38,2/12/2018,Parana,Internacional,1,2,1,0,2,2,1,3,4,14,15,29,ParanaInternacional,0
1493,1493,6503,2018,38,2/12/2018,Fluminense,America-MG,5,2,0,0,5,2,0,7,7,15,19,34,FluminenseAmerica-MG,0
1494,1494,6504,2018,38,2/12/2018,Chapecoense,Sao Paulo,0,3,0,0,0,3,0,3,3,11,23,34,ChapecoenseSao Paulo,0
1495,1495,6505,2018,38,2/12/2018,Palmeiras,Vitoria,2,2,0,0,2,2,0,4,4,11,6,17,PalmeirasVitoria,0
1496,1496,6506,2019,1,27/4/2019,Sao Paulo,Botafogo-RJ,0,4,0,0,0,4,0,4,4,23,7,30,Sao PauloBotafogo-RJ,0
1497,1497,6507,2019,1,27/4/2019,Atletico-MG,Avai,0,1,0,0,0,1,0,1,1,12,18,30,Atletico-MGAvai,0
1498,1498,6508,2019,1,27/4/2019,Chapecoense,Internacional,1,1,0,0,1,1,0,2,2,15,11,26,ChapecoenseInternacional,0
1499,1499,6509,2019,1,27/4/2019,Flamengo,Cruzeiro,4,5,0,1,4,6,1,9,10,13,17,30,FlamengoCruzeiro,0
1500,1500,6510,2019,1,28/4/2019,Gremio,Santos,3,4,0,1,3,5,1,7,8,12,18,30,GremioSantos,0
1501,1501,6511,2019,1,28/4/2019,Bahia,Corinthians,1,4,0,0,1,4,0,5,5,17,5,22,BahiaCorinthians,0
1502,1502,6512,2019,1,28/4/2019,Athletico-PR,Vasco,1,1,0,0,1,1,0,2,2,15,19,34,Athletico-PRVasco,0
1503,1503,6513,2019,1,28/4/2019,Ceara,CSA,0,0,0,1,0,1,1,0,1,15,4,19,CearaCSA,0
1504,1504,6514,2019,1,28/4/2019,Palmeiras,Fortaleza,1,2,0,0,1,2,0,3,3,12,16,28,PalmeirasFortaleza,0
1505,1505,6515,2019,1,28/4/2019,Fluminense,Goias,4,1,0,0,4,1,0,5,5,14,9,23,FluminenseGoias,0
1506,1506,6516,2019,2,1/5/2019,Internacional,Flamengo,3,2,0,0,3,2,0,5,5,8,9,17,InternacionalFlamengo,0
3010,3010,6517,2019,2,1/5/2019,CSA,Palmeiras,0,0,0,0,0,0,0,0,0,0,0,0,CSAPalmeiras,0
1507,1507,6518,2019,2,1/5/2019,Corinthians,Chapecoense,2,1,0,0,2,1,0,3,3,14,10,24,CorinthiansChapecoense,0
1508,1508,6519,2019,2,1/5/2019,Cruzeiro,Ceara,1,0,0,0,1,0,0,1,1,10,12,22,CruzeiroCeara,0
1509,1509,6520,2019,2,1/5/2019,Avai,Gremio,4,3,0,0,4,3,0,7,7,15,17,32,AvaiGremio,0
1510,1510,6521,2019,2,1/5/2019,Goias,Sao Paulo,3,2,0,1,3,3,1,5,6,15,12,27,GoiasSao Paulo,0
3011,3011,6522,2019,2,1/5/2019,Vasco,Atletico-MG,0,0,0,0,0,0,0,0,0,12,9,21,VascoAtletico-MG,0
1511,1511,6523,2019,2,1/5/2019,Fortaleza,Athletico-PR,3,3,0,0,3,3,0,6,6,12,19,31,FortalezaAthletico-PR,0
1512,1512,6524,2019,2,2/5/2019,Santos,Fluminense,3,2,0,0,3,2,0,5,5,25,14,39,SantosFluminense,0
1513,1513,6525,2019,2,2/5/2019,Botafogo-RJ,Bahia,3,0,0,0,3,0,0,3,3,11,15,26,Botafogo-RJBahia,0
1514,1514,6526,2019,3,4/5/2019,Vasco,Corinthians,2,1,0,0,2,1,0,3,3,21,8,29,VascoCorinthians,0
1515,1515,6527,2019,3,4/5/2019,Palmeiras,Internacional,2,5,0,0,2,5,0,7,7,15,18,33,PalmeirasInternacional,0
1516,1516,6528,2019,3,4/5/2019,Ceara,Atletico-MG,0,1,0,0,0,1,0,1,1,12,7,19,CearaAtletico-MG,0
1517,1517,6529,2019,3,5/5/2019,Chapecoense,Athletico-PR,1,3,0,0,1,3,0,4,4,16,17,33,ChapecoenseAthletico-PR,0
1518,1518,6530,2019,3,5/5/2019,Sao Paulo,Flamengo,1,7,0,0,1,7,0,8,8,16,15,31,Sao PauloFlamengo,0
1519,1519,6531,2019,3,5/5/2019,Botafogo-RJ,Fortaleza,0,2,0,0,0,2,0,2,2,10,16,26,Botafogo-RJFortaleza,0
1520,1520,6532,2019,3,5/5/2019,CSA,Santos,1,4,0,0,1,4,0,5,5,11,13,24,CSASantos,0
1521,1521,6533,2019,3,5/5/2019,Cruzeiro,Goias,1,2,0,1,1,3,1,3,4,14,10,24,CruzeiroGoias,0
1522,1522,6534,2019,3,5/5/2019,Gremio,Fluminense,2,1,0,0,2,1,0,3,3,8,10,18,GremioFluminense,0
1523,1523,6535,2019,3,5/5/2019,Bahia,Avai,1,2,0,0,1,2,0,3,3,27,15,42,BahiaAvai,0
1524,1524,6536,2019,4,11/5/2019,Fluminense,Botafogo-RJ,3,5,0,0,3,5,0,8,8,16,12,28,FluminenseBotafogo-RJ,1
1525,1525,6537,2019,4,11/5/2019,Corinthians,Gremio,2,4,0,0,2,4,0,6,6,13,19,32,CorinthiansGremio,0
1526,1526,6538,2019,4,11/5/2019,Goias,Ceara,2,2,0,0,2,2,0,4,4,20,12,32,GoiasCeara,0
1527,1527,6539,2019,4,12/5/2019,Flamengo,Chapecoense,2,3,0,0,2,3,0,5,5,18,9,27,FlamengoChapecoense,0
1528,1528,6540,2019,4,12/5/2019,Santos,Vasco,2,4,0,1,2,5,1,6,7,18,11,29,SantosVasco,0
1529,1529,6541,2019,4,12/5/2019,Atletico-MG,Palmeiras,1,3,0,0,1,3,0,4,4,0,0,0,Atletico-MGPalmeiras,0
1530,1530,6542,2019,4,12/5/2019,Internacional,Cruzeiro,0,0,0,1,0,1,1,0,1,10,14,24,InternacionalCruzeiro,0
1531,1531,6543,2019,4,12/5/2019,Avai,CSA,1,2,0,0,1,2,0,3,3,14,18,32,AvaiCSA,0
1532,1532,6544,2019,4,12/5/2019,Athletico-PR,Bahia,2,3,0,0,2,3,0,5,5,13,14,27,Athletico-PRBahia,0
1533,1533,6545,2019,4,12/5/2019,Fortaleza,Sao Paulo,2,2,0,0,2,2,0,4,4,12,14,26,FortalezaSao Paulo,0
1534,1534,6546,2019,5,18/5/2019,Fluminense,Cruzeiro,3,2,0,0,3,2,0,5,5,20,12,32,FluminenseCruzeiro,0
1535,1535,6547,2019,5,18/5/2019,Palmeiras,Santos,2,4,0,0,2,4,0,6,6,23,19,42,PalmeirasSantos,1
1536,1536,6548,2019,5,18/5/2019,Atletico-MG,Flamengo,3,1,1,0,4,1,1,4,5,11,8,19,Atletico-MGFlamengo,0
1537,1537,6549,2019,5,19/5/2019,Sao Paulo,Bahia,1,3,1,0,2,3,1,4,5,9,19,28,Sao PauloBahia,0
1538,1538,6550,2019,5,19/5/2019,Internacional,CSA,2,3,0,0,2,3,0,5,5,11,9,20,InternacionalCSA,0
1539,1539,6551,2019,5,19/5/2019,Athletico-PR,Corinthians,1,4,0,0,1,4,0,5,5,16,12,28,Athletico-PRCorinthians,0
1540,1540,6552,2019,5,19/5/2019,Goias,Botafogo-RJ,1,3,0,0,1,3,0,4,4,18,14,32,GoiasBotafogo-RJ,0
1541,1541,6553,2019,5,19/5/2019,Chapecoense,Fortaleza,1,1,0,0,1,1,0,2,2,16,12,28,ChapecoenseFortaleza,0
1542,1542,6554,2019,5,19/5/2019,Vasco,Avai,1,2,0,0,1,2,0,3,3,16,14,30,VascoAvai,0
1543,1543,6555,2019,5,19/5/2019,Ceara,Gremio,3,6,0,0,3,6,0,9,9,14,16,30,CearaGremio,0
1544,1544,6556,2019,6,25/5/2019,Botafogo-RJ,Palmeiras,10,0,0,0,10,0,0,10,10,13,19,32,Botafogo-RJPalmeiras,0
1545,1545,6557,2019,6,25/5/2019,Gremio,Atletico-MG,1,4,0,0,1,4,0,5,5,10,14,24,GremioAtletico-MG,0
1546,1546,6558,2019,6,26/5/2019,Flamengo,Athletico-PR,4,3,0,0,4,3,0,7,7,16,21,37,FlamengoAthletico-PR,0
1547,1547,6559,2019,6,26/5/2019,Santos,Internacional,5,5,0,0,5,5,0,10,10,19,19,38,SantosInternacional,0
1548,1548,6560,2019,6,26/5/2019,Fortaleza,Vasco,1,2,0,0,1,2,0,3,3,9,12,21,FortalezaVasco,0
1549,1549,6561,2019,6,26/5/2019,Cruzeiro,Chapecoense,1,3,0,0,1,3,0,4,4,13,11,24,CruzeiroChapecoense,0
1550,1550,6562,2019,6,26/5/2019,Bahia,Fluminense,2,3,0,1,2,4,1,5,6,9,10,19,BahiaFluminense,0
1551,1551,6563,2019,6,26/5/2019,Corinthians,Sao Paulo,3,4,0,0,3,4,0,7,7,16,14,30,CorinthiansSao Paulo,1
1552,1552,6564,2019,6,27/5/2019,CSA,Goias,3,1,0,0,3,1,0,4,4,19,10,29,CSAGoias,0
1553,1553,6565,2019,6,27/5/2019,Avai,Ceara,4,3,0,0,4,3,0,7,7,21,15,36,AvaiCeara,0
1554,1554,6566,2019,7,1/6/2019,Flamengo,Fortaleza,1,0,0,0,1,0,0,1,1,16,6,22,FlamengoFortaleza,0
1555,1555,6567,2019,7,1/6/2019,Bahia,Gremio,1,2,0,0,1,2,0,3,3,8,10,18,BahiaGremio,0
1556,1556,6568,2019,7,2/6/2019,Botafogo-RJ,Vasco,2,3,0,0,2,3,0,5,5,15,16,31,Botafogo-RJVasco,1
1557,1557,6569,2019,7,2/6/2019,Ceara,Santos,2,1,0,0,2,1,0,3,3,14,22,36,CearaSantos,0
1558,1558,6570,2019,7,2/6/2019,Athletico-PR,Fluminense,1,3,0,1,1,4,1,4,5,20,17,37,Athletico-PRFluminense,0
1559,1559,6571,2019,7,2/6/2019,Sao Paulo,Cruzeiro,2,3,1,0,3,3,1,5,6,15,12,27,Sao PauloCruzeiro,0
1560,1560,6572,2019,7,2/6/2019,Atletico-MG,CSA,0,3,0,0,0,3,0,3,3,2,11,13,Atletico-MGCSA,0
1561,1561,6573,2019,7,2/6/2019,Chapecoense,Palmeiras,2,5,0,0,2,5,0,7,7,14,21,35,ChapecoensePalmeiras,0
3012,3012,6574,2019,7,2/6/2019,Internacional,Avai,0,0,0,0,0,0,0,0,0,11,12,23,InternacionalAvai,0
1562,1562,6575,2019,7,7/8/2019,Corinthians,Goias,1,2,0,1,1,3,1,3,4,13,11,24,CorinthiansGoias,0
1563,1563,6576,2019,8,7/6/2019,Vasco,Internacional,0,2,0,0,0,2,0,2,2,13,16,29,VascoInternacional,0
1564,1564,6577,2019,8,8/6/2019,Palmeiras,Athletico-PR,2,4,0,0,2,4,0,6,6,16,29,45,PalmeirasAthletico-PR,0
1565,1565,6578,2019,8,8/6/2019,Gremio,Fortaleza,1,4,0,1,1,5,1,5,6,7,7,14,GremioFortaleza,0
1566,1566,6579,2019,8,8/6/2019,Cruzeiro,Corinthians,1,1,0,0,1,1,0,2,2,12,13,25,CruzeiroCorinthians,0
1567,1567,6580,2019,8,8/6/2019,Ceara,Bahia,2,2,0,0,2,2,0,4,4,12,10,22,CearaBahia,0
1568,1568,6581,2019,8,8/6/2019,Avai,Sao Paulo,5,2,0,0,5,2,0,7,7,17,17,34,AvaiSao Paulo,0
1569,1569,6582,2019,8,9/6/2019,CSA,Botafogo-RJ,2,1,0,0,2,1,0,3,3,20,10,30,CSABotafogo-RJ,0
1570,1570,6583,2019,8,9/6/2019,Fluminense,Flamengo,2,3,0,0,2,3,0,5,5,14,17,31,FluminenseFlamengo,1
1571,1571,6584,2019,8,9/6/2019,Santos,Atletico-MG,1,2,0,0,1,2,0,3,3,12,14,26,SantosAtletico-MG,0
1572,1572,6585,2019,8,10/6/2019,Goias,Chapecoense,2,0,0,1,2,1,1,2,3,14,17,31,GoiasChapecoense,0
1573,1573,6586,2019,9,12/6/2019,Botafogo-RJ,Gremio,1,2,0,0,1,2,0,3,3,9,11,20,Botafogo-RJGremio,0
1574,1574,6587,2019,9,12/6/2019,Fortaleza,Cruzeiro,1,6,1,0,2,6,1,7,8,10,15,25,FortalezaCruzeiro,0
1575,1575,6588,2019,9,12/6/2019,Internacional,Bahia,1,1,0,0,1,1,0,2,2,11,7,18,InternacionalBahia,0
1576,1576,6589,2019,9,12/6/2019,CSA,Flamengo,3,1,0,0,3,1,0,4,4,13,10,23,CSAFlamengo,0
1577,1577,6590,2019,9,12/6/2019,Santos,Corinthians,4,4,0,0,4,4,0,8,8,16,13,29,SantosCorinthians,1
1578,1578,6591,2019,9,13/6/2019,Vasco,Ceara,0,2,0,0,0,2,0,2,2,14,15,29,VascoCeara,0
1579,1579,6592,2019,9,13/6/2019,Chapecoense,Fluminense,2,6,0,1,2,7,1,8,9,12,21,33,ChapecoenseFluminense,0
1580,1580,6593,2019,9,13/6/2019,Palmeiras,Avai,1,1,0,0,1,1,0,2,2,13,18,31,PalmeirasAvai,0
1581,1581,6594,2019,9,13/6/2019,Atletico-MG,Sao Paulo,2,4,0,0,2,4,0,6,6,13,17,30,Atletico-MGSao Paulo,0
1582,1582,6595,2019,9,13/6/2019,Goias,Athletico-PR,1,3,0,0,1,3,0,4,4,0,0,0,GoiasAthletico-PR,0
1583,1583,6596,2019,10,13/7/2019,Gremio,Vasco,2,4,0,0,2,4,0,6,6,18,12,30,GremioVasco,0
1584,1584,6597,2019,10,13/7/2019,Fortaleza,Avai,2,2,0,0,2,2,0,4,4,15,12,27,FortalezaAvai,0
1585,1585,6598,2019,10,13/7/2019,Bahia,Santos,2,3,0,0,2,3,0,5,5,13,11,24,BahiaSantos,0
1586,1586,6599,2019,10,13/7/2019,Sao Paulo,Palmeiras,3,3,0,0,3,3,0,6,6,19,18,37,Sao PauloPalmeiras,1
1587,1587,6600,2019,10,14/7/2019,Flamengo,Goias,1,2,0,0,1,2,0,3,3,8,9,17,FlamengoGoias,0
1588,1588,6601,2019,10,14/7/2019,Corinthians,CSA,2,6,0,0,2,6,0,8,8,2,18,20,CorinthiansCSA,0
1589,1589,6602,2019,10,14/7/2019,Athletico-PR,Internacional,3,3,0,0,3,3,0,6,6,15,16,31,Athletico-PRInternacional,0
3013,3013,6603,2019,10,14/7/2019,Cruzeiro,Botafogo-RJ,0,0,0,0,0,0,0,0,0,11,8,19,CruzeiroBotafogo-RJ,0
1590,1590,6604,2019,10,14/7/2019,Chapecoense,Atletico-MG,3,5,0,0,3,5,0,8,8,20,16,36,ChapecoenseAtletico-MG,0
1591,1591,6605,2019,10,15/7/2019,Fluminense,Ceara,2,2,0,0,2,2,0,4,4,11,15,26,FluminenseCeara,0
1592,1592,6606,2019,11,20/7/2019,Vasco,Fluminense,4,3,0,2,4,5,2,7,9,25,22,47,VascoFluminense,1
1593,1593,6607,2019,11,20/7/2019,Bahia,Cruzeiro,2,1,1,0,3,1,1,3,4,17,8,25,BahiaCruzeiro,0
1594,1594,6608,2019,11,20/7/2019,Ceara,Palmeiras,3,2,0,0,3,2,0,5,5,26,13,39,CearaPalmeiras,0
1595,1595,6609,2019,11,20/7/2019,CSA,Athletico-PR,2,1,0,0,2,1,0,3,3,0,0,0,CSAAthletico-PR,0
1596,1596,6610,2019,11,20/7/2019,Internacional,Gremio,3,2,0,0,3,2,0,5,5,13,14,27,InternacionalGremio,1
1597,1597,6611,2019,11,21/7/2019,Botafogo-RJ,Santos,2,3,1,1,3,4,2,5,7,12,14,26,Botafogo-RJSantos,0
1598,1598,6612,2019,11,21/7/2019,Atletico-MG,Fortaleza,1,4,0,0,1,4,0,5,5,15,12,27,Atletico-MGFortaleza,0
1599,1599,6613,2019,11,21/7/2019,Corinthians,Flamengo,1,4,0,1,1,5,1,5,6,20,17,37,CorinthiansFlamengo,0
1600,1600,6614,2019,11,21/7/2019,Avai,Goias,4,2,0,0,4,2,0,6,6,16,19,35,AvaiGoias,0
1601,1601,6615,2019,11,22/7/2019,Sao Paulo,Chapecoense,1,3,0,0,1,3,0,4,4,29,19,48,Sao PauloChapecoense,0
1602,1602,6616,2019,12,27/7/2019,Palmeiras,Vasco,1,4,0,0,1,4,0,5,5,22,22,44,PalmeirasVasco,0
1603,1603,6617,2019,12,27/7/2019,Cruzeiro,Athletico-PR,1,0,0,0,1,0,0,1,1,0,0,0,CruzeiroAthletico-PR,0
1604,1604,6618,2019,12,27/7/2019,Fluminense,Sao Paulo,1,3,0,0,1,3,0,4,4,20,14,34,FluminenseSao Paulo,0
1605,1605,6619,2019,12,27/7/2019,Internacional,Ceara,3,3,0,0,3,3,0,6,6,11,12,23,InternacionalCeara,0
1606,1606,6620,2019,12,28/7/2019,Chapecoense,Bahia,1,1,0,0,1,1,0,2,2,16,15,31,ChapecoenseBahia,0
1607,1607,6621,2019,12,28/7/2019,Flamengo,Botafogo-RJ,5,2,0,0,5,2,0,7,7,23,16,39,FlamengoBotafogo-RJ,1
1608,1608,6622,2019,12,28/7/2019,Santos,Avai,2,2,0,0,2,2,0,4,4,9,13,22,SantosAvai,0
1609,1609,6623,2019,12,28/7/2019,Goias,Atletico-MG,1,0,0,0,1,0,0,1,1,14,9,23,GoiasAtletico-MG,0
1610,1610,6624,2019,12,28/7/2019,Fortaleza,Corinthians,2,1,0,0,2,1,0,3,3,18,16,34,FortalezaCorinthians,0
1611,1611,6625,2019,12,29/7/2019,CSA,Gremio,4,2,0,0,4,2,0,6,6,13,13,26,CSAGremio,0
1612,1612,6626,2019,13,3/8/2019,Ceara,Fortaleza,3,1,0,1,3,2,1,4,5,14,16,30,CearaFortaleza,1
1613,1613,6627,2019,13,3/8/2019,Fluminense,Internacional,1,2,0,0,1,2,0,3,3,8,12,20,FluminenseInternacional,0
1614,1614,6628,2019,13,4/8/2019,Santos,Goias,3,4,0,0,3,4,0,7,7,15,8,23,SantosGoias,0
1615,1615,6629,2019,13,4/8/2019,Avai,Botafogo-RJ,2,1,1,0,3,1,1,3,4,12,11,23,AvaiBotafogo-RJ,0
1616,1616,6630,2019,13,4/8/2019,Bahia,Flamengo,1,1,1,0,2,1,1,2,3,18,14,32,BahiaFlamengo,0
1617,1617,6631,2019,13,4/8/2019,Corinthians,Palmeiras,1,3,0,0,1,3,0,4,4,11,24,35,CorinthiansPalmeiras,1
1618,1618,6632,2019,13,4/8/2019,Vasco,CSA,4,1,0,0,4,1,0,5,5,13,14,27,VascoCSA,0
1619,1619,6633,2019,13,4/8/2019,Atletico-MG,Cruzeiro,2,3,0,0,2,3,0,5,5,19,13,32,Atletico-MGCruzeiro,1
1620,1620,6634,2019,13,5/8/2019,Gremio,Chapecoense,4,3,0,0,4,3,0,7,7,17,16,33,GremioChapecoense,0
1621,1621,6635,2019,13,21/8/2019,Athletico-PR,Sao Paulo,3,3,0,0,3,3,0,6,6,0,0,0,Athletico-PRSao Paulo,0
1622,1622,6636,2019,14,10/8/2019,Ceara,Chapecoense,3,2,0,0,3,2,0,5,5,20,11,31,CearaChapecoense,0
1623,1623,6637,2019,14,10/8/2019,Sao Paulo,Santos,6,1,0,0,6,1,0,7,7,21,15,36,Sao PauloSantos,1
1624,1624,6638,2019,14,10/8/2019,Flamengo,Gremio,4,2,0,0,4,2,0,6,6,14,15,29,FlamengoGremio,0
1625,1625,6639,2019,14,10/8/2019,Atletico-MG,Fluminense,4,3,0,1,4,4,1,7,8,14,13,27,Atletico-MGFluminense,0
1626,1626,6640,2019,14,11/8/2019,Internacional,Corinthians,3,2,0,0,3,2,0,5,5,16,8,24,InternacionalCorinthians,0
1627,1627,6641,2019,14,11/8/2019,Palmeiras,Bahia,6,4,1,1,7,5,2,10,12,15,19,34,PalmeirasBahia,0
1628,1628,6642,2019,14,11/8/2019,Avai,Cruzeiro,4,2,1,1,5,3,2,6,8,15,15,30,AvaiCruzeiro,0
1629,1629,6643,2019,14,11/8/2019,Botafogo-RJ,Athletico-PR,3,1,0,0,3,1,0,4,4,11,12,23,Botafogo-RJAthletico-PR,0
1630,1630,6644,2019,14,11/8/2019,Goias,Vasco,4,4,0,1,4,5,1,8,9,14,22,36,GoiasVasco,0
1631,1631,6645,2019,14,12/8/2019,CSA,Fortaleza,3,1,0,0,3,1,0,4,4,19,13,32,CSAFortaleza,0
1632,1632,6646,2019,15,17/8/2019,Corinthians,Botafogo-RJ,2,3,0,0,2,3,0,5,5,17,13,30,CorinthiansBotafogo-RJ,0
1633,1633,6647,2019,15,17/8/2019,Fortaleza,Internacional,2,2,1,0,3,2,1,4,5,14,14,28,FortalezaInternacional,0
1634,1634,6648,2019,15,17/8/2019,Vasco,Flamengo,0,3,0,0,0,3,0,3,3,12,18,30,VascoFlamengo,1
1635,1635,6649,2019,15,17/8/2019,Athletico-PR,Atletico-MG,3,1,0,0,3,1,0,4,4,0,0,0,Athletico-PRAtletico-MG,0
3014,3014,6650,2019,15,17/8/2019,Gremio,Palmeiras,0,0,0,0,0,0,0,0,0,13,14,27,GremioPalmeiras,0
1636,1636,6651,2019,15,18/8/2019,Fluminense,CSA,1,2,0,0,1,2,0,3,3,7,16,23,FluminenseCSA,0
1637,1637,6652,2019,15,18/8/2019,Sao Paulo,Ceara,3,2,0,0,3,2,0,5,5,12,16,28,Sao PauloCeara,0
1638,1638,6653,2019,15,18/8/2019,Bahia,Goias,2,3,1,0,3,3,1,5,6,7,13,20,BahiaGoias,0
1639,1639,6654,2019,15,18/8/2019,Cruzeiro,Santos,2,0,0,1,2,1,1,2,3,16,7,23,CruzeiroSantos,0
1640,1640,6655,2019,15,18/8/2019,Chapecoense,Avai,1,0,0,0,1,0,0,1,1,25,15,40,ChapecoenseAvai,1
1641,1641,6656,2019,16,24/8/2019,Atletico-MG,Bahia,0,2,0,0,0,2,0,2,2,17,16,33,Atletico-MGBahia,0
1642,1642,6657,2019,16,24/8/2019,Gremio,Athletico-PR,3,1,0,0,3,1,0,4,4,0,0,0,GremioAthletico-PR,0
1643,1643,6658,2019,16,25/8/2019,Goias,Internacional,2,2,1,0,3,2,1,4,5,9,14,23,GoiasInternacional,0
1644,1644,6659,2019,16,25/8/2019,Vasco,Sao Paulo,4,3,0,1,4,4,1,7,8,19,16,35,VascoSao Paulo,0
1645,1645,6660,2019,16,25/8/2019,Santos,Fortaleza,3,3,0,0,3,3,0,6,6,14,22,36,SantosFortaleza,0
1646,1646,6661,2019,16,25/8/2019,Ceara,Flamengo,3,0,0,0,3,0,0,3,3,11,14,25,CearaFlamengo,0
1647,1647,6662,2019,16,25/8/2019,Avai,Corinthians,0,1,1,1,1,2,2,1,3,19,15,34,AvaiCorinthians,0
1648,1648,6663,2019,16,25/8/2019,CSA,Cruzeiro,3,3,0,0,3,3,0,6,6,17,14,31,CSACruzeiro,0
1649,1649,6664,2019,16,26/8/2019,Botafogo-RJ,Chapecoense,2,1,0,0,2,1,0,3,3,13,16,29,Botafogo-RJChapecoense,0
1650,1650,6665,2019,16,10/9/2019,Palmeiras,Fluminense,0,2,0,0,0,2,0,2,2,12,11,23,PalmeirasFluminense,0
1651,1651,6666,2019,17,31/8/2019,Sao Paulo,Gremio,1,1,1,0,2,1,1,2,3,10,9,19,Sao PauloGremio,0
1652,1652,6667,2019,17,31/8/2019,Bahia,CSA,1,1,0,0,1,1,0,2,2,15,17,32,BahiaCSA,0
1653,1653,6668,2019,17,31/8/2019,Chapecoense,Santos,2,4,0,0,2,4,0,6,6,17,19,36,ChapecoenseSantos,0
1654,1654,6669,2019,17,31/8/2019,Athletico-PR,Ceara,1,3,0,0,1,3,0,4,4,14,15,29,Athletico-PRCeara,0
1655,1655,6670,2019,17,31/8/2019,Internacional,Botafogo-RJ,4,4,0,0,4,4,0,8,8,10,6,16,InternacionalBotafogo-RJ,0
1656,1656,6671,2019,17,1/9/2019,Flamengo,Palmeiras,2,2,0,1,2,3,1,4,5,15,16,31,FlamengoPalmeiras,0
1657,1657,6672,2019,17,1/9/2019,Fortaleza,Goias,3,2,0,1,3,3,1,5,6,21,14,35,FortalezaGoias,0
1658,1658,6673,2019,17,1/9/2019,Cruzeiro,Vasco,3,4,0,0,3,4,0,7,7,14,15,29,CruzeiroVasco,0
1659,1659,6674,2019,17,1/9/2019,Corinthians,Atletico-MG,0,1,0,0,0,1,0,1,1,9,14,23,CorinthiansAtletico-MG,0
1660,1660,6675,2019,17,2/9/2019,Fluminense,Avai,3,1,0,0,3,1,0,4,4,14,15,29,FluminenseAvai,0
1661,1661,6676,2019,18,7/9/2019,Vasco,Bahia,3,1,0,0,3,1,0,4,4,15,19,34,VascoBahia,0
1662,1662,6677,2019,18,7/9/2019,Corinthians,Ceara,1,1,0,0,1,1,0,2,2,9,10,19,CorinthiansCeara,0
1663,1663,6678,2019,18,7/9/2019,Avai,Flamengo,1,2,1,0,2,2,1,3,4,15,9,24,AvaiFlamengo,0
1664,1664,6679,2019,18,7/9/2019,Fortaleza,Fluminense,1,2,0,0,1,2,0,3,3,13,15,28,FortalezaFluminense,0
1665,1665,6680,2019,18,7/9/2019,Internacional,Sao Paulo,1,5,0,0,1,5,0,6,6,14,16,30,InternacionalSao Paulo,0
1666,1666,6681,2019,18,7/9/2019,Goias,Palmeiras,5,1,0,1,5,2,1,6,7,11,21,32,GoiasPalmeiras,0
1667,1667,6682,2019,18,8/9/2019,Cruzeiro,Gremio,2,1,0,0,2,1,0,3,3,11,10,21,CruzeiroGremio,0
1668,1668,6683,2019,18,8/9/2019,Santos,Athletico-PR,3,6,0,0,3,6,0,9,9,8,15,23,SantosAthletico-PR,0
1669,1669,6684,2019,18,8/9/2019,Botafogo-RJ,Atletico-MG,4,3,0,1,4,4,1,7,8,14,14,28,Botafogo-RJAtletico-MG,0
1670,1670,6685,2019,18,8/9/2019,CSA,Chapecoense,3,2,0,2,3,4,2,5,7,22,14,36,CSAChapecoense,0
1671,1671,6686,2019,19,14/9/2019,Flamengo,Santos,2,5,0,0,2,5,0,7,7,20,24,44,FlamengoSantos,0
1672,1672,6687,2019,19,14/9/2019,Chapecoense,Vasco,2,5,0,0,2,5,0,7,7,14,22,36,ChapecoenseVasco,0
1673,1673,6688,2019,19,14/9/2019,Palmeiras,Cruzeiro,2,3,0,0,2,3,0,5,5,20,19,39,PalmeirasCruzeiro,0
1674,1674,6689,2019,19,14/9/2019,Ceara,Botafogo-RJ,1,1,0,0,1,1,0,2,2,11,5,16,CearaBotafogo-RJ,0
1675,1675,6690,2019,19,15/9/2019,Athletico-PR,Avai,1,0,0,0,1,0,0,1,1,0,0,0,Athletico-PRAvai,0
1676,1676,6691,2019,19,15/9/2019,Atletico-MG,Internacional,0,1,0,0,0,1,0,1,1,6,14,20,Atletico-MGInternacional,0
1677,1677,6692,2019,19,15/9/2019,Bahia,Fortaleza,1,1,0,0,1,1,0,2,2,16,11,27,BahiaFortaleza,0
1678,1678,6693,2019,19,15/9/2019,Gremio,Goias,0,1,0,0,0,1,0,1,1,10,10,20,GremioGoias,0
1679,1679,6694,2019,19,15/9/2019,Fluminense,Corinthians,4,1,0,0,4,1,0,5,5,19,12,31,FluminenseCorinthians,0
1680,1680,6695,2019,19,15/9/2019,Sao Paulo,CSA,1,3,0,0,1,3,0,4,4,14,16,30,Sao PauloCSA,0
1681,1681,6696,2019,20,21/9/2019,Botafogo-RJ,Sao Paulo,3,1,0,0,3,1,0,4,4,14,23,37,Botafogo-RJSao Paulo,0
1682,1682,6697,2019,20,21/9/2019,Cruzeiro,Flamengo,2,2,0,0,2,2,0,4,4,9,14,23,CruzeiroFlamengo,0
1683,1683,6698,2019,20,21/9/2019,Corinthians,Bahia,2,4,0,0,2,4,0,6,6,12,15,27,CorinthiansBahia,0
1684,1684,6699,2019,20,21/9/2019,Santos,Gremio,1,4,0,0,1,4,0,5,5,13,15,28,SantosGremio,0
1685,1685,6700,2019,20,22/9/2019,Internacional,Chapecoense,0,4,0,0,0,4,0,4,4,12,19,31,InternacionalChapecoense,0
1686,1686,6701,2019,20,22/9/2019,Fortaleza,Palmeiras,4,1,0,0,4,1,0,5,5,16,11,27,FortalezaPalmeiras,0
1687,1687,6702,2019,20,22/9/2019,CSA,Ceara,1,2,0,0,1,2,0,3,3,20,9,29,CSACeara,0
1688,1688,6703,2019,20,22/9/2019,Vasco,Athletico-PR,3,3,0,0,3,3,0,6,6,0,0,0,VascoAthletico-PR,0
1689,1689,6704,2019,20,22/9/2019,Goias,Fluminense,4,0,1,0,5,0,1,4,5,16,10,26,GoiasFluminense,0
1690,1690,6705,2019,20,23/9/2019,Avai,Atletico-MG,3,1,0,0,3,1,0,4,4,11,14,25,AvaiAtletico-MG,0
1691,1691,6706,2019,21,25/9/2019,Ceara,Cruzeiro,2,3,0,0,2,3,0,5,5,18,17,35,CearaCruzeiro,0
1692,1692,6707,2019,21,25/9/2019,Bahia,Botafogo-RJ,1,0,0,1,1,1,1,1,2,17,9,26,BahiaBotafogo-RJ,0
1693,1693,6708,2019,21,25/9/2019,Flamengo,Internacional,1,1,0,2,1,3,2,2,4,16,6,22,FlamengoInternacional,0
1694,1694,6709,2019,21,25/9/2019,Sao Paulo,Goias,2,4,0,0,2,4,0,6,6,21,24,45,Sao PauloGoias,0
1695,1695,6710,2019,21,26/9/2019,Palmeiras,CSA,0,1,0,0,0,1,0,1,1,13,13,26,PalmeirasCSA,0
1696,1696,6711,2019,21,26/9/2019,Fluminense,Santos,2,3,2,1,4,4,3,5,8,12,15,27,FluminenseSantos,0
1697,1697,6712,2019,21,26/9/2019,Gremio,Avai,1,1,0,0,1,1,0,2,2,18,9,27,GremioAvai,0
1698,1698,6713,2019,21,26/9/2019,Athletico-PR,Fortaleza,3,0,0,0,3,0,0,3,3,11,8,19,Athletico-PRFortaleza,0
1699,1699,6714,2019,21,2/10/2019,Atletico-MG,Vasco,3,2,0,0,3,2,0,5,5,18,22,40,Atletico-MGVasco,0
1700,1700,6715,2019,21,2/10/2019,Chapecoense,Corinthians,3,2,0,0,3,2,0,5,5,19,15,34,ChapecoenseCorinthians,0
1701,1701,6716,2019,22,28/9/2019,Flamengo,Sao Paulo,3,4,0,0,3,4,0,7,7,20,27,47,FlamengoSao Paulo,0
1702,1702,6717,2019,22,29/9/2019,Corinthians,Vasco,3,5,0,0,3,5,0,8,8,16,23,39,CorinthiansVasco,0
1703,1703,6718,2019,22,29/9/2019,Santos,CSA,1,2,1,0,2,2,1,3,4,13,12,25,SantosCSA,0
1704,1704,6719,2019,22,29/9/2019,Internacional,Palmeiras,3,2,0,0,3,2,0,5,5,28,17,45,InternacionalPalmeiras,0
1705,1705,6720,2019,22,29/9/2019,Fluminense,Gremio,1,4,0,0,1,4,0,5,5,17,9,26,FluminenseGremio,0
1706,1706,6721,2019,22,29/9/2019,Athletico-PR,Chapecoense,0,1,0,0,0,1,0,1,1,0,0,0,Athletico-PRChapecoense,0
1707,1707,6722,2019,22,29/9/2019,Atletico-MG,Ceara,0,2,0,0,0,2,0,2,2,13,12,25,Atletico-MGCeara,0
1708,1708,6723,2019,22,30/9/2019,Avai,Bahia,1,2,0,0,1,2,0,3,3,16,16,32,AvaiBahia,0
1709,1709,6724,2019,22,30/9/2019,Fortaleza,Botafogo-RJ,3,2,0,0,3,2,0,5,5,15,12,27,FortalezaBotafogo-RJ,0
1710,1710,6725,2019,22,30/9/2019,Goias,Cruzeiro,0,3,0,0,0,3,0,3,3,20,19,39,GoiasCruzeiro,0
1711,1711,6726,2019,23,5/10/2019,Vasco,Santos,4,2,0,1,4,3,1,6,7,15,17,32,VascoSantos,0
1712,1712,6727,2019,23,5/10/2019,Sao Paulo,Fortaleza,3,2,0,0,3,2,0,5,5,15,14,29,Sao PauloFortaleza,0
1713,1713,6728,2019,23,5/10/2019,Gremio,Corinthians,3,2,0,0,3,2,0,5,5,12,12,24,GremioCorinthians,0
1714,1714,6729,2019,23,5/10/2019,Bahia,Athletico-PR,2,3,0,0,2,3,0,5,5,9,14,23,BahiaAthletico-PR,0
1715,1715,6730,2019,23,5/10/2019,Cruzeiro,Internacional,5,3,0,0,5,3,0,8,8,18,14,32,CruzeiroInternacional,0
1716,1716,6731,2019,23,6/10/2019,Chapecoense,Flamengo,1,0,0,0,1,0,0,1,1,16,20,36,ChapecoenseFlamengo,0
1717,1717,6732,2019,23,6/10/2019,Ceara,Goias,1,0,0,0,1,0,0,1,1,7,12,19,CearaGoias,0
1718,1718,6733,2019,23,6/10/2019,Palmeiras,Atletico-MG,3,4,0,0,3,4,0,7,7,12,20,32,PalmeirasAtletico-MG,0
1719,1719,6734,2019,23,6/10/2019,Botafogo-RJ,Fluminense,4,1,0,0,4,1,0,5,5,20,20,40,Botafogo-RJFluminense,1
1720,1720,6735,2019,23,6/10/2019,CSA,Avai,3,3,0,0,3,3,0,6,6,10,11,21,CSAAvai,0
1721,1721,6736,2019,24,9/10/2019,CSA,Internacional,2,2,0,0,2,2,0,4,4,16,9,25,CSAInternacional,0
1722,1722,6737,2019,24,9/10/2019,Botafogo-RJ,Goias,4,2,0,0,4,2,0,6,6,29,18,47,Botafogo-RJGoias,0
1723,1723,6738,2019,24,9/10/2019,Fortaleza,Chapecoense,4,2,0,0,4,2,0,6,6,18,17,35,FortalezaChapecoense,0
1724,1724,6739,2019,24,9/10/2019,Bahia,Sao Paulo,2,1,0,0,2,1,0,3,3,10,15,25,BahiaSao Paulo,0
1725,1725,6740,2019,24,9/10/2019,Gremio,Ceara,0,3,0,0,0,3,0,3,3,11,19,30,GremioCeara,0
1726,1726,6741,2019,24,9/10/2019,Cruzeiro,Fluminense,4,3,0,0,4,3,0,7,7,17,18,35,CruzeiroFluminense,0
1727,1727,6742,2019,24,9/10/2019,Santos,Palmeiras,1,2,0,1,1,3,1,3,4,16,13,29,SantosPalmeiras,1
1728,1728,6743,2019,24,10/10/2019,Corinthians,Athletico-PR,2,2,0,0,2,2,0,4,4,0,0,0,CorinthiansAthletico-PR,0
1729,1729,6744,2019,24,10/10/2019,Avai,Vasco,1,1,0,0,1,1,0,2,2,18,11,29,AvaiVasco,0
1730,1730,6745,2019,24,10/10/2019,Flamengo,Atletico-MG,0,3,0,0,0,3,0,3,3,10,9,19,FlamengoAtletico-MG,0
1731,1731,6746,2019,25,12/10/2019,Goias,CSA,2,3,0,0,2,3,0,5,5,17,21,38,GoiasCSA,0
1732,1732,6747,2019,25,12/10/2019,Fluminense,Bahia,0,1,0,0,0,1,0,1,1,11,15,26,FluminenseBahia,0
1733,1733,6748,2019,25,12/10/2019,Palmeiras,Botafogo-RJ,2,2,0,0,2,2,0,4,4,22,13,35,PalmeirasBotafogo-RJ,0
1734,1734,6749,2019,25,13/10/2019,Internacional,Santos,2,3,0,0,2,3,0,5,5,16,18,34,InternacionalSantos,0
1735,1735,6750,2019,25,13/10/2019,Athletico-PR,Flamengo,2,4,0,0,2,4,0,6,6,0,0,0,Athletico-PRFlamengo,0
1736,1736,6751,2019,25,13/10/2019,Ceara,Avai,1,3,0,0,1,3,0,4,4,16,16,32,CearaAvai,0
1737,1737,6752,2019,25,13/10/2019,Vasco,Fortaleza,2,4,0,1,2,5,1,6,7,14,19,33,VascoFortaleza,0
1738,1738,6753,2019,25,13/10/2019,Sao Paulo,Corinthians,0,1,0,0,0,1,0,1,1,9,10,19,Sao PauloCorinthians,1
1739,1739,6754,2019,25,13/10/2019,Atletico-MG,Gremio,4,1,1,0,5,1,1,5,6,17,8,25,Atletico-MGGremio,0
1740,1740,6755,2019,25,13/10/2019,Chapecoense,Cruzeiro,1,1,0,0,1,1,0,2,2,12,13,25,ChapecoenseCruzeiro,0
1741,1741,6756,2019,26,16/10/2019,CSA,Atletico-MG,3,3,0,1,3,4,1,6,7,18,13,31,CSAAtletico-MG,0
1742,1742,6757,2019,26,16/10/2019,Gremio,Bahia,3,2,0,0,3,2,0,5,5,13,15,28,GremioBahia,0
1743,1743,6758,2019,26,16/10/2019,Fortaleza,Flamengo,1,3,0,0,1,3,0,4,4,8,16,24,FortalezaFlamengo,0
1744,1744,6759,2019,26,16/10/2019,Cruzeiro,Sao Paulo,2,2,0,0,2,2,0,4,4,18,16,34,CruzeiroSao Paulo,0
1745,1745,6760,2019,26,16/10/2019,Palmeiras,Chapecoense,1,3,0,1,1,4,1,4,5,15,14,29,PalmeirasChapecoense,0
1746,1746,6761,2019,26,16/10/2019,Goias,Corinthians,3,4,2,0,5,4,2,7,9,10,16,26,GoiasCorinthians,0
1747,1747,6762,2019,26,16/10/2019,Vasco,Botafogo-RJ,1,0,0,0,1,0,0,1,1,15,11,26,VascoBotafogo-RJ,1
1748,1748,6763,2019,26,17/10/2019,Avai,Internacional,1,3,1,0,2,3,1,4,5,7,16,23,AvaiInternacional,0
1749,1749,6764,2019,26,17/10/2019,Santos,Ceara,3,4,0,0,3,4,0,7,7,15,11,26,SantosCeara,0
1750,1750,6765,2019,26,17/10/2019,Fluminense,Athletico-PR,0,1,0,0,0,1,0,1,1,0,0,0,FluminenseAthletico-PR,0
1751,1751,6766,2019,27,19/10/2019,Fortaleza,Gremio,4,2,0,1,4,3,1,6,7,13,17,30,FortalezaGremio,0
1752,1752,6767,2019,27,19/10/2019,Corinthians,Cruzeiro,3,1,0,0,3,1,0,4,4,15,18,33,CorinthiansCruzeiro,0
1753,1753,6768,2019,27,20/10/2019,Internacional,Vasco,3,1,0,0,3,1,0,4,4,14,12,26,InternacionalVasco,0
1754,1754,6769,2019,27,20/10/2019,Sao Paulo,Avai,4,1,0,1,4,2,1,5,6,23,11,34,Sao PauloAvai,0
1755,1755,6770,2019,27,20/10/2019,Atletico-MG,Santos,3,4,0,0,3,4,0,7,7,24,14,38,Atletico-MGSantos,0
1756,1756,6771,2019,27,20/10/2019,Flamengo,Fluminense,3,5,0,0,3,5,0,8,8,23,13,36,FlamengoFluminense,0
1757,1757,6772,2019,27,20/10/2019,Chapecoense,Goias,2,5,0,0,2,5,0,7,7,23,14,37,ChapecoenseGoias,0
1758,1758,6773,2019,27,20/10/2019,Athletico-PR,Palmeiras,1,2,0,0,1,2,0,3,3,23,11,34,Athletico-PRPalmeiras,0
1759,1759,6774,2019,27,21/10/2019,Bahia,Ceara,2,3,0,0,2,3,0,5,5,14,11,25,BahiaCeara,0
1760,1760,6775,2019,27,21/10/2019,Botafogo-RJ,CSA,2,2,0,1,2,3,1,4,5,18,16,34,Botafogo-RJCSA,0
1761,1761,6776,2019,28,26/10/2019,Corinthians,Santos,3,1,0,0,3,1,0,4,4,20,12,32,CorinthiansSantos,1
1762,1762,6777,2019,28,26/10/2019,Ceara,Vasco,3,3,0,0,3,3,0,6,6,11,14,25,CearaVasco,0
1763,1763,6778,2019,28,26/10/2019,Bahia,Internacional,1,5,0,0,1,5,0,6,6,16,11,27,BahiaInternacional,0
1764,1764,6779,2019,28,26/10/2019,Fluminense,Chapecoense,1,4,0,0,1,4,0,5,5,11,14,25,FluminenseChapecoense,0
1765,1765,6780,2019,28,26/10/2019,Cruzeiro,Fortaleza,3,1,0,0,3,1,0,4,4,0,0,0,CruzeiroFortaleza,0
1766,1766,6781,2019,28,27/10/2019,Athletico-PR,Goias,1,1,0,0,1,1,0,2,2,0,0,0,Athletico-PRGoias,0
1767,1767,6782,2019,28,27/10/2019,Gremio,Botafogo-RJ,3,2,0,0,3,2,0,5,5,13,9,22,GremioBotafogo-RJ,0
3015,3015,6783,2019,28,27/10/2019,Sao Paulo,Atletico-MG,0,0,0,0,0,0,0,0,0,9,11,20,Sao PauloAtletico-MG,0
1768,1768,6784,2019,28,27/10/2019,Avai,Palmeiras,3,2,0,0,3,2,0,5,5,18,17,35,AvaiPalmeiras,0
1769,1769,6785,2019,28,27/10/2019,Flamengo,CSA,1,2,0,0,1,2,0,3,3,20,13,33,FlamengoCSA,0
3016,3016,6786,2019,29,30/10/2019,Palmeiras,Sao Paulo,0,0,0,0,0,0,0,0,0,12,14,26,PalmeirasSao Paulo,1
1770,1770,6787,2019,29,30/10/2019,Avai,Fortaleza,4,1,1,0,5,1,1,5,6,20,10,30,AvaiFortaleza,0
1771,1771,6788,2019,29,30/10/2019,Atletico-MG,Chapecoense,3,3,0,0,3,3,0,6,6,15,10,25,Atletico-MGChapecoense,0
1772,1772,6789,2019,29,30/10/2019,Ceara,Fluminense,1,1,0,0,1,1,0,2,2,12,8,20,CearaFluminense,0
1773,1773,6790,2019,29,30/10/2019,Vasco,Gremio,2,2,0,0,2,2,0,4,4,9,13,22,VascoGremio,0
1774,1774,6791,2019,29,30/10/2019,CSA,Corinthians,6,2,0,0,6,2,0,8,8,17,10,27,CSACorinthians,0
1775,1775,6792,2019,29,31/10/2019,Santos,Bahia,5,3,0,0,5,3,0,8,8,17,26,43,SantosBahia,0
1776,1776,6793,2019,29,31/10/2019,Goias,Flamengo,5,3,0,1,5,4,1,8,9,18,15,33,GoiasFlamengo,0
1777,1777,6794,2019,29,31/10/2019,Internacional,Athletico-PR,3,2,0,0,3,2,0,5,5,14,22,36,InternacionalAthletico-PR,0
1778,1778,6795,2019,29,31/10/2019,Botafogo-RJ,Cruzeiro,1,3,0,0,1,3,0,4,4,15,15,30,Botafogo-RJCruzeiro,0
1779,1779,6796,2019,30,2/11/2019,Fortaleza,Atletico-MG,3,3,0,1,3,4,1,6,7,18,19,37,FortalezaAtletico-MG,0
1780,1780,6797,2019,30,2/11/2019,Fluminense,Vasco,2,3,0,0,2,3,0,5,5,7,12,19,FluminenseVasco,1
1781,1781,6798,2019,30,2/11/2019,Palmeiras,Ceara,2,2,0,0,2,2,0,4,4,14,19,33,PalmeirasCeara,0
1782,1782,6799,2019,30,2/11/2019,Chapecoense,Sao Paulo,2,2,0,0,2,2,0,4,4,19,11,30,ChapecoenseSao Paulo,0
1783,1783,6800,2019,30,3/11/2019,Flamengo,Corinthians,0,1,0,0,0,1,0,1,1,12,10,22,FlamengoCorinthians,0
1784,1784,6801,2019,30,3/11/2019,Athletico-PR,CSA,3,4,0,0,3,4,0,7,7,0,0,0,Athletico-PRCSA,0
1785,1785,6802,2019,30,3/11/2019,Gremio,Internacional,2,2,0,1,2,3,1,4,5,16,16,32,GremioInternacional,1
1786,1786,6803,2019,30,3/11/2019,Santos,Botafogo-RJ,1,0,0,0,1,0,0,1,1,16,8,24,SantosBotafogo-RJ,0
1787,1787,6804,2019,30,3/11/2019,Cruzeiro,Bahia,3,0,1,0,4,0,1,3,4,16,11,27,CruzeiroBahia,0
1788,1788,6805,2019,30,3/11/2019,Goias,Avai,1,3,0,0,1,3,0,4,4,19,19,38,GoiasAvai,0
1789,1789,6806,2019,31,6/11/2019,Corinthians,Fortaleza,2,3,0,0,2,3,0,5,5,18,9,27,CorinthiansFortaleza,0
1790,1790,6807,2019,31,6/11/2019,Atletico-MG,Goias,0,2,0,0,0,2,0,2,2,15,16,31,Atletico-MGGoias,0
1791,1791,6808,2019,31,6/11/2019,Avai,Santos,5,2,1,1,6,3,2,7,9,19,11,30,AvaiSantos,0
1792,1792,6809,2019,31,6/11/2019,Athletico-PR,Cruzeiro,3,1,0,1,3,2,1,4,5,0,0,0,Athletico-PRCruzeiro,0
1793,1793,6810,2019,31,6/11/2019,Vasco,Palmeiras,7,4,1,0,8,4,1,11,12,17,27,44,VascoPalmeiras,0
1794,1794,6811,2019,31,6/11/2019,Bahia,Chapecoense,1,3,0,0,1,3,0,4,4,20,16,36,BahiaChapecoense,0
1795,1795,6812,2019,31,7/11/2019,Ceara,Internacional,2,2,0,0,2,2,0,4,4,8,11,19,CearaInternacional,0
1796,1796,6813,2019,31,7/11/2019,Sao Paulo,Fluminense,2,1,0,0,2,1,0,3,3,6,16,22,Sao PauloFluminense,0
1797,1797,6814,2019,31,7/11/2019,Botafogo-RJ,Flamengo,5,2,1,0,6,2,1,7,8,16,14,30,Botafogo-RJFlamengo,1
1798,1798,6815,2019,31,7/11/2019,Gremio,CSA,3,2,0,0,3,2,0,5,5,15,16,31,GremioCSA,0
1799,1799,6816,2019,32,9/11/2019,Goias,Santos,4,2,0,0,4,2,0,6,6,19,16,35,GoiasSantos,0
1800,1800,6817,2019,32,9/11/2019,Palmeiras,Corinthians,2,1,0,0,2,1,0,3,3,12,18,30,PalmeirasCorinthians,1
1801,1801,6818,2019,32,10/11/2019,Internacional,Fluminense,3,2,0,0,3,2,0,5,5,16,9,25,InternacionalFluminense,0
1802,1802,6819,2019,32,10/11/2019,Cruzeiro,Atletico-MG,1,1,0,0,1,1,0,2,2,9,12,21,CruzeiroAtletico-MG,1
1803,1803,6820,2019,32,10/11/2019,Sao Paulo,Athletico-PR,2,2,0,0,2,2,0,4,4,0,0,0,Sao PauloAthletico-PR,0
1804,1804,6821,2019,32,10/11/2019,Flamengo,Bahia,1,0,0,0,1,0,0,1,1,10,11,21,FlamengoBahia,0
1805,1805,6822,2019,32,10/11/2019,Chapecoense,Gremio,2,2,0,0,2,2,0,4,4,10,13,23,ChapecoenseGremio,0
1806,1806,6823,2019,32,10/11/2019,Fortaleza,Ceara,4,4,0,0,4,4,0,8,8,13,17,30,FortalezaCeara,1
1807,1807,6824,2019,32,10/11/2019,CSA,Vasco,2,2,1,0,3,2,1,4,5,17,18,35,CSAVasco,0
1808,1808,6825,2019,32,11/11/2019,Botafogo-RJ,Avai,4,3,0,1,4,4,1,7,8,19,16,35,Botafogo-RJAvai,0
1809,1809,6826,2019,34,13/11/2019,Flamengo,Vasco,6,5,0,0,6,5,0,11,11,23,25,48,FlamengoVasco,1
1810,1810,6827,2019,34,23/11/2019,Santos,Cruzeiro,2,2,0,0,2,2,0,4,4,16,19,35,SantosCruzeiro,0
1811,1811,6828,2019,34,24/11/2019,Palmeiras,Gremio,2,3,0,0,2,3,0,5,5,14,14,28,PalmeirasGremio,0
1812,1812,6829,2019,34,24/11/2019,Atletico-MG,Athletico-PR,3,2,0,0,3,2,0,5,5,0,0,0,Atletico-MGAthletico-PR,0
1813,1813,6830,2019,34,24/11/2019,Goias,Bahia,2,2,0,0,2,2,0,4,4,14,23,37,GoiasBahia,0
1814,1814,6831,2019,34,24/11/2019,Botafogo-RJ,Corinthians,4,2,0,0,4,2,0,6,6,11,19,30,Botafogo-RJCorinthians,0
1815,1815,6832,2019,34,24/11/2019,Ceara,Sao Paulo,3,1,0,0,3,1,0,4,4,12,16,28,CearaSao Paulo,0
1816,1816,6833,2019,34,24/11/2019,Internacional,Fortaleza,4,2,0,0,4,2,0,6,6,16,12,28,InternacionalFortaleza,0
1817,1817,6834,2019,34,24/11/2019,Avai,Chapecoense,0,1,1,1,1,2,2,1,3,11,15,26,AvaiChapecoense,1
1818,1818,6835,2019,34,25/11/2019,CSA,Fluminense,2,2,0,0,2,2,0,4,4,15,14,29,CSAFluminense,0
1819,1819,6836,2019,33,16/11/2019,Santos,Sao Paulo,0,3,0,0,0,3,0,3,3,14,25,39,SantosSao Paulo,1
1820,1820,6837,2019,33,16/11/2019,Fluminense,Atletico-MG,2,3,0,0,2,3,0,5,5,15,15,30,FluminenseAtletico-MG,0
1821,1821,6838,2019,33,17/11/2019,Gremio,Flamengo,1,3,0,1,1,4,1,4,5,9,15,24,GremioFlamengo,0
1822,1822,6839,2019,33,17/11/2019,Bahia,Palmeiras,2,0,0,0,2,0,0,2,2,17,16,33,BahiaPalmeiras,0
1823,1823,6840,2019,33,17/11/2019,Chapecoense,Ceara,2,1,0,0,2,1,0,3,3,13,15,28,ChapecoenseCeara,0
1824,1824,6841,2019,33,17/11/2019,Athletico-PR,Botafogo-RJ,4,1,0,0,4,1,0,5,5,0,0,0,Athletico-PRBotafogo-RJ,0
1825,1825,6842,2019,33,17/11/2019,Corinthians,Internacional,0,2,0,0,0,2,0,2,2,9,19,28,CorinthiansInternacional,0
1826,1826,6843,2019,33,17/11/2019,Fortaleza,CSA,0,1,0,0,0,1,0,1,1,10,20,30,FortalezaCSA,0
1827,1827,6844,2019,33,18/11/2019,Vasco,Goias,2,2,0,0,2,2,0,4,4,22,16,38,VascoGoias,0
1828,1828,6845,2019,33,18/11/2019,Cruzeiro,Avai,3,2,0,0,3,2,0,5,5,14,20,34,CruzeiroAvai,0
1829,1829,6846,2019,35,27/11/2019,Internacional,Goias,2,4,0,0,2,4,0,6,6,22,24,46,InternacionalGoias,0
1830,1830,6847,2019,35,27/11/2019,Chapecoense,Botafogo-RJ,2,3,0,0,2,3,0,5,5,12,18,30,ChapecoenseBotafogo-RJ,0
1831,1831,6848,2019,35,27/11/2019,Bahia,Atletico-MG,1,1,0,0,1,1,0,2,2,12,20,32,BahiaAtletico-MG,0
1832,1832,6849,2019,35,27/11/2019,Athletico-PR,Gremio,3,4,0,1,3,5,1,7,8,0,0,0,Athletico-PRGremio,0
1833,1833,6850,2019,35,27/11/2019,Flamengo,Ceara,2,1,0,1,2,2,1,3,4,13,10,23,FlamengoCeara,0
1834,1834,6851,2019,35,27/11/2019,Corinthians,Avai,0,1,0,0,0,1,0,1,1,15,13,28,CorinthiansAvai,0
1835,1835,6852,2019,35,28/11/2019,Fluminense,Palmeiras,3,4,0,0,3,4,0,7,7,15,20,35,FluminensePalmeiras,0
1836,1836,6853,2019,35,28/11/2019,Fortaleza,Santos,2,8,0,2,2,10,2,10,12,16,17,33,FortalezaSantos,0
1837,1837,6854,2019,35,28/11/2019,Sao Paulo,Vasco,4,2,0,0,4,2,0,6,6,29,16,45,Sao PauloVasco,0
1838,1838,6855,2019,35,28/11/2019,Cruzeiro,CSA,0,4,0,0,0,4,0,4,4,9,16,25,CruzeiroCSA,0
1839,1839,6856,2019,36,30/11/2019,Botafogo-RJ,Internacional,2,3,0,0,2,3,0,5,5,8,14,22,Botafogo-RJInternacional,0
1840,1840,6857,2019,36,30/11/2019,Ceara,Athletico-PR,7,2,0,1,7,3,1,9,10,17,16,33,CearaAthletico-PR,0
1841,1841,6858,2019,36,1/12/2019,Avai,Fluminense,4,5,0,0,4,5,0,9,9,26,20,46,AvaiFluminense,0
1842,1842,6859,2019,36,1/12/2019,Palmeiras,Flamengo,1,2,0,0,1,2,0,3,3,18,21,39,PalmeirasFlamengo,0
1843,1843,6860,2019,36,1/12/2019,Goias,Fortaleza,1,4,0,0,1,4,0,5,5,11,15,26,GoiasFortaleza,0
1844,1844,6861,2019,36,1/12/2019,CSA,Bahia,3,4,0,1,3,5,1,7,8,9,12,21,CSABahia,0
1845,1845,6862,2019,36,1/12/2019,Atletico-MG,Corinthians,3,1,0,0,3,1,0,4,4,15,8,23,Atletico-MGCorinthians,0
1846,1846,6863,2019,36,1/12/2019,Santos,Chapecoense,3,4,0,0,3,4,0,7,7,18,19,37,SantosChapecoense,0
3017,3017,6864,2019,36,1/12/2019,Gremio,Sao Paulo,0,0,0,0,0,0,0,0,0,15,16,31,GremioSao Paulo,0
1847,1847,6865,2019,36,2/12/2019,Vasco,Cruzeiro,3,3,0,0,3,3,0,6,6,16,19,35,VascoCruzeiro,0
1848,1848,6866,2019,37,4/12/2019,Athletico-PR,Santos,2,4,0,1,2,5,1,6,7,16,9,25,Athletico-PRSantos,0
1849,1849,6867,2019,37,4/12/2019,Ceara,Corinthians,3,4,1,0,4,4,1,7,8,15,14,29,CearaCorinthians,0
1850,1850,6868,2019,37,4/12/2019,Atletico-MG,Botafogo-RJ,1,3,0,0,1,3,0,4,4,11,10,21,Atletico-MGBotafogo-RJ,0
1851,1851,6869,2019,37,4/12/2019,Chapecoense,CSA,1,2,0,1,1,3,1,3,4,21,13,34,ChapecoenseCSA,0
1852,1852,6870,2019,37,4/12/2019,Fluminense,Fortaleza,2,1,1,1,3,2,2,3,5,16,9,25,FluminenseFortaleza,0
1853,1853,6871,2019,37,4/12/2019,Sao Paulo,Internacional,3,4,0,0,3,4,0,7,7,20,19,39,Sao PauloInternacional,0
1854,1854,6872,2019,37,5/12/2019,Gremio,Cruzeiro,0,4,0,1,0,5,1,4,5,11,21,32,GremioCruzeiro,0
1855,1855,6873,2019,37,5/12/2019,Palmeiras,Goias,5,1,0,0,5,1,0,6,6,21,13,34,PalmeirasGoias,0
1856,1856,6874,2019,37,5/12/2019,Bahia,Vasco,3,2,1,1,4,3,2,5,7,21,11,32,BahiaVasco,0
1857,1857,6875,2019,37,5/12/2019,Flamengo,Avai,0,1,0,0,0,1,0,1,1,18,13,31,FlamengoAvai,0
1858,1858,6876,2019,38,8/12/2019,Corinthians,Fluminense,1,3,0,0,1,3,0,4,4,21,14,35,CorinthiansFluminense,0
1859,1859,6877,2019,38,8/12/2019,Santos,Flamengo,2,3,0,0,2,3,0,5,5,12,15,27,SantosFlamengo,0
1860,1860,6878,2019,38,8/12/2019,Botafogo-RJ,Ceara,0,2,0,0,0,2,0,2,2,12,19,31,Botafogo-RJCeara,0
1861,1861,6879,2019,38,8/12/2019,CSA,Sao Paulo,1,3,0,1,1,4,1,4,5,17,24,41,CSASao Paulo,0
1862,1862,6880,2019,38,8/12/2019,Internacional,Atletico-MG,4,1,0,0,4,1,0,5,5,11,16,27,InternacionalAtletico-MG,0
1863,1863,6881,2019,38,8/12/2019,Cruzeiro,Palmeiras,0,1,0,0,0,1,0,1,1,11,11,22,CruzeiroPalmeiras,0
1864,1864,6882,2019,38,8/12/2019,Goias,Gremio,1,1,0,0,1,1,0,2,2,21,8,29,GoiasGremio,0
1865,1865,6883,2019,38,8/12/2019,Vasco,Chapecoense,2,3,0,0,2,3,0,5,5,18,16,34,VascoChapecoense,0
1866,1866,6884,2019,38,8/12/2019,Avai,Athletico-PR,2,1,0,0,2,1,0,3,3,0,0,0,AvaiAthletico-PR,0
1867,1867,6885,2019,38,8/12/2019,Fortaleza,Bahia,2,1,0,0,2,1,0,3,3,9,15,24,FortalezaBahia,0
1868,1868,6886,2020,1,8/8/2020,Fortaleza,Athletico-PR,3,2,1,0,4,2,1,5,6,14,10,24,FortalezaAthletico-PR,0
1869,1869,6887,2020,1,8/8/2020,Coritiba,Internacional,3,4,0,0,3,4,0,7,7,11,21,32,CoritibaInternacional,0
1870,1870,6888,2020,1,8/8/2020,Sport,Ceara,3,3,0,0,3,3,0,6,6,15,18,33,SportCeara,0
1871,1871,6889,2020,1,9/8/2020,Santos,Bragantino,0,1,0,0,0,1,0,1,1,10,19,29,SantosBragantino,1
1872,1872,6890,2020,1,9/8/2020,Flamengo,Atletico-MG,3,2,0,0,3,2,0,5,5,12,24,36,FlamengoAtletico-MG,0
1873,1873,6891,2020,1,9/8/2020,Gremio,Fluminense,2,3,0,0,2,3,0,5,5,24,16,40,GremioFluminense,0
1874,1874,6892,2020,1,30/9/2020,Corinthians,Atletico-GO,2,0,0,0,2,0,0,2,2,18,12,30,CorinthiansAtletico-GO,0
1875,1875,6893,2020,1,30/9/2020,Botafogo-RJ,Bahia,2,3,1,0,3,3,1,5,6,18,14,32,Botafogo-RJBahia,0
1876,1876,6894,2020,1,3/12/2020,Goias,Sao Paulo,3,0,0,0,3,0,0,3,3,16,19,35,GoiasSao Paulo,0
1877,1877,6895,2020,1,26/1/2021,Palmeiras,Vasco,1,1,0,0,1,1,0,2,2,19,11,30,PalmeirasVasco,0
1878,1878,6896,2020,2,12/8/2020,Athletico-PR,Goias,3,3,0,0,3,3,0,6,6,16,18,34,Athletico-PRGoias,0
1879,1879,6897,2020,2,12/8/2020,Atletico-MG,Corinthians,0,1,0,0,0,1,0,1,1,19,11,30,Atletico-MGCorinthians,0
1880,1880,6898,2020,2,12/8/2020,Bragantino,Botafogo-RJ,3,1,0,0,3,1,0,4,4,13,8,21,BragantinoBotafogo-RJ,0
1881,1881,6899,2020,2,12/8/2020,Bahia,Coritiba,0,5,0,0,0,5,0,5,5,16,18,34,BahiaCoritiba,0
1882,1882,6900,2020,2,12/8/2020,Atletico-GO,Flamengo,1,1,0,1,1,2,1,2,3,15,19,34,Atletico-GOFlamengo,0
1883,1883,6901,2020,2,12/8/2020,Ceara,Gremio,3,1,0,0,3,1,0,4,4,17,7,24,CearaGremio,0
1884,1884,6902,2020,2,12/8/2020,Fluminense,Palmeiras,3,3,0,0,3,3,0,6,6,20,31,51,FluminensePalmeiras,0
1885,1885,6903,2020,2,13/8/2020,Sao Paulo,Fortaleza,1,2,0,0,1,2,0,3,3,16,18,34,Sao PauloFortaleza,0
1886,1886,6904,2020,2,13/8/2020,Internacional,Santos,2,3,0,0,2,3,0,5,5,28,14,42,InternacionalSantos,0
1887,1887,6905,2020,2,13/8/2020,Vasco,Sport,2,3,0,1,2,4,1,5,6,29,17,46,VascoSport,0
1888,1888,6906,2020,3,15/8/2020,Gremio,Corinthians,2,3,0,0,2,3,0,5,5,16,14,30,GremioCorinthians,0
1889,1889,6907,2020,3,15/8/2020,Coritiba,Flamengo,5,3,1,0,6,3,1,8,9,25,16,41,CoritibaFlamengo,0
1890,1890,6908,2020,3,15/8/2020,Palmeiras,Goias,1,3,0,0,1,3,0,4,4,11,16,27,PalmeirasGoias,0
1891,1891,6909,2020,3,16/8/2020,Atletico-MG,Ceara,2,4,0,0,2,4,0,6,6,14,16,30,Atletico-MGCeara,0
1892,1892,6910,2020,3,16/8/2020,Bahia,Bragantino,1,1,0,0,1,1,0,2,2,16,16,32,BahiaBragantino,0
1893,1893,6911,2020,3,16/8/2020,Vasco,Sao Paulo,2,5,0,0,2,5,0,7,7,16,15,31,VascoSao Paulo,0
1894,1894,6912,2020,3,16/8/2020,Fluminense,Internacional,2,2,0,0,2,2,0,4,4,13,24,37,FluminenseInternacional,0
1895,1895,6913,2020,3,16/8/2020,Atletico-GO,Sport,1,2,1,0,2,2,1,3,4,13,15,28,Atletico-GOSport,0
1896,1896,6914,2020,3,16/8/2020,Fortaleza,Botafogo-RJ,2,1,0,0,2,1,0,3,3,9,8,17,FortalezaBotafogo-RJ,0
1897,1897,6915,2020,3,16/8/2020,Santos,Athletico-PR,1,1,0,0,1,1,0,2,2,9,22,31,SantosAthletico-PR,0
1898,1898,6916,2020,4,19/8/2020,Flamengo,Gremio,3,3,0,0,3,3,0,6,6,17,20,37,FlamengoGremio,0
1899,1899,6917,2020,4,19/8/2020,Bragantino,Fluminense,5,5,0,0,5,5,0,10,10,19,14,33,BragantinoFluminense,0
1900,1900,6918,2020,4,19/8/2020,Athletico-PR,Palmeiras,5,0,0,0,5,0,0,5,5,23,20,43,Athletico-PRPalmeiras,0
1901,1901,6919,2020,4,19/8/2020,Goias,Fortaleza,4,2,0,0,4,2,0,6,6,16,15,31,GoiasFortaleza,0
1902,1902,6920,2020,4,19/8/2020,Internacional,Atletico-GO,3,3,1,0,4,3,1,6,7,19,17,36,InternacionalAtletico-GO,0
1903,1903,6921,2020,4,19/8/2020,Corinthians,Coritiba,2,1,0,1,2,2,1,3,4,15,7,22,CorinthiansCoritiba,0
1904,1904,6922,2020,4,19/8/2020,Botafogo-RJ,Atletico-MG,2,0,0,0,2,0,0,2,2,9,10,19,Botafogo-RJAtletico-MG,0
1905,1905,6923,2020,4,20/8/2020,Sport,Santos,5,2,0,0,5,2,0,7,7,23,17,40,SportSantos,0
1906,1906,6924,2020,4,20/8/2020,Ceara,Vasco,3,3,0,0,3,3,0,6,6,18,14,32,CearaVasco,0
1907,1907,6925,2020,4,20/8/2020,Sao Paulo,Bahia,2,2,0,0,2,2,0,4,4,14,16,30,Sao PauloBahia,0
1908,1908,6926,2020,5,22/8/2020,Athletico-PR,Fluminense,4,3,0,0,4,3,0,7,7,21,12,33,Athletico-PRFluminense,0
1909,1909,6927,2020,5,22/8/2020,Internacional,Atletico-MG,1,2,0,0,1,2,0,3,3,20,21,41,InternacionalAtletico-MG,0
1910,1910,6928,2020,5,22/8/2020,Goias,Atletico-GO,5,2,0,0,5,2,0,7,7,26,19,45,GoiasAtletico-GO,1
1911,1911,6929,2020,5,23/8/2020,Flamengo,Botafogo-RJ,3,3,0,0,3,3,0,6,6,15,17,32,FlamengoBotafogo-RJ,1
1912,1912,6930,2020,5,23/8/2020,Vasco,Gremio,5,2,0,0,5,2,0,7,7,23,17,40,VascoGremio,0
1913,1913,6931,2020,5,23/8/2020,Palmeiras,Santos,5,3,0,1,5,4,1,8,9,21,15,36,PalmeirasSantos,1
1914,1914,6932,2020,5,23/8/2020,Bragantino,Coritiba,2,0,1,0,3,0,1,2,3,17,18,35,BragantinoCoritiba,0
1915,1915,6933,2020,5,23/8/2020,Sport,Sao Paulo,2,3,0,0,2,3,0,5,5,21,25,46,SportSao Paulo,0
1916,1916,6934,2020,5,23/8/2020,Ceara,Bahia,1,2,0,0,1,2,0,3,3,21,7,28,CearaBahia,0
1917,1917,6935,2020,5,26/8/2020,Corinthians,Fortaleza,0,2,0,0,0,2,0,2,2,14,12,26,CorinthiansFortaleza,0
1918,1918,6936,2020,11,26/8/2020,Sao Paulo,Athletico-PR,2,1,0,0,2,1,0,3,3,13,16,29,Sao PauloAthletico-PR,0
1919,1919,6937,2020,11,16/9/2020,Corinthians,Bahia,3,2,0,0,3,2,0,5,5,15,13,28,CorinthiansBahia,0
1920,1920,6938,2020,11,19/9/2020,Fortaleza,Internacional,1,3,0,0,1,3,0,4,4,9,20,29,FortalezaInternacional,0
1921,1921,6939,2020,11,19/9/2020,Bragantino,Ceara,4,3,0,0,4,3,0,7,7,24,11,35,BragantinoCeara,0
1922,1922,6940,2020,11,19/9/2020,Atletico-GO,Atletico-MG,2,0,0,0,2,0,0,2,2,16,14,30,Atletico-GOAtletico-MG,0
1923,1923,6941,2020,11,20/9/2020,Gremio,Palmeiras,2,3,0,0,2,3,0,5,5,21,21,42,GremioPalmeiras,0
1924,1924,6942,2020,11,20/9/2020,Coritiba,Vasco,1,2,0,0,1,2,0,3,3,14,15,29,CoritibaVasco,0
1925,1925,6943,2020,11,20/9/2020,Botafogo-RJ,Santos,4,2,0,0,4,2,0,6,6,15,13,28,Botafogo-RJSantos,0
1926,1926,6944,2020,11,20/9/2020,Sport,Fluminense,0,1,0,0,0,1,0,1,1,10,9,19,SportFluminense,0
1927,1927,6945,2020,11,13/10/2020,Flamengo,Goias,1,4,0,0,1,4,0,5,5,12,12,24,FlamengoGoias,0
1928,1928,6946,2020,6,29/8/2020,Botafogo-RJ,Internacional,3,1,0,0,3,1,0,4,4,14,24,38,Botafogo-RJInternacional,0
1929,1929,6947,2020,6,29/8/2020,Fluminense,Vasco,4,1,0,1,4,2,1,5,6,19,16,35,FluminenseVasco,1
1930,1930,6948,2020,6,29/8/2020,Bahia,Palmeiras,2,2,0,0,2,2,0,4,4,15,16,31,BahiaPalmeiras,0
1931,1931,6949,2020,6,29/8/2020,Fortaleza,Bragantino,2,2,0,1,2,3,1,4,5,22,10,32,FortalezaBragantino,0
1932,1932,6950,2020,6,30/8/2020,Sao Paulo,Corinthians,3,0,0,0,3,0,0,3,3,16,22,38,Sao PauloCorinthians,1
1933,1933,6951,2020,6,30/8/2020,Coritiba,Sport,1,4,0,0,1,4,0,5,5,14,19,33,CoritibaSport,0
1934,1934,6952,2020,6,30/8/2020,Santos,Flamengo,6,7,0,0,6,7,0,13,13,14,26,40,SantosFlamengo,0
1935,1935,6953,2020,6,30/8/2020,Atletico-GO,Ceara,1,2,1,0,2,2,1,3,4,16,11,27,Atletico-GOCeara,0
1936,1936,6954,2020,6,18/11/2020,Atletico-MG,Athletico-PR,1,2,0,0,1,2,0,3,3,8,24,32,Atletico-MGAthletico-PR,0
1937,1937,6955,2020,6,30/11/2020,Gremio,Goias,2,2,0,0,2,2,0,4,4,15,17,32,GremioGoias,0
1938,1938,6956,2020,7,2/9/2020,Ceara,Fortaleza,2,2,0,0,2,2,0,4,4,22,18,40,CearaFortaleza,1
1939,1939,6957,2020,7,2/9/2020,Fluminense,Atletico-GO,3,1,1,0,4,1,1,4,5,14,16,30,FluminenseAtletico-GO,0
1940,1940,6958,2020,7,2/9/2020,Goias,Corinthians,1,3,0,0,1,3,0,4,4,16,12,28,GoiasCorinthians,0
1941,1941,6959,2020,7,2/9/2020,Botafogo-RJ,Coritiba,1,1,0,0,1,1,0,2,2,23,21,44,Botafogo-RJCoritiba,0
1942,1942,6960,2020,7,2/9/2020,Athletico-PR,Bragantino,2,2,0,0,2,2,0,4,4,15,12,27,Athletico-PRBragantino,0
1943,1943,6961,2020,7,2/9/2020,Bahia,Flamengo,1,2,0,0,1,2,0,3,3,8,17,25,BahiaFlamengo,0
1944,1944,6962,2020,7,2/9/2020,Palmeiras,Internacional,3,5,0,0,3,5,0,8,8,21,23,44,PalmeirasInternacional,0
1945,1945,6963,2020,7,2/9/2020,Santos,Vasco,2,3,0,0,2,3,0,5,5,17,21,38,SantosVasco,0
1946,1946,6964,2020,7,3/9/2020,Gremio,Sport,1,5,0,0,1,5,0,6,6,10,11,21,GremioSport,0
3018,3018,6965,2020,7,3/9/2020,Atletico-MG,Sao Paulo,0,0,0,0,0,0,0,0,0,18,11,29,Atletico-MGSao Paulo,0
1947,1947,6966,2020,8,5/9/2020,Flamengo,Fortaleza,1,1,0,0,1,1,0,2,2,12,21,33,FlamengoFortaleza,0
1948,1948,6967,2020,8,5/9/2020,Corinthians,Botafogo-RJ,3,1,0,0,3,1,0,4,4,18,10,28,CorinthiansBotafogo-RJ,0
1949,1949,6968,2020,8,5/9/2020,Ceara,Santos,3,4,2,2,5,6,4,7,11,21,16,37,CearaSantos,0
1950,1950,6969,2020,8,6/9/2020,Bragantino,Palmeiras,1,3,1,0,2,3,1,4,5,23,12,35,BragantinoPalmeiras,1
1951,1951,6970,2020,8,6/9/2020,Internacional,Bahia,2,3,0,0,2,3,0,5,5,11,12,23,InternacionalBahia,0
1952,1952,6971,2020,8,6/9/2020,Sao Paulo,Fluminense,3,0,0,0,3,0,0,3,3,21,13,34,Sao PauloFluminense,0
1953,1953,6972,2020,8,6/9/2020,Vasco,Athletico-PR,1,1,0,0,1,1,0,2,2,7,16,23,VascoAthletico-PR,0
1954,1954,6973,2020,8,6/9/2020,Atletico-GO,Gremio,1,3,0,1,1,4,1,4,5,16,13,29,Atletico-GOGremio,0
1955,1955,6974,2020,8,6/9/2020,Sport,Goias,1,0,0,0,1,0,0,1,1,18,17,35,SportGoias,0
1956,1956,6975,2020,8,6/9/2020,Coritiba,Atletico-MG,1,3,0,0,1,3,0,4,4,14,19,33,CoritibaAtletico-MG,0
1957,1957,6976,2020,9,9/9/2020,Athletico-PR,Botafogo-RJ,1,0,0,0,1,0,0,1,1,19,10,29,Athletico-PRBotafogo-RJ,0
1958,1958,6977,2020,9,9/9/2020,Fortaleza,Sport,5,1,0,0,5,1,0,6,6,27,14,41,FortalezaSport,0
1959,1959,6978,2020,9,9/9/2020,Goias,Coritiba,5,2,1,1,6,3,2,7,9,27,13,40,GoiasCoritiba,0
1960,1960,6979,2020,9,9/9/2020,Sao Paulo,Bragantino,4,2,0,0,4,2,0,6,6,18,18,36,Sao PauloBragantino,1
1961,1961,6980,2020,9,9/9/2020,Fluminense,Flamengo,1,1,0,0,1,1,0,2,2,15,16,31,FluminenseFlamengo,1
1962,1962,6981,2020,9,9/9/2020,Santos,Atletico-MG,1,2,0,1,1,3,1,3,4,11,15,26,SantosAtletico-MG,0
1963,1963,6982,2020,9,10/9/2020,Internacional,Ceara,0,2,0,0,0,2,0,2,2,15,16,31,InternacionalCeara,0
1964,1964,6983,2020,9,10/9/2020,Corinthians,Palmeiras,3,2,2,0,5,2,2,5,7,13,16,29,CorinthiansPalmeiras,1
1965,1965,6984,2020,9,10/9/2020,Bahia,Gremio,1,3,1,1,2,4,2,4,6,12,9,21,BahiaGremio,0
1966,1966,6985,2020,9,10/9/2020,Vasco,Atletico-GO,2,1,1,0,3,1,1,3,4,15,23,38,VascoAtletico-GO,0
1967,1967,6986,2020,10,12/9/2020,Athletico-PR,Coritiba,4,1,0,1,4,2,1,5,6,21,12,33,Athletico-PRCoritiba,1
1968,1968,6987,2020,10,12/9/2020,Santos,Sao Paulo,3,2,0,0,3,2,0,5,5,18,20,38,SantosSao Paulo,1
1969,1969,6988,2020,10,13/9/2020,Fluminense,Corinthians,2,4,1,0,3,4,1,6,7,14,15,29,FluminenseCorinthians,0
1970,1970,6989,2020,10,13/9/2020,Gremio,Fortaleza,1,2,1,1,2,3,2,3,5,11,13,24,GremioFortaleza,0
1971,1971,6990,2020,10,13/9/2020,Atletico-MG,Bragantino,1,1,0,0,1,1,0,2,2,13,18,31,Atletico-MGBragantino,0
1972,1972,6991,2020,10,13/9/2020,Bahia,Atletico-GO,2,2,1,0,3,2,1,4,5,16,20,36,BahiaAtletico-GO,0
1973,1973,6992,2020,10,13/9/2020,Ceara,Flamengo,1,0,0,0,1,0,0,1,1,8,6,14,CearaFlamengo,0
1974,1974,6993,2020,10,13/9/2020,Goias,Internacional,4,3,1,0,5,3,1,7,8,10,14,24,GoiasInternacional,0
1975,1975,6994,2020,10,13/9/2020,Palmeiras,Sport,2,3,1,1,3,4,2,5,7,15,12,27,PalmeirasSport,0
1976,1976,6995,2020,10,13/9/2020,Botafogo-RJ,Vasco,2,2,0,0,2,2,0,4,4,18,8,26,Botafogo-RJVasco,1
1977,1977,6996,2020,12,23/9/2020,Sport,Corinthians,3,4,0,0,3,4,0,7,7,11,15,26,SportCorinthians,0
1978,1978,6997,2020,12,26/9/2020,Athletico-PR,Bahia,4,1,0,0,4,1,0,5,5,20,11,31,Athletico-PRBahia,0
1979,1979,6998,2020,12,26/9/2020,Internacional,Sao Paulo,2,0,1,0,3,0,1,2,3,16,16,32,InternacionalSao Paulo,0
1980,1980,6999,2020,12,26/9/2020,Atletico-MG,Gremio,1,1,0,0,1,1,0,2,2,20,11,31,Atletico-MGGremio,0
1981,1981,7000,2020,12,27/9/2020,Vasco,Bragantino,2,1,0,0,2,1,0,3,3,9,16,25,VascoBragantino,0
1982,1982,7001,2020,12,27/9/2020,Palmeiras,Flamengo,4,2,0,0,4,2,0,6,6,14,16,30,PalmeirasFlamengo,0
1983,1983,7002,2020,12,27/9/2020,Ceara,Goias,3,4,0,0,3,4,0,7,7,13,14,27,CearaGoias,0
1984,1984,7003,2020,12,27/9/2020,Atletico-GO,Botafogo-RJ,2,3,0,0,2,3,0,5,5,16,12,28,Atletico-GOBotafogo-RJ,0
1985,1985,7004,2020,12,27/9/2020,Santos,Fortaleza,1,1,0,0,1,1,0,2,2,12,20,32,SantosFortaleza,0
1986,1986,7005,2020,12,28/9/2020,Fluminense,Coritiba,1,1,0,1,1,2,1,2,3,16,19,35,FluminenseCoritiba,0
1987,1987,7006,2020,13,3/10/2020,Gremio,Internacional,1,1,1,1,2,2,2,2,4,15,16,31,GremioInternacional,1
1988,1988,7007,2020,13,3/10/2020,Palmeiras,Ceara,1,4,0,0,1,4,0,5,5,10,20,30,PalmeirasCeara,0
1989,1989,7008,2020,13,3/10/2020,Bragantino,Corinthians,1,2,0,0,1,2,0,3,3,18,13,31,BragantinoCorinthians,1
1990,1990,7009,2020,13,4/10/2020,Botafogo-RJ,Fluminense,0,1,0,0,0,1,0,1,1,20,21,41,Botafogo-RJFluminense,1
1991,1991,7010,2020,13,4/10/2020,Coritiba,Sao Paulo,2,3,0,0,2,3,0,5,5,13,12,25,CoritibaSao Paulo,0
1992,1992,7011,2020,13,4/10/2020,Flamengo,Athletico-PR,3,4,0,0,3,4,0,7,7,18,22,40,FlamengoAthletico-PR,0
1993,1993,7012,2020,13,4/10/2020,Fortaleza,Atletico-GO,5,5,0,0,5,5,0,10,10,8,14,22,FortalezaAtletico-GO,0
1994,1994,7013,2020,13,4/10/2020,Goias,Santos,4,3,1,1,5,4,2,7,9,16,15,31,GoiasSantos,0
1995,1995,7014,2020,13,4/10/2020,Bahia,Sport,2,3,0,0,2,3,0,5,5,15,13,28,BahiaSport,0
1996,1996,7015,2020,13,4/10/2020,Atletico-MG,Vasco,3,3,0,1,3,4,1,6,7,0,0,0,Atletico-MGVasco,0
1997,1997,7016,2020,14,7/10/2020,Corinthians,Santos,2,2,0,0,2,2,0,4,4,19,16,35,CorinthiansSantos,1
1998,1998,7017,2020,14,7/10/2020,Flamengo,Sport,0,3,0,0,0,3,0,3,3,14,16,30,FlamengoSport,0
1999,1999,7018,2020,14,7/10/2020,Bahia,Vasco,4,3,0,1,4,4,1,7,8,18,15,33,BahiaVasco,0
2000,2000,7019,2020,14,7/10/2020,Gremio,Coritiba,2,2,0,0,2,2,0,4,4,18,21,39,GremioCoritiba,0
2001,2001,7020,2020,14,7/10/2020,Sao Paulo,Atletico-GO,3,2,0,0,3,2,0,5,5,17,12,29,Sao PauloAtletico-GO,0
2002,2002,7021,2020,14,7/10/2020,Goias,Fluminense,3,2,0,0,3,2,0,5,5,19,15,34,GoiasFluminense,0
2003,2003,7022,2020,14,7/10/2020,Botafogo-RJ,Palmeiras,4,4,0,0,4,4,0,8,8,16,15,31,Botafogo-RJPalmeiras,0
2004,2004,7023,2020,14,7/10/2020,Fortaleza,Atletico-MG,3,3,1,0,4,3,1,6,7,9,19,28,FortalezaAtletico-MG,0
2005,2005,7024,2020,14,8/10/2020,Athletico-PR,Ceara,3,2,0,0,3,2,0,5,5,11,12,23,Athletico-PRCeara,0
2006,2006,7025,2020,14,8/10/2020,Bragantino,Internacional,3,3,1,0,4,3,1,6,7,18,22,40,BragantinoInternacional,0
2007,2007,7026,2020,15,10/10/2020,Vasco,Flamengo,2,5,0,0,2,5,0,7,7,14,25,39,VascoFlamengo,1
2008,2008,7027,2020,15,10/10/2020,Coritiba,Fortaleza,1,0,0,0,1,0,0,1,1,20,12,32,CoritibaFortaleza,0
2009,2009,7028,2020,15,10/10/2020,Palmeiras,Sao Paulo,2,1,0,0,2,1,0,3,3,15,17,32,PalmeirasSao Paulo,1
2010,2010,7029,2020,15,10/10/2020,Atletico-MG,Goias,0,1,0,0,0,1,0,1,1,14,11,25,Atletico-MGGoias,0
2011,2011,7030,2020,15,11/10/2020,Fluminense,Bahia,2,3,0,0,2,3,0,5,5,26,18,44,FluminenseBahia,0
2012,2012,7031,2020,15,11/10/2020,Santos,Gremio,2,3,0,1,2,4,1,5,6,17,14,31,SantosGremio,0
2013,2013,7032,2020,15,11/10/2020,Sport,Botafogo-RJ,3,2,0,1,3,3,1,5,6,11,15,26,SportBotafogo-RJ,0
2014,2014,7033,2020,15,11/10/2020,Atletico-GO,Bragantino,1,1,0,0,1,1,0,2,2,17,18,35,Atletico-GOBragantino,0
2015,2015,7034,2020,15,11/10/2020,Ceara,Corinthians,4,1,1,1,5,2,2,5,7,9,10,19,CearaCorinthians,0
2016,2016,7035,2020,15,11/10/2020,Internacional,Athletico-PR,2,0,0,0,2,0,0,2,2,19,14,33,InternacionalAthletico-PR,0
2017,2017,7036,2020,16,14/10/2020,Palmeiras,Coritiba,3,2,0,0,3,2,0,5,5,13,20,33,PalmeirasCoritiba,0
2018,2018,7037,2020,16,14/10/2020,Gremio,Botafogo-RJ,3,2,1,0,4,2,1,5,6,11,13,24,GremioBotafogo-RJ,0
2019,2019,7038,2020,16,14/10/2020,Santos,Atletico-GO,3,3,0,0,3,3,0,6,6,18,21,39,SantosAtletico-GO,0
2020,2020,7039,2020,16,14/10/2020,Athletico-PR,Corinthians,3,3,0,1,3,4,1,6,7,18,14,32,Athletico-PRCorinthians,0
2021,2021,7040,2020,16,14/10/2020,Atletico-MG,Fluminense,3,1,0,0,3,1,0,4,4,11,9,20,Atletico-MGFluminense,0
2022,2022,7041,2020,16,14/10/2020,Sport,Internacional,3,2,0,0,3,2,0,5,5,6,19,25,SportInternacional,0
2023,2023,7042,2020,16,15/10/2020,Flamengo,Bragantino,2,1,0,0,2,1,0,3,3,16,14,30,FlamengoBragantino,0
2024,2024,7043,2020,16,16/10/2020,Goias,Bahia,5,4,0,2,5,6,2,9,11,16,18,34,GoiasBahia,0
2025,2025,7044,2020,16,19/11/2020,Vasco,Fortaleza,2,0,0,0,2,0,0,2,2,11,20,31,VascoFortaleza,0
2026,2026,7045,2020,16,25/11/2020,Ceara,Sao Paulo,5,3,0,0,5,3,0,8,8,20,13,33,CearaSao Paulo,0
2027,2027,7046,2020,17,17/10/2020,Atletico-GO,Athletico-PR,3,5,2,0,5,5,2,8,10,10,20,30,Atletico-GOAthletico-PR,0
2028,2028,7047,2020,17,17/10/2020,Coritiba,Santos,5,2,0,0,5,2,0,7,7,18,25,43,CoritibaSantos,0
2029,2029,7048,2020,17,17/10/2020,Fluminense,Ceara,3,3,0,0,3,3,0,6,6,17,16,33,FluminenseCeara,0
2030,2030,7049,2020,17,17/10/2020,Sao Paulo,Gremio,4,2,0,0,4,2,0,6,6,24,15,39,Sao PauloGremio,0
2031,2031,7050,2020,17,18/10/2020,Corinthians,Flamengo,4,5,0,0,4,5,0,9,9,14,13,27,CorinthiansFlamengo,0
2032,2032,7051,2020,17,18/10/2020,Internacional,Vasco,1,1,0,0,1,1,0,2,2,17,11,28,InternacionalVasco,0
2033,2033,7052,2020,17,18/10/2020,Bragantino,Sport,2,2,0,0,2,2,0,4,4,13,13,26,BragantinoSport,0
2034,2034,7053,2020,17,18/10/2020,Fortaleza,Palmeiras,2,3,0,1,2,4,1,5,6,14,19,33,FortalezaPalmeiras,0
2035,2035,7054,2020,17,19/10/2020,Bahia,Atletico-MG,4,1,0,0,4,1,0,5,5,14,14,28,BahiaAtletico-MG,0
2036,2036,7055,2020,17,19/10/2020,Botafogo-RJ,Goias,2,1,0,0,2,1,0,3,3,18,11,29,Botafogo-RJGoias,0
2037,2037,7056,2020,18,21/10/2020,Vasco,Corinthians,1,2,0,0,1,2,0,3,3,12,18,30,VascoCorinthians,0
2038,2038,7057,2020,18,24/10/2020,Bragantino,Goias,0,3,0,0,0,3,0,3,3,17,15,32,BragantinoGoias,0
2039,2039,7058,2020,18,24/10/2020,Ceara,Coritiba,3,1,0,0,3,1,0,4,4,22,12,34,CearaCoritiba,0
2040,2040,7059,2020,18,24/10/2020,Atletico-MG,Sport,1,0,0,0,1,0,0,1,1,10,11,21,Atletico-MGSport,0
2041,2041,7060,2020,18,25/10/2020,Atletico-GO,Palmeiras,1,4,0,0,1,4,0,5,5,15,17,32,Atletico-GOPalmeiras,0
2042,2042,7061,2020,18,25/10/2020,Fluminense,Santos,5,4,0,0,5,4,0,9,9,13,18,31,FluminenseSantos,0
2043,2043,7062,2020,18,25/10/2020,Athletico-PR,Gremio,3,1,0,0,3,1,0,4,4,15,11,26,Athletico-PRGremio,0
2044,2044,7063,2020,18,25/10/2020,Internacional,Flamengo,6,5,0,0,6,5,0,11,11,16,16,32,InternacionalFlamengo,0
2045,2045,7064,2020,18,11/11/2020,Bahia,Fortaleza,3,3,0,0,3,3,0,6,6,14,11,25,BahiaFortaleza,0
2046,2046,7065,2020,18,9/12/2020,Sao Paulo,Botafogo-RJ,0,2,0,1,0,3,1,2,3,12,8,20,Sao PauloBotafogo-RJ,0
2047,2047,7066,2020,19,31/10/2020,Botafogo-RJ,Ceara,4,5,1,1,5,6,2,9,11,17,19,36,Botafogo-RJCeara,0
2048,2048,7067,2020,19,31/10/2020,Coritiba,Atletico-GO,2,5,0,0,2,5,0,7,7,22,18,40,CoritibaAtletico-GO,0
2049,2049,7068,2020,19,31/10/2020,Corinthians,Internacional,4,3,0,1,4,4,1,7,8,16,13,29,CorinthiansInternacional,0
2050,2050,7069,2020,19,31/10/2020,Fortaleza,Fluminense,2,1,1,0,3,1,1,3,4,14,18,32,FortalezaFluminense,0
2051,2051,7070,2020,19,1/11/2020,Flamengo,Sao Paulo,4,3,0,0,4,3,0,7,7,18,18,36,FlamengoSao Paulo,0
2052,2052,7071,2020,19,1/11/2020,Sport,Athletico-PR,2,1,1,0,3,1,1,3,4,17,15,32,SportAthletico-PR,0
2053,2053,7072,2020,19,1/11/2020,Santos,Bahia,4,2,0,0,4,2,0,6,6,19,13,32,SantosBahia,0
2054,2054,7073,2020,19,1/11/2020,Goias,Vasco,5,7,0,0,5,7,0,12,12,16,20,36,GoiasVasco,0
2055,2055,7074,2020,19,2/11/2020,Palmeiras,Atletico-MG,2,1,0,0,2,1,0,3,3,10,12,22,PalmeirasAtletico-MG,0
2056,2056,7075,2020,19,2/11/2020,Gremio,Bragantino,1,1,0,0,1,1,0,2,2,13,12,25,GremioBragantino,0
2057,2057,7076,2020,20,7/11/2020,Athletico-PR,Fortaleza,3,2,0,0,3,2,0,5,5,20,14,34,Athletico-PRFortaleza,0
2058,2058,7077,2020,20,7/11/2020,Sao Paulo,Goias,2,1,0,1,2,2,1,3,4,9,19,28,Sao PauloGoias,0
2059,2059,7078,2020,20,7/11/2020,Atletico-GO,Corinthians,3,4,0,0,3,4,0,7,7,22,25,47,Atletico-GOCorinthians,0
2060,2060,7079,2020,20,8/11/2020,Vasco,Palmeiras,1,3,0,0,1,3,0,4,4,17,19,36,VascoPalmeiras,0
2061,2061,7080,2020,20,8/11/2020,Internacional,Coritiba,2,3,1,0,3,3,1,5,6,9,13,22,InternacionalCoritiba,0
2062,2062,7081,2020,20,8/11/2020,Bragantino,Santos,1,4,0,0,1,4,0,5,5,15,20,35,BragantinoSantos,1
2063,2063,7082,2020,20,8/11/2020,Atletico-MG,Flamengo,5,4,0,0,5,4,0,9,9,21,13,34,Atletico-MGFlamengo,0
2064,2064,7083,2020,20,8/11/2020,Bahia,Botafogo-RJ,2,3,0,0,2,3,0,5,5,19,17,36,BahiaBotafogo-RJ,0
2065,2065,7084,2020,20,8/11/2020,Fluminense,Gremio,0,1,0,0,0,1,0,1,1,12,13,25,FluminenseGremio,0
2066,2066,7085,2020,20,8/11/2020,Ceara,Sport,0,3,0,0,0,3,0,3,3,17,13,30,CearaSport,0
2067,2067,7086,2020,21,14/11/2020,Sport,Vasco,0,2,0,0,0,2,0,2,2,14,21,35,SportVasco,0
2068,2068,7087,2020,21,14/11/2020,Santos,Internacional,1,2,0,0,1,2,0,3,3,24,18,42,SantosInternacional,0
2069,2069,7088,2020,21,14/11/2020,Goias,Athletico-PR,5,1,0,0,5,1,0,6,6,14,12,26,GoiasAthletico-PR,0
2070,2070,7089,2020,21,14/11/2020,Corinthians,Atletico-MG,3,5,0,0,3,5,0,8,8,29,11,40,CorinthiansAtletico-MG,0
2071,2071,7090,2020,21,14/11/2020,Fortaleza,Sao Paulo,2,4,0,0,2,4,0,6,6,15,18,33,FortalezaSao Paulo,0
2072,2072,7091,2020,21,14/11/2020,Gremio,Ceara,1,2,0,0,1,2,0,3,3,8,14,22,GremioCeara,0
2073,2073,7092,2020,21,14/11/2020,Palmeiras,Fluminense,2,2,0,0,2,2,0,4,4,15,8,23,PalmeirasFluminense,0
2074,2074,7093,2020,21,14/11/2020,Flamengo,Atletico-GO,2,1,0,0,2,1,0,3,3,15,16,31,FlamengoAtletico-GO,0
2075,2075,7094,2020,21,16/11/2020,Coritiba,Bahia,3,4,0,0,3,4,0,7,7,12,12,24,CoritibaBahia,0
2076,2076,7095,2020,21,16/11/2020,Botafogo-RJ,Bragantino,0,3,0,0,0,3,0,3,3,16,18,34,Botafogo-RJBragantino,0
2077,2077,7096,2020,22,20/11/2020,Bragantino,Bahia,2,4,0,0,2,4,0,6,6,16,13,29,BragantinoBahia,0
2078,2078,7097,2020,22,21/11/2020,Athletico-PR,Santos,0,2,0,0,0,2,0,2,2,22,13,35,Athletico-PRSantos,0
2079,2079,7098,2020,22,21/11/2020,Flamengo,Coritiba,1,3,0,0,1,3,0,4,4,16,18,34,FlamengoCoritiba,0
2080,2080,7099,2020,22,21/11/2020,Goias,Palmeiras,2,2,0,1,2,3,1,4,5,20,15,35,GoiasPalmeiras,0
2081,2081,7100,2020,22,22/11/2020,Sao Paulo,Vasco,2,4,0,0,2,4,0,6,6,7,19,26,Sao PauloVasco,0
2082,2082,7101,2020,22,22/11/2020,Ceara,Atletico-MG,4,1,0,1,4,2,1,5,6,11,12,23,CearaAtletico-MG,0
2083,2083,7102,2020,22,22/11/2020,Internacional,Fluminense,2,4,0,0,2,4,0,6,6,20,20,40,InternacionalFluminense,0
2084,2084,7103,2020,22,22/11/2020,Botafogo-RJ,Fortaleza,1,1,0,0,1,1,0,2,2,18,15,33,Botafogo-RJFortaleza,0
2085,2085,7104,2020,22,22/11/2020,Corinthians,Gremio,2,1,2,0,4,1,2,3,5,12,14,26,CorinthiansGremio,0
2086,2086,7105,2020,22,23/11/2020,Sport,Atletico-GO,1,3,0,0,1,3,0,4,4,17,16,33,SportAtletico-GO,0
2087,2087,7106,2020,23,25/11/2020,Atletico-MG,Botafogo-RJ,2,4,0,0,2,4,0,6,6,25,19,44,Atletico-MGBotafogo-RJ,0
2088,2088,7107,2020,23,25/11/2020,Coritiba,Corinthians,2,2,0,0,2,2,0,4,4,13,25,38,CoritibaCorinthians,0
2089,2089,7108,2020,23,26/11/2020,Fortaleza,Goias,2,0,0,0,2,0,0,2,2,17,19,36,FortalezaGoias,0
2090,2090,7109,2020,23,28/11/2020,Palmeiras,Athletico-PR,2,1,0,0,2,1,0,3,3,16,15,31,PalmeirasAthletico-PR,0
2091,2091,7110,2020,23,28/11/2020,Santos,Sport,3,3,0,0,3,3,0,6,6,17,24,41,SantosSport,0
2092,2092,7111,2020,23,28/11/2020,Bahia,Sao Paulo,0,2,0,0,0,2,0,2,2,12,15,27,BahiaSao Paulo,0
2093,2093,7112,2020,23,28/11/2020,Atletico-GO,Internacional,1,3,0,1,1,4,1,4,5,19,18,37,Atletico-GOInternacional,0
2094,2094,7113,2020,23,30/11/2020,Vasco,Ceara,3,2,0,0,3,2,0,5,5,15,18,33,VascoCeara,0
2095,2095,7114,2020,23,30/11/2020,Fluminense,Bragantino,2,3,0,0,2,3,0,5,5,15,21,36,FluminenseBragantino,0
2096,2096,7115,2020,23,28/1/2021,Gremio,Flamengo,5,3,0,0,5,3,0,8,8,15,24,39,GremioFlamengo,0
2097,2097,7116,2020,24,2/12/2020,Fortaleza,Corinthians,2,2,1,1,3,3,2,4,6,12,15,27,FortalezaCorinthians,0
2098,2098,7117,2020,24,5/12/2020,Santos,Palmeiras,3,3,0,1,3,4,1,6,7,14,16,30,SantosPalmeiras,1
2099,2099,7118,2020,24,5/12/2020,Botafogo-RJ,Flamengo,1,1,1,1,2,2,2,2,4,16,26,42,Botafogo-RJFlamengo,1
2100,2100,7119,2020,24,5/12/2020,Fluminense,Athletico-PR,4,3,0,1,4,4,1,7,8,16,18,34,FluminenseAthletico-PR,0
2101,2101,7120,2020,24,5/12/2020,Bahia,Ceara,2,2,0,0,2,2,0,4,4,12,17,29,BahiaCeara,0
2102,2102,7121,2020,24,5/12/2020,Coritiba,Bragantino,4,3,0,0,4,3,0,7,7,17,26,43,CoritibaBragantino,0
2103,2103,7122,2020,24,6/12/2020,Sao Paulo,Sport,4,4,0,0,4,4,0,8,8,17,17,34,Sao PauloSport,0
2104,2104,7123,2020,24,6/12/2020,Gremio,Vasco,2,1,0,0,2,1,0,3,3,9,8,17,GremioVasco,0
2105,2105,7124,2020,24,6/12/2020,Atletico-MG,Internacional,2,6,0,0,2,6,0,8,8,18,14,32,Atletico-MGInternacional,0
2106,2106,7125,2020,24,7/12/2020,Atletico-GO,Goias,3,3,0,0,3,3,0,6,6,17,21,38,Atletico-GOGoias,1
2107,2107,7126,2020,25,12/12/2020,Athletico-PR,Atletico-MG,2,2,0,0,2,2,0,4,4,20,13,33,Athletico-PRAtletico-MG,0
2108,2108,7127,2020,25,12/12/2020,Bragantino,Fortaleza,3,2,0,0,3,2,0,5,5,17,18,35,BragantinoFortaleza,0
2109,2109,7128,2020,25,12/12/2020,Internacional,Botafogo-RJ,4,5,0,0,4,5,0,9,9,23,19,42,InternacionalBotafogo-RJ,0
2110,2110,7129,2020,25,12/12/2020,Palmeiras,Bahia,2,3,0,0,2,3,0,5,5,11,20,31,PalmeirasBahia,0
2111,2111,7130,2020,25,12/12/2020,Goias,Gremio,4,1,0,0,4,1,0,5,5,12,10,22,GoiasGremio,0
2112,2112,7131,2020,25,12/12/2020,Ceara,Atletico-GO,0,3,0,0,0,3,0,3,3,13,15,28,CearaAtletico-GO,0
2113,2113,7132,2020,25,13/12/2020,Flamengo,Santos,2,1,0,0,2,1,0,3,3,12,11,23,FlamengoSantos,0
2114,2114,7133,2020,25,13/12/2020,Corinthians,Sao Paulo,0,1,0,0,0,1,0,1,1,12,8,20,CorinthiansSao Paulo,1
2115,2115,7134,2020,25,13/12/2020,Sport,Coritiba,0,1,0,0,0,1,0,1,1,20,14,34,SportCoritiba,0
2116,2116,7135,2020,25,13/12/2020,Vasco,Fluminense,6,2,0,0,6,2,0,8,8,21,14,35,VascoFluminense,1
2117,2117,7136,2020,26,16/12/2020,Sao Paulo,Atletico-MG,2,3,0,1,2,4,1,5,6,9,10,19,Sao PauloAtletico-MG,0
2118,2118,7137,2020,26,16/12/2020,Atletico-GO,Fluminense,3,4,0,0,3,4,0,7,7,17,18,35,Atletico-GOFluminense,0
2119,2119,7138,2020,26,19/12/2020,Sport,Gremio,2,2,0,1,2,3,1,4,5,21,9,30,SportGremio,0
2120,2120,7139,2020,26,19/12/2020,Internacional,Palmeiras,4,2,0,0,4,2,0,6,6,13,23,36,InternacionalPalmeiras,0
2121,2121,7140,2020,26,19/12/2020,Coritiba,Botafogo-RJ,3,1,0,0,3,1,0,4,4,14,18,32,CoritibaBotafogo-RJ,0
2122,2122,7141,2020,26,20/12/2020,Bragantino,Athletico-PR,2,5,0,0,2,5,0,7,7,8,17,25,BragantinoAthletico-PR,0
2123,2123,7142,2020,26,20/12/2020,Vasco,Santos,2,0,0,0,2,0,0,2,2,26,15,41,VascoSantos,0
2124,2124,7143,2020,26,20/12/2020,Flamengo,Bahia,1,3,1,1,2,4,2,4,6,17,22,39,FlamengoBahia,0
2125,2125,7144,2020,26,20/12/2020,Fortaleza,Ceara,1,1,1,0,2,1,1,2,3,18,17,35,FortalezaCeara,1
2126,2126,7145,2020,26,21/12/2020,Corinthians,Goias,1,0,0,0,1,0,0,1,1,11,15,26,CorinthiansGoias,0
3019,3019,7146,2020,27,26/12/2020,Atletico-MG,Coritiba,0,0,0,0,0,0,0,0,0,15,13,28,Atletico-MGCoritiba,0
2127,2127,7147,2020,27,26/12/2020,Goias,Sport,4,1,0,0,4,1,0,5,5,22,18,40,GoiasSport,0
2128,2128,7148,2020,27,26/12/2020,Fortaleza,Flamengo,3,3,0,0,3,3,0,6,6,22,14,36,FortalezaFlamengo,0
2129,2129,7149,2020,27,26/12/2020,Fluminense,Sao Paulo,3,1,0,0,3,1,0,4,4,17,22,39,FluminenseSao Paulo,0
2130,2130,7150,2020,27,27/12/2020,Botafogo-RJ,Corinthians,1,1,0,0,1,1,0,2,2,19,20,39,Botafogo-RJCorinthians,0
2131,2131,7151,2020,27,27/12/2020,Bahia,Internacional,3,1,0,0,3,1,0,4,4,18,12,30,BahiaInternacional,0
2132,2132,7152,2020,27,27/12/2020,Athletico-PR,Vasco,0,1,0,0,0,1,0,1,1,14,11,25,Athletico-PRVasco,0
2133,2133,7153,2020,27,27/12/2020,Palmeiras,Bragantino,3,0,0,0,3,0,0,3,3,10,6,16,PalmeirasBragantino,1
2134,2134,7154,2020,27,27/12/2020,Santos,Ceara,2,3,0,0,2,3,0,5,5,15,24,39,SantosCeara,0
2135,2135,7155,2020,27,27/12/2020,Gremio,Atletico-GO,2,3,0,0,2,3,0,5,5,11,15,26,GremioAtletico-GO,0
2136,2136,7156,2020,28,6/1/2021,Gremio,Bahia,2,4,0,0,2,4,0,6,6,11,17,28,GremioBahia,0
2137,2137,7157,2020,28,6/1/2021,Botafogo-RJ,Athletico-PR,3,2,0,0,3,2,0,5,5,14,21,35,Botafogo-RJAthletico-PR,0
2138,2138,7158,2020,28,6/1/2021,Coritiba,Goias,4,3,0,0,4,3,0,7,7,13,17,30,CoritibaGoias,0
2139,2139,7159,2020,28,6/1/2021,Sport,Fortaleza,3,1,0,0,3,1,0,4,4,14,12,26,SportFortaleza,0
2140,2140,7160,2020,28,6/1/2021,Flamengo,Fluminense,1,4,0,0,1,4,0,5,5,12,22,34,FlamengoFluminense,0
2141,2141,7161,2020,28,6/1/2021,Bragantino,Sao Paulo,2,2,0,1,2,3,1,4,5,17,4,21,BragantinoSao Paulo,1
2142,2142,7162,2020,28,7/1/2021,Ceara,Internacional,6,4,0,0,6,4,0,10,10,18,16,34,CearaInternacional,0
2143,2143,7163,2020,28,7/1/2021,Atletico-GO,Vasco,3,2,0,0,3,2,0,5,5,19,17,36,Atletico-GOVasco,0
2144,2144,7164,2020,28,18/1/2021,Palmeiras,Corinthians,2,3,0,1,2,4,1,5,6,14,11,25,PalmeirasCorinthians,1
2145,2145,7165,2020,28,26/1/2021,Atletico-MG,Santos,1,1,0,0,1,1,0,2,2,10,14,24,Atletico-MGSantos,0
2146,2146,7166,2020,29,9/1/2021,Sport,Palmeiras,5,3,0,0,5,3,0,8,8,15,21,36,SportPalmeiras,0
2147,2147,7167,2020,29,9/1/2021,Coritiba,Athletico-PR,2,1,0,0,2,1,0,3,3,11,10,21,CoritibaAthletico-PR,1
2148,2148,7168,2020,29,9/1/2021,Fortaleza,Gremio,4,2,0,0,4,2,0,6,6,17,12,29,FortalezaGremio,0
2149,2149,7169,2020,29,10/1/2021,Sao Paulo,Santos,2,4,0,0,2,4,0,6,6,19,21,40,Sao PauloSantos,1
2150,2150,7170,2020,29,10/1/2021,Flamengo,Ceara,3,1,0,0,3,1,0,4,4,10,12,22,FlamengoCeara,0
2151,2151,7171,2020,29,10/1/2021,Atletico-GO,Bahia,2,0,0,0,2,0,0,2,2,20,18,38,Atletico-GOBahia,0
2152,2152,7172,2020,29,10/1/2021,Internacional,Goias,0,2,0,0,0,2,0,2,2,14,14,28,InternacionalGoias,0
2153,2153,7173,2020,29,10/1/2021,Vasco,Botafogo-RJ,1,0,0,0,1,0,0,1,1,11,13,24,VascoBotafogo-RJ,1
2154,2154,7174,2020,29,11/1/2021,Bragantino,Atletico-MG,4,0,0,0,4,0,0,4,4,15,11,26,BragantinoAtletico-MG,0
2155,2155,7175,2020,29,13/1/2021,Corinthians,Fluminense,1,2,0,0,1,2,0,3,3,17,15,32,CorinthiansFluminense,0
2156,2156,7176,2020,30,15/1/2021,Palmeiras,Gremio,3,1,0,0,3,1,0,4,4,22,10,32,PalmeirasGremio,0
2157,2157,7177,2020,30,16/1/2021,Fluminense,Sport,1,1,0,1,1,2,1,2,3,23,18,41,FluminenseSport,0
2158,2158,7178,2020,30,16/1/2021,Vasco,Coritiba,2,2,1,0,3,2,1,4,5,10,13,23,VascoCoritiba,0
2159,2159,7179,2020,30,17/1/2021,Athletico-PR,Sao Paulo,2,1,0,0,2,1,0,3,3,10,14,24,Athletico-PRSao Paulo,0
2160,2160,7180,2020,30,17/1/2021,Santos,Botafogo-RJ,2,1,0,0,2,1,0,3,3,8,24,32,SantosBotafogo-RJ,0
2161,2161,7181,2020,30,17/1/2021,Atletico-MG,Atletico-GO,2,3,0,0,2,3,0,5,5,13,14,27,Atletico-MGAtletico-GO,0
2162,2162,7182,2020,30,17/1/2021,Ceara,Bragantino,1,2,0,0,1,2,0,3,3,13,16,29,CearaBragantino,0
2163,2163,7183,2020,30,17/1/2021,Internacional,Fortaleza,0,3,0,0,0,3,0,3,3,24,17,41,InternacionalFortaleza,0
2164,2164,7184,2020,30,18/1/2021,Goias,Flamengo,5,1,0,0,5,1,0,6,6,24,13,37,GoiasFlamengo,0
2165,2165,7185,2020,30,28/1/2021,Bahia,Corinthians,3,1,0,0,3,1,0,4,4,24,19,43,BahiaCorinthians,0
2166,2166,7186,2020,31,20/1/2021,Botafogo-RJ,Atletico-GO,2,3,0,0,2,3,0,5,5,17,14,31,Botafogo-RJAtletico-GO,0
2167,2167,7187,2020,31,20/1/2021,Bahia,Athletico-PR,2,0,0,0,2,0,0,2,2,15,14,29,BahiaAthletico-PR,0
2168,2168,7188,2020,31,20/1/2021,Gremio,Atletico-MG,1,1,0,0,1,1,0,2,2,11,7,18,GremioAtletico-MG,0
2169,2169,7189,2020,31,20/1/2021,Coritiba,Fluminense,1,4,1,1,2,5,2,5,7,21,10,31,CoritibaFluminense,0
2170,2170,7190,2020,31,20/1/2021,Sao Paulo,Internacional,2,1,0,0,2,1,0,3,3,15,19,34,Sao PauloInternacional,0
3020,3020,7191,2020,31,20/1/2021,Bragantino,Vasco,0,0,0,0,0,0,0,0,0,12,17,29,BragantinoVasco,0
2171,2171,7192,2020,31,21/1/2021,Flamengo,Palmeiras,2,2,0,0,2,2,0,4,4,26,15,41,FlamengoPalmeiras,0
2172,2172,7193,2020,31,21/1/2021,Fortaleza,Santos,3,0,0,0,3,0,0,3,3,20,14,34,FortalezaSantos,0
2173,2173,7194,2020,31,21/1/2021,Goias,Ceara,1,0,0,0,1,0,0,1,1,12,11,23,GoiasCeara,0
2174,2174,7195,2020,31,21/1/2021,Corinthians,Sport,1,0,0,0,1,0,0,1,1,9,7,16,CorinthiansSport,0
2175,2175,7196,2020,32,23/1/2021,Sao Paulo,Coritiba,1,2,0,0,1,2,0,3,3,19,16,35,Sao PauloCoritiba,0
2176,2176,7197,2020,32,23/1/2021,Vasco,Atletico-MG,4,1,0,0,4,1,0,5,5,15,11,26,VascoAtletico-MG,0
2177,2177,7198,2020,32,24/1/2021,Internacional,Gremio,2,2,0,0,2,2,0,4,4,19,15,34,InternacionalGremio,1
2178,2178,7199,2020,32,24/1/2021,Athletico-PR,Flamengo,2,0,0,0,2,0,0,2,2,20,11,31,Athletico-PRFlamengo,0
2179,2179,7200,2020,32,24/1/2021,Ceara,Palmeiras,3,5,1,0,4,5,1,8,9,9,16,25,CearaPalmeiras,0
2180,2180,7201,2020,32,24/1/2021,Atletico-GO,Fortaleza,2,2,0,1,2,3,1,4,5,12,13,25,Atletico-GOFortaleza,0
2181,2181,7202,2020,32,24/1/2021,Sport,Bahia,3,0,0,0,3,0,0,3,3,16,8,24,SportBahia,0
2182,2182,7203,2020,32,24/1/2021,Santos,Goias,4,4,0,0,4,4,0,8,8,11,19,30,SantosGoias,0
2183,2183,7204,2020,32,24/1/2021,Fluminense,Botafogo-RJ,2,1,0,0,2,1,0,3,3,20,20,40,FluminenseBotafogo-RJ,1
2184,2184,7205,2020,32,25/1/2021,Corinthians,Bragantino,5,4,0,0,5,4,0,9,9,16,14,30,CorinthiansBragantino,1
2185,2185,7206,2020,33,31/1/2021,Vasco,Bahia,1,3,1,0,2,3,1,4,5,15,16,31,VascoBahia,0
2186,2186,7207,2020,33,31/1/2021,Ceara,Athletico-PR,0,2,0,0,0,2,0,2,2,15,18,33,CearaAthletico-PR,0
2187,2187,7208,2020,33,31/1/2021,Atletico-GO,Sao Paulo,3,1,0,0,3,1,0,4,4,13,9,22,Atletico-GOSao Paulo,0
2188,2188,7209,2020,33,31/1/2021,Coritiba,Gremio,3,3,0,0,3,3,0,6,6,26,12,38,CoritibaGremio,0
2189,2189,7210,2020,33,31/1/2021,Atletico-MG,Fortaleza,0,1,0,0,0,1,0,1,1,16,15,31,Atletico-MGFortaleza,0
2190,2190,7211,2020,33,31/1/2021,Internacional,Bragantino,3,0,0,0,3,0,0,3,3,11,12,23,InternacionalBragantino,0
2191,2191,7212,2020,33,31/1/2021,Fluminense,Goias,1,2,0,0,1,2,0,3,3,9,15,24,FluminenseGoias,0
2192,2192,7213,2020,33,1/2/2021,Sport,Flamengo,2,2,0,0,2,2,0,4,4,15,20,35,SportFlamengo,0
2193,2193,7214,2020,33,2/2/2021,Palmeiras,Botafogo-RJ,2,1,0,0,2,1,0,3,3,16,10,26,PalmeirasBotafogo-RJ,0
3023,3023,7215,2020,33,17/2/2021,Santos,Corinthians,0,0,0,0,0,0,0,0,0,24,25,49,SantosCorinthians,1
2194,2194,7216,2020,34,3/2/2021,Gremio,Santos,5,2,0,1,5,3,1,7,8,12,20,32,GremioSantos,0
2195,2195,7217,2020,34,3/2/2021,Bragantino,Atletico-GO,3,3,0,0,3,3,0,6,6,15,7,22,BragantinoAtletico-GO,0
3021,3021,7218,2020,34,3/2/2021,Corinthians,Ceara,0,0,0,0,0,0,0,0,0,18,14,32,CorinthiansCeara,0
2196,2196,7219,2020,34,3/2/2021,Goias,Atletico-MG,3,3,0,0,3,3,0,6,6,13,13,26,GoiasAtletico-MG,0
2197,2197,7220,2020,34,3/2/2021,Bahia,Fluminense,1,1,0,0,1,1,0,2,2,15,11,26,BahiaFluminense,0
2198,2198,7221,2020,34,4/2/2021,Fortaleza,Coritiba,2,5,0,2,2,7,2,7,9,18,15,33,FortalezaCoritiba,0
2199,2199,7222,2020,34,4/2/2021,Flamengo,Vasco,1,3,0,0,1,3,0,4,4,19,15,34,FlamengoVasco,1
2200,2200,7223,2020,34,4/2/2021,Athletico-PR,Internacional,3,2,0,0,3,2,0,5,5,15,20,35,Athletico-PRInternacional,0
2201,2201,7224,2020,34,5/2/2021,Botafogo-RJ,Sport,1,3,0,0,1,3,0,4,4,11,19,30,Botafogo-RJSport,0
2202,2202,7225,2020,34,19/2/2021,Sao Paulo,Palmeiras,2,1,0,0,2,1,0,3,3,16,14,30,Sao PauloPalmeiras,1
2203,2203,7226,2020,35,6/2/2021,Bahia,Goias,3,4,1,0,4,4,1,7,8,18,13,31,BahiaGoias,0
2204,2204,7227,2020,35,6/2/2021,Atletico-GO,Santos,2,2,1,0,3,2,1,4,5,18,13,31,Atletico-GOSantos,0
2205,2205,7228,2020,35,7/2/2021,Bragantino,Flamengo,4,2,0,0,4,2,0,6,6,20,16,36,BragantinoFlamengo,0
3022,3022,7229,2020,35,8/2/2021,Botafogo-RJ,Gremio,0,0,0,0,0,0,0,0,0,14,18,32,Botafogo-RJGremio,0
2206,2206,7230,2020,35,10/2/2021,Internacional,Sport,2,3,2,0,4,3,2,5,7,12,11,23,InternacionalSport,0
2207,2207,7231,2020,35,10/2/2021,Fortaleza,Vasco,2,3,0,0,2,3,0,5,5,15,14,29,FortalezaVasco,0
2208,2208,7232,2020,35,10/2/2021,Sao Paulo,Ceara,4,4,0,0,4,4,0,8,8,11,17,28,Sao PauloCeara,0
2209,2209,7233,2020,35,10/2/2021,Fluminense,Atletico-MG,0,1,0,0,0,1,0,1,1,8,13,21,FluminenseAtletico-MG,0
2210,2210,7234,2020,35,10/2/2021,Corinthians,Athletico-PR,3,0,0,0,3,0,0,3,3,19,12,31,CorinthiansAthletico-PR,0
2211,2211,7235,2020,35,17/2/2021,Coritiba,Palmeiras,2,3,0,1,2,4,1,5,6,16,20,36,CoritibaPalmeiras,0
2212,2212,7236,2020,36,13/2/2021,Goias,Botafogo-RJ,4,3,0,1,4,4,1,7,8,22,26,48,GoiasBotafogo-RJ,0
2213,2213,7237,2020,36,13/2/2021,Atletico-MG,Bahia,1,1,0,0,1,1,0,2,2,10,9,19,Atletico-MGBahia,0
2214,2214,7238,2020,36,13/2/2021,Santos,Coritiba,0,4,0,0,0,4,0,4,4,15,16,31,SantosCoritiba,0
2215,2215,7239,2020,36,14/2/2021,Flamengo,Corinthians,1,5,0,0,1,5,0,6,6,21,16,37,FlamengoCorinthians,0
2216,2216,7240,2020,36,14/2/2021,Vasco,Internacional,1,6,0,0,1,6,0,7,7,9,20,29,VascoInternacional,0
2217,2217,7241,2020,36,14/2/2021,Athletico-PR,Atletico-GO,3,1,0,0,3,1,0,4,4,14,9,23,Athletico-PRAtletico-GO,0
2218,2218,7242,2020,36,14/2/2021,Palmeiras,Fortaleza,0,3,0,0,0,3,0,3,3,16,11,27,PalmeirasFortaleza,0
2219,2219,7243,2020,36,14/2/2021,Gremio,Sao Paulo,5,4,1,0,6,4,1,9,10,19,18,37,GremioSao Paulo,0
2220,2220,7244,2020,36,15/2/2021,Ceara,Fluminense,1,1,0,0,1,1,0,2,2,18,8,26,CearaFluminense,0
2221,2221,7245,2020,36,15/2/2021,Sport,Bragantino,3,0,0,0,3,0,0,3,3,8,10,18,SportBragantino,0
2222,2222,7246,2020,37,20/2/2021,Coritiba,Ceara,1,0,0,0,1,0,0,1,1,14,9,23,CoritibaCeara,0
2223,2223,7247,2020,37,20/2/2021,Fortaleza,Bahia,4,3,1,0,5,3,1,7,8,15,13,28,FortalezaBahia,0
2224,2224,7248,2020,37,21/2/2021,Sport,Atletico-MG,4,4,0,0,4,4,0,8,8,16,13,29,SportAtletico-MG,0
2225,2225,7249,2020,37,21/2/2021,Corinthians,Vasco,1,2,0,0,1,2,0,3,3,23,18,41,CorinthiansVasco,0
2226,2226,7250,2020,37,21/2/2021,Flamengo,Internacional,4,0,0,1,4,1,1,4,5,21,14,35,FlamengoInternacional,0
2227,2227,7251,2020,37,21/2/2021,Santos,Fluminense,3,4,0,1,3,5,1,7,8,20,19,39,SantosFluminense,0
2228,2228,7252,2020,37,21/2/2021,Gremio,Athletico-PR,3,1,0,2,3,3,2,4,6,19,17,36,GremioAthletico-PR,0
2229,2229,7253,2020,37,21/2/2021,Goias,Bragantino,2,0,0,0,2,0,0,2,2,18,20,38,GoiasBragantino,0
2230,2230,7254,2020,37,22/2/2021,Palmeiras,Atletico-GO,2,1,0,0,2,1,0,3,3,20,13,33,PalmeirasAtletico-GO,0
2231,2231,7255,2020,37,22/2/2021,Botafogo-RJ,Sao Paulo,3,5,0,1,3,6,1,8,9,12,15,27,Botafogo-RJSao Paulo,0
2232,2232,7256,2020,38,25/2/2021,Bragantino,Gremio,4,0,0,0,4,0,0,4,4,24,12,36,BragantinoGremio,0
3024,3024,7257,2020,38,25/2/2021,Bahia,Santos,0,0,0,0,0,0,0,0,0,11,13,24,BahiaSantos,0
2233,2233,7258,2020,38,25/2/2021,Athletico-PR,Sport,0,1,0,0,0,1,0,1,1,15,10,25,Athletico-PRSport,0
2234,2234,7259,2020,38,25/2/2021,Atletico-GO,Coritiba,0,1,0,0,0,1,0,1,1,8,9,17,Atletico-GOCoritiba,0
2235,2235,7260,2020,38,25/2/2021,Internacional,Corinthians,0,2,0,0,0,2,0,2,2,13,16,29,InternacionalCorinthians,0
2236,2236,7261,2020,38,25/2/2021,Ceara,Botafogo-RJ,3,0,1,0,4,0,1,3,4,7,4,11,CearaBotafogo-RJ,0
2237,2237,7262,2020,38,25/2/2021,Sao Paulo,Flamengo,6,3,0,0,6,3,0,9,9,27,24,51,Sao PauloFlamengo,0
2238,2238,7263,2020,38,25/2/2021,Atletico-MG,Palmeiras,3,0,0,0,3,0,0,3,3,22,17,39,Atletico-MGPalmeiras,0
2239,2239,7264,2020,38,25/2/2021,Vasco,Goias,1,2,0,0,1,2,0,3,3,12,18,30,VascoGoias,0
3025,3025,7265,2020,38,25/2/2021,Fluminense,Fortaleza,0,0,0,0,0,0,0,0,0,10,12,22,FluminenseFortaleza,0
2240,2240,7266,2021,1,29/5/2021,Cuiaba,Juventude,1,3,0,0,1,3,0,4,4,14,14,28,CuiabaJuventude,0
2241,2241,7267,2021,1,29/5/2021,Bahia,Santos,3,3,0,0,3,3,0,6,6,18,9,27,BahiaSantos,0
2242,2242,7268,2021,1,29/5/2021,Sao Paulo,Fluminense,1,2,0,0,1,2,0,3,3,10,12,22,Sao PauloFluminense,0
2243,2243,7269,2021,1,30/5/2021,Atletico-MG,Fortaleza,2,4,0,0,2,4,0,6,6,16,19,35,Atletico-MGFortaleza,0
2244,2244,7270,2021,1,30/5/2021,Flamengo,Palmeiras,2,3,0,0,2,3,0,5,5,25,21,46,FlamengoPalmeiras,0
2245,2245,7271,2021,1,30/5/2021,Ceara,Gremio,3,3,0,0,3,3,0,6,6,17,18,35,CearaGremio,0
2246,2246,7272,2021,1,30/5/2021,Corinthians,Atletico-GO,5,3,0,0,5,3,0,8,8,18,14,32,CorinthiansAtletico-GO,0
2247,2247,7273,2021,1,30/5/2021,Chapecoense,Bragantino,1,0,0,0,1,0,0,1,1,9,12,21,ChapecoenseBragantino,0
2248,2248,7274,2021,1,30/5/2021,Athletico-PR,America-MG,1,2,0,0,1,2,0,3,3,18,9,27,Athletico-PRAmerica-MG,0
2249,2249,7275,2021,1,30/5/2021,Internacional,Sport,4,2,0,0,4,2,0,6,6,24,15,39,InternacionalSport,0
2250,2250,7276,2021,2,5/6/2021,Atletico-GO,Sao Paulo,4,5,0,0,4,5,0,9,9,16,14,30,Atletico-GOSao Paulo,0
2251,2251,7277,2021,2,5/6/2021,Santos,Ceara,3,1,0,0,3,1,0,4,4,18,19,37,SantosCeara,0
2252,2252,7278,2021,2,5/6/2021,Bragantino,Bahia,2,4,0,0,2,4,0,6,6,12,13,25,BragantinoBahia,0
2253,2253,7279,2021,2,6/6/2021,Fluminense,Cuiaba,2,1,0,0,2,1,0,3,3,22,15,37,FluminenseCuiaba,0
2254,2254,7280,2021,2,6/6/2021,America-MG,Corinthians,2,3,0,0,2,3,0,5,5,12,19,31,America-MGCorinthians,0
2255,2255,7281,2021,2,6/6/2021,Fortaleza,Internacional,1,4,0,2,1,6,2,5,7,19,21,40,FortalezaInternacional,0
2256,2256,7282,2021,2,6/6/2021,Juventude,Athletico-PR,0,2,0,0,0,2,0,2,2,14,27,41,JuventudeAthletico-PR,0
2257,2257,7283,2021,2,6/6/2021,Palmeiras,Chapecoense,2,0,0,0,2,0,0,2,2,10,11,21,PalmeirasChapecoense,0
2258,2258,7284,2021,2,6/6/2021,Sport,Atletico-MG,3,2,0,0,3,2,0,5,5,18,15,33,SportAtletico-MG,0
2259,2259,7285,2021,2,23/11/2021,Gremio,Flamengo,3,2,2,0,5,2,2,5,7,14,14,28,GremioFlamengo,0
2260,2260,7286,2021,3,12/6/2021,Santos,Juventude,2,3,0,0,2,3,0,5,5,14,20,34,SantosJuventude,0
2261,2261,7287,2021,3,12/6/2021,Palmeiras,Corinthians,3,0,0,0,3,0,0,3,3,14,14,28,PalmeirasCorinthians,1
2262,2262,7288,2021,3,13/6/2021,Atletico-MG,Sao Paulo,0,1,0,0,0,1,0,1,1,14,22,36,Atletico-MGSao Paulo,0
2263,2263,7289,2021,3,13/6/2021,Gremio,Athletico-PR,5,4,0,0,5,4,0,9,9,21,12,33,GremioAthletico-PR,0
3026,3026,7290,2021,3,13/6/2021,Flamengo,America-MG,0,0,0,0,0,0,0,0,0,17,18,35,FlamengoAmerica-MG,0
2264,2264,7291,2021,3,13/6/2021,Bahia,Internacional,4,4,0,1,4,5,1,8,9,14,16,30,BahiaInternacional,0
2265,2265,7292,2021,3,13/6/2021,Fortaleza,Sport,3,3,0,1,3,4,1,6,7,22,16,38,FortalezaSport,0
2266,2266,7293,2021,3,13/6/2021,Bragantino,Fluminense,3,1,0,0,3,1,0,4,4,11,8,19,BragantinoFluminense,0
2267,2267,7294,2021,3,13/6/2021,Chapecoense,Ceara,2,2,0,0,2,2,0,4,4,16,14,30,ChapecoenseCeara,0
2268,2268,7295,2021,3,21/7/2021,Cuiaba,Atletico-GO,5,4,0,1,5,5,1,9,10,17,14,31,CuiabaAtletico-GO,0
2269,2269,7296,2021,4,16/6/2021,Internacional,Atletico-MG,3,1,0,0,3,1,0,4,4,13,13,26,InternacionalAtletico-MG,0
2270,2270,7297,2021,4,16/6/2021,Sao Paulo,Chapecoense,3,2,1,0,4,2,1,5,6,9,13,22,Sao PauloChapecoense,0
2271,2271,7298,2021,4,16/6/2021,Corinthians,Bragantino,2,0,0,0,2,0,0,2,2,13,15,28,CorinthiansBragantino,1
2272,2272,7299,2021,4,16/6/2021,Juventude,Palmeiras,0,3,0,0,0,3,0,3,3,11,24,35,JuventudePalmeiras,0
2273,2273,7300,2021,4,17/6/2021,America-MG,Cuiaba,1,1,0,0,1,1,0,2,2,16,16,32,America-MGCuiaba,0
2274,2274,7301,2021,4,17/6/2021,Ceara,Bahia,3,5,0,0,3,5,0,8,8,19,16,35,CearaBahia,0
2275,2275,7302,2021,4,17/6/2021,Sport,Gremio,5,4,0,0,5,4,0,9,9,16,11,27,SportGremio,0
2276,2276,7303,2021,4,17/6/2021,Atletico-GO,Fortaleza,3,1,0,0,3,1,0,4,4,18,13,31,Atletico-GOFortaleza,0
2277,2277,7304,2021,4,17/6/2021,Fluminense,Santos,4,3,0,0,4,3,0,7,7,14,9,23,FluminenseSantos,0
2278,2278,7305,2021,4,2/11/2021,Athletico-PR,Flamengo,4,2,0,0,4,2,0,6,6,8,15,23,Athletico-PRFlamengo,0
2279,2279,7306,2021,5,19/6/2021,Flamengo,Bragantino,2,3,0,0,2,3,0,5,5,15,13,28,FlamengoBragantino,0
2280,2280,7307,2021,5,20/6/2021,Palmeiras,America-MG,3,4,0,0,3,4,0,7,7,15,10,25,PalmeirasAmerica-MG,0
2281,2281,7308,2021,5,20/6/2021,Bahia,Corinthians,1,3,0,0,1,3,0,4,4,10,18,28,BahiaCorinthians,0
2282,2282,7309,2021,5,20/6/2021,Internacional,Ceara,2,3,0,0,2,3,0,5,5,16,23,39,InternacionalCeara,0
2283,2283,7310,2021,5,20/6/2021,Fortaleza,Fluminense,3,0,0,0,3,0,0,3,3,14,17,31,FortalezaFluminense,0
2284,2284,7311,2021,5,20/6/2021,Athletico-PR,Atletico-GO,2,2,0,0,2,2,0,4,4,17,15,32,Athletico-PRAtletico-GO,0
2285,2285,7312,2021,5,20/6/2021,Santos,Sao Paulo,2,4,0,0,2,4,0,6,6,22,20,42,SantosSao Paulo,1
2286,2286,7313,2021,5,20/6/2021,Juventude,Sport,4,0,0,0,4,0,0,4,4,16,9,25,JuventudeSport,0
2287,2287,7314,2021,5,21/6/2021,Atletico-MG,Chapecoense,1,1,0,0,1,1,0,2,2,9,10,19,Atletico-MGChapecoense,0
2288,2288,7315,2021,5,18/8/2021,Cuiaba,Gremio,1,5,0,0,1,5,0,6,6,12,10,22,CuiabaGremio,0
2289,2289,7316,2021,6,23/6/2021,Atletico-GO,Fluminense,3,3,0,0,3,3,0,6,6,22,17,39,Atletico-GOFluminense,0
2290,2290,7317,2021,6,23/6/2021,Sao Paulo,Cuiaba,1,1,0,0,1,1,0,2,2,18,14,32,Sao PauloCuiaba,0
2291,2291,7318,2021,6,23/6/2021,Flamengo,Fortaleza,1,1,0,0,1,1,0,2,2,18,15,33,FlamengoFortaleza,0
2292,2292,7319,2021,6,23/6/2021,Bragantino,Palmeiras,3,3,0,0,3,3,0,6,6,13,13,26,BragantinoPalmeiras,1
2293,2293,7320,2021,6,24/6/2021,America-MG,Juventude,2,2,1,0,3,2,1,4,5,17,16,33,America-MGJuventude,0
2294,2294,7321,2021,6,24/6/2021,Chapecoense,Internacional,2,3,1,2,3,5,3,5,8,12,19,31,ChapecoenseInternacional,0
2295,2295,7322,2021,6,24/6/2021,Corinthians,Sport,0,3,0,0,0,3,0,3,3,8,17,25,CorinthiansSport,0
2296,2296,7323,2021,6,24/6/2021,Ceara,Atletico-MG,3,4,0,0,3,4,0,7,7,16,16,32,CearaAtletico-MG,0
2297,2297,7324,2021,6,24/6/2021,Bahia,Athletico-PR,2,1,0,2,2,3,2,3,5,12,8,20,BahiaAthletico-PR,0
2298,2298,7325,2021,6,24/6/2021,Gremio,Santos,2,3,0,0,2,3,0,5,5,21,14,35,GremioSantos,0
2299,2299,7326,2021,7,27/6/2021,Juventude,Flamengo,2,1,0,0,2,1,0,3,3,17,12,29,JuventudeFlamengo,0
2300,2300,7327,2021,7,27/6/2021,Fluminense,Corinthians,3,1,1,0,4,1,1,4,5,14,11,25,FluminenseCorinthians,0
2301,2301,7328,2021,7,27/6/2021,Palmeiras,Bahia,3,4,0,0,3,4,0,7,7,10,16,26,PalmeirasBahia,0
2302,2302,7329,2021,7,27/6/2021,Athletico-PR,Chapecoense,1,1,0,0,1,1,0,2,2,12,15,27,Athletico-PRChapecoense,0
2303,2303,7330,2021,7,27/6/2021,Gremio,Fortaleza,2,4,1,0,3,4,1,6,7,13,12,25,GremioFortaleza,0
2304,2304,7331,2021,7,27/6/2021,Santos,Atletico-MG,4,3,0,1,4,4,1,7,8,20,16,36,SantosAtletico-MG,0
2305,2305,7332,2021,7,27/6/2021,America-MG,Internacional,2,3,0,0,2,3,0,5,5,16,20,36,America-MGInternacional,0
2306,2306,7333,2021,7,27/6/2021,Sport,Cuiaba,0,1,0,0,0,1,0,1,1,11,17,28,SportCuiaba,0
2307,2307,7334,2021,7,27/6/2021,Ceara,Sao Paulo,4,6,0,0,4,6,0,10,10,20,12,32,CearaSao Paulo,0
2308,2308,7335,2021,7,28/6/2021,Atletico-GO,Bragantino,2,2,0,0,2,2,0,4,4,24,16,40,Atletico-GOBragantino,0
2309,2309,7336,2021,8,30/6/2021,Fluminense,Athletico-PR,1,2,0,0,1,2,0,3,3,16,15,31,FluminenseAthletico-PR,0
2310,2310,7337,2021,8,30/6/2021,Fortaleza,Chapecoense,3,3,1,0,4,3,1,6,7,17,24,41,FortalezaChapecoense,0
2311,2311,7338,2021,8,30/6/2021,Internacional,Palmeiras,3,2,0,1,3,3,1,5,6,14,13,27,InternacionalPalmeiras,0
2312,2312,7339,2021,8,30/6/2021,Bahia,America-MG,4,0,0,0,4,0,0,4,4,6,9,15,BahiaAmerica-MG,0
2313,2313,7340,2021,8,30/6/2021,Santos,Sport,1,4,0,0,1,4,0,5,5,11,19,30,SantosSport,0
2314,2314,7341,2021,8,30/6/2021,Corinthians,Sao Paulo,1,1,0,0,1,1,0,2,2,15,26,41,CorinthiansSao Paulo,1
2315,2315,7342,2021,8,30/6/2021,Juventude,Gremio,3,0,0,0,3,0,0,3,3,15,12,27,JuventudeGremio,1
2316,2316,7343,2021,8,1/7/2021,Bragantino,Ceara,1,3,0,1,1,4,1,4,5,11,17,28,BragantinoCeara,0
2317,2317,7344,2021,8,1/7/2021,Atletico-MG,Atletico-GO,0,2,0,0,0,2,0,2,2,13,12,25,Atletico-MGAtletico-GO,0
2318,2318,7345,2021,8,1/7/2021,Cuiaba,Flamengo,3,5,0,0,3,5,0,8,8,18,26,44,CuiabaFlamengo,0
2319,2319,7346,2021,9,3/7/2021,Athletico-PR,Fortaleza,3,3,0,0,3,3,0,6,6,18,14,32,Athletico-PRFortaleza,0
2320,2320,7347,2021,9,3/7/2021,America-MG,Santos,4,3,0,0,4,3,0,7,7,13,6,19,America-MGSantos,0
2321,2321,7348,2021,9,3/7/2021,Corinthians,Internacional,2,2,0,0,2,2,0,4,4,11,17,28,CorinthiansInternacional,0
2322,2322,7349,2021,9,4/7/2021,Chapecoense,Bahia,2,1,0,0,2,1,0,3,3,14,13,27,ChapecoenseBahia,0
2323,2323,7350,2021,9,4/7/2021,Flamengo,Fluminense,2,1,0,0,2,1,0,3,3,11,15,26,FlamengoFluminense,0
2324,2324,7351,2021,9,4/7/2021,Sport,Palmeiras,2,1,0,0,2,1,0,3,3,23,13,36,SportPalmeiras,0
2325,2325,7352,2021,9,4/7/2021,Ceara,Juventude,2,2,0,1,2,3,1,4,5,23,15,38,CearaJuventude,0
2326,2326,7353,2021,9,4/7/2021,Sao Paulo,Bragantino,1,2,0,0,1,2,0,3,3,25,14,39,Sao PauloBragantino,1
2327,2327,7354,2021,9,4/7/2021,Cuiaba,Atletico-MG,5,2,0,0,5,2,0,7,7,14,15,29,CuiabaAtletico-MG,0
2328,2328,7355,2021,9,4/7/2021,Gremio,Atletico-GO,3,0,0,0,3,0,0,3,3,16,9,25,GremioAtletico-GO,0
2329,2329,7356,2021,10,6/7/2021,Santos,Athletico-PR,2,2,0,0,2,2,0,4,4,17,13,30,SantosAthletico-PR,0
2330,2330,7357,2021,10,7/7/2021,Bahia,Juventude,2,3,0,0,2,3,0,5,5,19,19,38,BahiaJuventude,0
2331,2331,7358,2021,10,7/7/2021,Bragantino,Cuiaba,3,2,0,0,3,2,0,5,5,15,21,36,BragantinoCuiaba,0
2332,2332,7359,2021,10,7/7/2021,Fortaleza,America-MG,2,1,0,0,2,1,0,3,3,18,16,34,FortalezaAmerica-MG,0
2333,2333,7360,2021,10,7/7/2021,Palmeiras,Gremio,2,2,0,0,2,2,0,4,4,15,16,31,PalmeirasGremio,0
2334,2334,7361,2021,10,7/7/2021,Atletico-MG,Flamengo,1,1,0,0,1,1,0,2,2,19,10,29,Atletico-MGFlamengo,0
2335,2335,7362,2021,10,7/7/2021,Atletico-GO,Sport,4,1,0,0,4,1,0,5,5,16,9,25,Atletico-GOSport,0
2336,2336,7363,2021,10,7/7/2021,Internacional,Sao Paulo,2,3,0,0,2,3,0,5,5,21,24,45,InternacionalSao Paulo,0
2337,2337,7364,2021,10,7/7/2021,Fluminense,Ceara,2,3,0,0,2,3,0,5,5,24,21,45,FluminenseCeara,0
2338,2338,7365,2021,10,8/7/2021,Chapecoense,Corinthians,3,0,0,0,3,0,0,3,3,17,10,27,ChapecoenseCorinthians,0
2339,2339,7366,2021,11,10/7/2021,Palmeiras,Santos,1,6,0,0,1,6,0,7,7,19,21,40,PalmeirasSantos,1
2340,2340,7367,2021,11,10/7/2021,Gremio,Internacional,1,2,0,0,1,2,0,3,3,12,19,31,GremioInternacional,1
2341,2341,7368,2021,11,10/7/2021,Athletico-PR,Bragantino,0,4,0,0,0,4,0,4,4,18,16,34,Athletico-PRBragantino,0
2342,2342,7369,2021,11,10/7/2021,Sport,Fluminense,1,3,0,0,1,3,0,4,4,16,13,29,SportFluminense,0
2343,2343,7370,2021,11,10/7/2021,Sao Paulo,Bahia,0,1,0,0,0,1,0,1,1,16,15,31,Sao PauloBahia,0
2344,2344,7371,2021,11,10/7/2021,America-MG,Atletico-MG,1,1,0,0,1,1,0,2,2,15,17,32,America-MGAtletico-MG,1
2345,2345,7372,2021,11,11/7/2021,Juventude,Atletico-GO,2,2,0,0,2,2,0,4,4,17,23,40,JuventudeAtletico-GO,0
2346,2346,7373,2021,11,11/7/2021,Cuiaba,Ceara,1,2,1,0,2,2,1,3,4,9,13,22,CuiabaCeara,0
2347,2347,7374,2021,11,11/7/2021,Flamengo,Chapecoense,3,3,0,0,3,3,0,6,6,19,16,35,FlamengoChapecoense,0
2348,2348,7375,2021,11,11/7/2021,Fortaleza,Corinthians,4,3,0,0,4,3,0,7,7,13,14,27,FortalezaCorinthians,0
2349,2349,7376,2021,12,17/7/2021,Ceara,Athletico-PR,4,3,0,0,4,3,0,7,7,11,15,26,CearaAthletico-PR,0
2350,2350,7377,2021,12,17/7/2021,Sao Paulo,Fortaleza,3,2,0,0,3,2,0,5,5,18,20,38,Sao PauloFortaleza,0
2351,2351,7378,2021,12,17/7/2021,Corinthians,Atletico-MG,0,2,0,0,0,2,0,2,2,9,22,31,CorinthiansAtletico-MG,0
2352,2352,7379,2021,12,17/7/2021,Fluminense,Gremio,1,4,0,0,1,4,0,5,5,13,12,25,FluminenseGremio,0
2353,2353,7380,2021,12,18/7/2021,Chapecoense,Cuiaba,2,2,0,0,2,2,0,4,4,15,13,28,ChapecoenseCuiaba,0
2354,2354,7381,2021,12,18/7/2021,Atletico-GO,Palmeiras,2,1,0,0,2,1,0,3,3,8,16,24,Atletico-GOPalmeiras,0
2355,2355,7382,2021,12,18/7/2021,Bahia,Flamengo,5,1,0,0,5,1,0,6,6,18,8,26,BahiaFlamengo,0
2356,2356,7383,2021,12,18/7/2021,Internacional,Juventude,4,4,0,1,4,5,1,8,9,19,14,33,InternacionalJuventude,1
2357,2357,7384,2021,12,18/7/2021,Bragantino,Santos,3,6,0,0,3,6,0,9,9,17,15,32,BragantinoSantos,1
2358,2358,7385,2021,12,19/7/2021,America-MG,Sport,1,3,0,0,1,3,0,4,4,19,22,41,America-MGSport,0
2359,2359,7386,2021,13,24/7/2021,Gremio,America-MG,3,3,0,0,3,3,0,6,6,20,16,36,GremioAmerica-MG,0
2360,2360,7387,2021,13,24/7/2021,Palmeiras,Fluminense,1,2,0,0,1,2,0,3,3,13,9,22,PalmeirasFluminense,0
2361,2361,7388,2021,13,25/7/2021,Atletico-MG,Bahia,2,1,0,0,2,1,0,3,3,17,14,31,Atletico-MGBahia,0
2362,2362,7389,2021,13,25/7/2021,Fortaleza,Bragantino,4,2,0,0,4,2,0,6,6,21,14,35,FortalezaBragantino,0
2363,2363,7390,2021,13,25/7/2021,Flamengo,Sao Paulo,3,6,0,0,3,6,0,9,9,23,16,39,FlamengoSao Paulo,0
2364,2364,7391,2021,13,25/7/2021,Santos,Atletico-GO,2,2,0,0,2,2,0,4,4,14,7,21,SantosAtletico-GO,0
2365,2365,7392,2021,13,25/7/2021,Athletico-PR,Internacional,4,3,0,0,4,3,0,7,7,14,13,27,Athletico-PRInternacional,0
2366,2366,7393,2021,13,25/7/2021,Sport,Ceara,4,1,0,0,4,1,0,5,5,12,13,25,SportCeara,0
2367,2367,7394,2021,13,26/7/2021,Juventude,Chapecoense,5,1,0,0,5,1,0,6,6,16,15,31,JuventudeChapecoense,0
2368,2368,7395,2021,13,26/7/2021,Cuiaba,Corinthians,2,1,1,0,3,1,1,3,4,16,12,28,CuiabaCorinthians,0
2369,2369,7396,2021,14,31/7/2021,Sao Paulo,Palmeiras,3,3,1,0,4,3,1,6,7,20,15,35,Sao PauloPalmeiras,1
2370,2370,7397,2021,14,31/7/2021,Internacional,Cuiaba,2,3,1,0,3,3,1,5,6,20,18,38,InternacionalCuiaba,0
2371,2371,7398,2021,14,31/7/2021,Bragantino,Gremio,1,2,0,0,1,2,0,3,3,13,19,32,BragantinoGremio,0
2372,2372,7399,2021,14,1/8/2021,Corinthians,Flamengo,1,1,0,0,1,1,0,2,2,7,13,20,CorinthiansFlamengo,0
2373,2373,7400,2021,14,1/8/2021,Atletico-MG,Athletico-PR,3,3,1,0,4,3,1,6,7,14,12,26,Atletico-MGAthletico-PR,0
3027,3027,7401,2021,14,1/8/2021,Chapecoense,Santos,2,1,2,0,4,1,2,3,5,17,13,30,ChapecoenseSantos,0
2374,2374,7402,2021,14,1/8/2021,Bahia,Sport,2,3,0,0,2,3,0,5,5,16,18,34,BahiaSport,0
2375,2375,7403,2021,14,1/8/2021,Atletico-GO,America-MG,4,0,0,0,4,0,0,4,4,21,14,35,Atletico-GOAmerica-MG,0
2376,2376,7404,2021,14,1/8/2021,Ceara,Fortaleza,2,3,0,0,2,3,0,5,5,13,12,25,CearaFortaleza,1
2377,2377,7405,2021,14,2/9/2021,Fluminense,Juventude,2,1,0,0,2,1,0,3,3,23,18,41,FluminenseJuventude,0
2378,2378,7406,2021,15,6/8/2021,Sport,Bragantino,3,1,0,0,3,1,0,4,4,17,14,31,SportBragantino,0
2379,2379,7407,2021,15,7/8/2021,Athletico-PR,Sao Paulo,2,4,0,1,2,5,1,6,7,12,16,28,Athletico-PRSao Paulo,0
2380,2380,7408,2021,15,7/8/2021,Palmeiras,Fortaleza,5,2,1,1,6,3,2,7,9,22,13,35,PalmeirasFortaleza,0
2381,2381,7409,2021,15,7/8/2021,Cuiaba,Bahia,1,2,1,0,2,2,1,3,4,15,17,32,CuiabaBahia,0
2382,2382,7410,2021,15,8/8/2021,Juventude,Atletico-MG,1,3,0,0,1,3,0,4,4,17,14,31,JuventudeAtletico-MG,0
2383,2383,7411,2021,15,8/8/2021,America-MG,Fluminense,2,2,0,0,2,2,0,4,4,17,13,30,America-MGFluminense,0
2384,2384,7412,2021,15,8/8/2021,Santos,Corinthians,1,1,0,0,1,1,0,2,2,17,9,26,SantosCorinthians,1
2385,2385,7413,2021,15,8/8/2021,Ceara,Atletico-GO,2,2,0,0,2,2,0,4,4,18,15,33,CearaAtletico-GO,0
2386,2386,7414,2021,15,8/8/2021,Flamengo,Internacional,2,2,1,0,3,2,1,4,5,9,15,24,FlamengoInternacional,0
2387,2387,7415,2021,15,9/8/2021,Gremio,Chapecoense,1,3,0,0,1,3,0,4,4,14,10,24,GremioChapecoense,0
2388,2388,7416,2021,16,14/8/2021,Bragantino,Juventude,4,4,0,0,4,4,0,8,8,14,14,28,BragantinoJuventude,0
2389,2389,7417,2021,16,14/8/2021,Atletico-MG,Palmeiras,2,1,0,1,2,2,1,3,4,14,14,28,Atletico-MGPalmeiras,0
2390,2390,7418,2021,16,14/8/2021,Sao Paulo,Gremio,3,1,0,0,3,1,0,4,4,14,16,30,Sao PauloGremio,0
2391,2391,7419,2021,16,15/8/2021,Flamengo,Sport,4,1,0,0,4,1,0,5,5,14,11,25,FlamengoSport,0
2392,2392,7420,2021,16,15/8/2021,Corinthians,Ceara,1,1,0,0,1,1,0,2,2,7,16,23,CorinthiansCeara,0
2393,2393,7421,2021,16,15/8/2021,Bahia,Atletico-GO,2,0,0,0,2,0,0,2,2,18,11,29,BahiaAtletico-GO,0
2394,2394,7422,2021,16,15/8/2021,Cuiaba,Athletico-PR,1,1,0,0,1,1,0,2,2,15,20,35,CuiabaAthletico-PR,0
2395,2395,7423,2021,16,15/8/2021,Fortaleza,Santos,2,1,0,0,2,1,0,3,3,17,13,30,FortalezaSantos,0
2396,2396,7424,2021,16,15/8/2021,Internacional,Fluminense,2,0,0,0,2,0,0,2,2,14,8,22,InternacionalFluminense,0
2397,2397,7425,2021,16,16/8/2021,Chapecoense,America-MG,1,1,1,0,2,1,1,2,3,10,11,21,ChapecoenseAmerica-MG,0
2398,2398,7426,2021,17,21/8/2021,Atletico-GO,Chapecoense,2,5,1,0,3,5,1,7,8,13,24,37,Atletico-GOChapecoense,0
2399,2399,7427,2021,17,21/8/2021,Gremio,Bahia,1,1,0,0,1,1,0,2,2,12,15,27,GremioBahia,0
2400,2400,7428,2021,17,21/8/2021,Juventude,Fortaleza,1,1,0,0,1,1,0,2,2,8,9,17,JuventudeFortaleza,0
2401,2401,7429,2021,17,22/8/2021,Palmeiras,Cuiaba,1,1,0,0,1,1,0,2,2,8,14,22,PalmeirasCuiaba,0
2402,2402,7430,2021,17,22/8/2021,Ceara,Flamengo,0,2,0,0,0,2,0,2,2,13,12,25,CearaFlamengo,0
2403,2403,7431,2021,17,22/8/2021,Athletico-PR,Corinthians,1,0,1,0,2,0,1,1,2,12,7,19,Athletico-PRCorinthians,0
2404,2404,7432,2021,17,22/8/2021,Santos,Internacional,2,2,0,0,2,2,0,4,4,19,14,33,SantosInternacional,0
2405,2405,7433,2021,17,22/8/2021,Sport,Sao Paulo,2,2,0,0,2,2,0,4,4,15,17,32,SportSao Paulo,0
2406,2406,7434,2021,17,23/8/2021,America-MG,Bragantino,2,0,0,0,2,0,0,2,2,14,15,29,America-MGBragantino,0
2407,2407,7435,2021,17,23/8/2021,Fluminense,Atletico-MG,3,3,0,0,3,3,0,6,6,16,16,32,FluminenseAtletico-MG,0
2408,2408,7436,2021,18,28/8/2021,Sport,Chapecoense,1,1,1,0,2,1,1,2,3,17,17,34,SportChapecoense,0
2409,2409,7437,2021,18,28/8/2021,Santos,Flamengo,4,4,0,0,4,4,0,8,8,14,14,28,SantosFlamengo,0
2410,2410,7438,2021,18,28/8/2021,Gremio,Corinthians,1,2,1,0,2,2,1,3,4,17,7,24,GremioCorinthians,0
2411,2411,7439,2021,18,28/8/2021,Palmeiras,Athletico-PR,3,0,0,0,3,0,0,3,3,10,16,26,PalmeirasAthletico-PR,0
2412,2412,7440,2021,18,29/8/2021,America-MG,Ceara,1,2,0,0,1,2,0,3,3,19,13,32,America-MGCeara,0
2413,2413,7441,2021,18,29/8/2021,Juventude,Sao Paulo,2,5,0,0,2,5,0,7,7,15,21,36,JuventudeSao Paulo,0
2414,2414,7442,2021,18,29/8/2021,Atletico-GO,Internacional,1,2,0,0,1,2,0,3,3,13,15,28,Atletico-GOInternacional,0
2415,2415,7443,2021,18,29/8/2021,Bragantino,Atletico-MG,3,4,0,0,3,4,0,7,7,16,18,34,BragantinoAtletico-MG,0
2416,2416,7444,2021,18,30/8/2021,Fluminense,Bahia,2,4,0,0,2,4,0,6,6,19,21,40,FluminenseBahia,0
2417,2417,7445,2021,18,30/8/2021,Fortaleza,Cuiaba,2,5,0,0,2,5,0,7,7,15,17,32,FortalezaCuiaba,0
2418,2418,7446,2021,19,4/9/2021,Bahia,Fortaleza,3,1,0,0,3,1,0,4,4,25,7,32,BahiaFortaleza,0
2419,2419,7447,2021,19,4/9/2021,Cuiaba,Santos,3,1,0,0,3,1,0,4,4,11,11,22,CuiabaSantos,0
2420,2420,7448,2021,19,5/9/2021,Athletico-PR,Sport,1,2,0,1,1,3,1,3,4,10,9,19,Athletico-PRSport,0
2421,2421,7449,2021,19,7/9/2021,Corinthians,Juventude,3,4,0,0,3,4,0,7,7,15,20,35,CorinthiansJuventude,0
3028,3028,7450,2021,19,7/9/2021,Chapecoense,Fluminense,0,0,0,0,0,0,0,0,0,18,4,22,ChapecoenseFluminense,0
2422,2422,7451,2021,19,22/9/2021,Sao Paulo,America-MG,3,1,0,0,3,1,0,4,4,17,18,35,Sao PauloAmerica-MG,0
2423,2423,7452,2021,19,20/10/2021,Ceara,Palmeiras,4,2,0,0,4,2,0,6,6,19,11,30,CearaPalmeiras,0
2424,2424,7453,2021,19,21/10/2021,Internacional,Bragantino,5,2,0,0,5,2,0,7,7,18,13,31,InternacionalBragantino,0
2425,2425,7454,2021,19,3/11/2021,Atletico-MG,Gremio,5,6,0,0,5,6,0,11,11,10,14,24,Atletico-MGGremio,0
2426,2426,7455,2021,19,5/11/2021,Flamengo,Atletico-GO,2,1,0,0,2,1,0,3,3,10,15,25,FlamengoAtletico-GO,0
2427,2427,7456,2021,20,11/9/2021,America-MG,Athletico-PR,1,1,0,0,1,1,0,2,2,14,17,31,America-MGAthletico-PR,0
2428,2428,7457,2021,20,11/9/2021,Juventude,Cuiaba,3,5,0,1,3,6,1,8,9,12,13,25,JuventudeCuiaba,0
2429,2429,7458,2021,20,11/9/2021,Bragantino,Chapecoense,4,2,1,0,5,2,1,6,7,17,13,30,BragantinoChapecoense,0
2430,2430,7459,2021,20,11/9/2021,Santos,Bahia,1,4,0,0,1,4,0,5,5,16,20,36,SantosBahia,0
3029,3029,7460,2021,20,12/9/2021,Gremio,Ceara,0,0,0,0,0,0,0,0,0,22,9,31,GremioCeara,0
2431,2431,7461,2021,20,12/9/2021,Fortaleza,Atletico-MG,1,2,0,0,1,2,0,3,3,13,18,31,FortalezaAtletico-MG,0
2432,2432,7462,2021,20,12/9/2021,Palmeiras,Flamengo,0,2,1,0,1,2,1,2,3,14,15,29,PalmeirasFlamengo,0
2433,2433,7463,2021,20,12/9/2021,Atletico-GO,Corinthians,4,2,0,0,4,2,0,6,6,10,10,20,Atletico-GOCorinthians,0
2434,2434,7464,2021,20,12/9/2021,Fluminense,Sao Paulo,5,4,0,0,5,4,0,9,9,16,16,32,FluminenseSao Paulo,0
2435,2435,7465,2021,20,13/9/2021,Sport,Internacional,4,1,0,0,4,1,0,5,5,21,20,41,SportInternacional,0
2436,2436,7466,2021,21,18/9/2021,Chapecoense,Palmeiras,2,2,0,0,2,2,0,4,4,16,14,30,ChapecoensePalmeiras,0
2437,2437,7467,2021,21,18/9/2021,Athletico-PR,Juventude,5,1,0,1,5,2,1,6,7,18,7,25,Athletico-PRJuventude,0
2438,2438,7468,2021,21,18/9/2021,Atletico-MG,Sport,2,3,0,0,2,3,0,5,5,18,13,31,Atletico-MGSport,0
2439,2439,7469,2021,21,18/9/2021,Bahia,Bragantino,1,4,0,0,1,4,0,5,5,16,13,29,BahiaBragantino,0
2440,2440,7470,2021,21,18/9/2021,Ceara,Santos,3,2,0,0,3,2,0,5,5,17,13,30,CearaSantos,0
2441,2441,7471,2021,21,19/9/2021,Internacional,Fortaleza,3,1,1,1,4,2,2,4,6,12,15,27,InternacionalFortaleza,0
2442,2442,7472,2021,21,19/9/2021,Sao Paulo,Atletico-GO,1,2,0,0,1,2,0,3,3,18,11,29,Sao PauloAtletico-GO,0
2443,2443,7473,2021,21,19/9/2021,Corinthians,America-MG,1,0,1,0,2,0,1,1,2,8,13,21,CorinthiansAmerica-MG,0
2444,2444,7474,2021,21,19/9/2021,Flamengo,Gremio,3,4,0,0,3,4,0,7,7,16,17,33,FlamengoGremio,0
2445,2445,7475,2021,21,20/9/2021,Cuiaba,Fluminense,2,2,1,0,3,2,1,4,5,15,16,31,CuiabaFluminense,0
2446,2446,7476,2021,22,25/9/2021,Ceara,Chapecoense,0,3,0,1,0,4,1,3,4,8,18,26,CearaChapecoense,0
2447,2447,7477,2021,22,25/9/2021,Corinthians,Palmeiras,1,1,0,0,1,1,0,2,2,8,11,19,CorinthiansPalmeiras,1
2448,2448,7478,2021,22,25/9/2021,Sao Paulo,Atletico-MG,1,1,0,0,1,1,0,2,2,14,12,26,Sao PauloAtletico-MG,0
2449,2449,7479,2021,22,26/9/2021,America-MG,Flamengo,1,1,0,0,1,1,0,2,2,9,12,21,America-MGFlamengo,0
2450,2450,7480,2021,22,26/9/2021,Internacional,Bahia,2,2,0,0,2,2,0,4,4,19,15,34,InternacionalBahia,0
2451,2451,7481,2021,22,26/9/2021,Fluminense,Bragantino,2,2,0,0,2,2,0,4,4,11,19,30,FluminenseBragantino,0
2452,2452,7482,2021,22,26/9/2021,Juventude,Santos,3,0,0,0,3,0,0,3,3,15,16,31,JuventudeSantos,0
2453,2453,7483,2021,22,26/9/2021,Sport,Fortaleza,5,2,0,0,5,2,0,7,7,19,14,33,SportFortaleza,0
2454,2454,7484,2021,22,26/9/2021,Athletico-PR,Gremio,1,5,0,0,1,5,0,6,6,17,18,35,Athletico-PRGremio,0
2455,2455,7485,2021,22,26/9/2021,Atletico-GO,Cuiaba,1,4,0,0,1,4,0,5,5,10,16,26,Atletico-GOCuiaba,0
2456,2456,7486,2021,23,2/10/2021,Cuiaba,America-MG,1,2,0,0,1,2,0,3,3,13,20,33,CuiabaAmerica-MG,0
2457,2457,7487,2021,23,2/10/2021,Fortaleza,Atletico-GO,1,4,0,0,1,4,0,5,5,14,20,34,FortalezaAtletico-GO,0
3030,3030,7488,2021,23,2/10/2021,Bragantino,Corinthians,0,0,0,0,0,0,0,0,0,10,6,16,BragantinoCorinthians,1
2458,2458,7489,2021,23,2/10/2021,Atletico-MG,Internacional,4,2,0,0,4,2,0,6,6,16,15,31,Atletico-MGInternacional,0
2459,2459,7490,2021,23,3/10/2021,Flamengo,Athletico-PR,2,2,0,0,2,2,0,4,4,13,14,27,FlamengoAthletico-PR,0
2460,2460,7491,2021,23,3/10/2021,Chapecoense,Sao Paulo,1,1,0,0,1,1,0,2,2,11,11,22,ChapecoenseSao Paulo,0
2461,2461,7492,2021,23,3/10/2021,Palmeiras,Juventude,1,1,0,0,1,1,0,2,2,19,13,32,PalmeirasJuventude,0
2462,2462,7493,2021,23,3/10/2021,Gremio,Sport,2,1,0,0,2,1,0,3,3,21,18,39,GremioSport,0
2463,2463,7494,2021,23,27/10/2021,Santos,Fluminense,2,2,0,0,2,2,0,4,4,18,10,28,SantosFluminense,0
2464,2464,7495,2021,23,27/10/2021,Bahia,Ceara,3,2,0,1,3,3,1,5,6,19,13,32,BahiaCeara,0
2465,2465,7496,2021,24,5/10/2021,Corinthians,Bahia,0,1,0,1,0,2,1,1,2,14,18,32,CorinthiansBahia,0
2466,2466,7497,2021,24,6/10/2021,Chapecoense,Atletico-MG,2,1,0,0,2,1,0,3,3,12,17,29,ChapecoenseAtletico-MG,0
2467,2467,7498,2021,24,6/10/2021,Atletico-GO,Athletico-PR,3,3,0,0,3,3,0,6,6,12,16,28,Atletico-GOAthletico-PR,0
2468,2468,7499,2021,24,6/10/2021,Sport,Juventude,2,2,0,0,2,2,0,4,4,11,11,22,SportJuventude,0
2469,2469,7500,2021,24,6/10/2021,Ceara,Internacional,5,2,0,0,5,2,0,7,7,22,16,38,CearaInternacional,0
2470,2470,7501,2021,24,6/10/2021,Bragantino,Flamengo,1,3,0,0,1,3,0,4,4,13,20,33,BragantinoFlamengo,0
2471,2471,7502,2021,24,6/10/2021,Fluminense,Fortaleza,2,2,0,0,2,2,0,4,4,13,16,29,FluminenseFortaleza,0
2472,2472,7503,2021,24,6/10/2021,America-MG,Palmeiras,2,3,0,0,2,3,0,5,5,14,17,31,America-MGPalmeiras,0
2473,2473,7504,2021,24,6/10/2021,Gremio,Cuiaba,2,2,0,0,2,2,0,4,4,15,10,25,GremioCuiaba,0
2474,2474,7505,2021,24,7/10/2021,Sao Paulo,Santos,2,4,0,0,2,4,0,6,6,19,13,32,Sao PauloSantos,1
2475,2475,7506,2021,25,9/10/2021,Fluminense,Atletico-GO,2,2,0,0,2,2,0,4,4,15,17,32,FluminenseAtletico-GO,0
2476,2476,7507,2021,25,9/10/2021,Atletico-MG,Ceara,1,3,0,0,1,3,0,4,4,12,10,22,Atletico-MGCeara,0
2477,2477,7508,2021,25,9/10/2021,Sport,Corinthians,3,0,0,0,3,0,0,3,3,14,7,21,SportCorinthians,0
2478,2478,7509,2021,25,9/10/2021,Fortaleza,Flamengo,0,2,1,0,1,2,1,2,3,10,17,27,FortalezaFlamengo,0
2479,2479,7510,2021,25,9/10/2021,Athletico-PR,Bahia,1,2,0,0,1,2,0,3,3,14,9,23,Athletico-PRBahia,0
2480,2480,7511,2021,25,9/10/2021,Palmeiras,Bragantino,1,2,0,0,1,2,0,3,3,14,15,29,PalmeirasBragantino,1
2481,2481,7512,2021,25,9/10/2021,Juventude,America-MG,6,3,0,0,6,3,0,9,9,24,26,50,JuventudeAmerica-MG,0
2482,2482,7513,2021,25,10/10/2021,Internacional,Chapecoense,3,1,0,0,3,1,0,4,4,16,14,30,InternacionalChapecoense,0
2483,2483,7514,2021,25,10/10/2021,Santos,Gremio,4,6,0,1,4,7,1,10,11,14,25,39,SantosGremio,0
2484,2484,7515,2021,25,11/10/2021,Cuiaba,Sao Paulo,2,2,0,0,2,2,0,4,4,14,16,30,CuiabaSao Paulo,0
2485,2485,7516,2021,26,12/10/2021,Bragantino,Atletico-GO,2,4,1,0,3,4,1,6,7,12,13,25,BragantinoAtletico-GO,0
2486,2486,7517,2021,26,12/10/2021,Bahia,Palmeiras,4,2,0,1,4,3,1,6,7,22,13,35,BahiaPalmeiras,0
2487,2487,7518,2021,26,13/10/2021,Atletico-MG,Santos,2,7,0,0,2,7,0,9,9,10,13,23,Atletico-MGSantos,0
2488,2488,7519,2021,26,13/10/2021,Chapecoense,Athletico-PR,4,5,0,0,4,5,0,9,9,17,13,30,ChapecoenseAthletico-PR,0
2489,2489,7520,2021,26,13/10/2021,Flamengo,Juventude,2,3,0,0,2,3,0,5,5,17,14,31,FlamengoJuventude,0
2490,2490,7521,2021,26,13/10/2021,Fortaleza,Gremio,2,2,0,0,2,2,0,4,4,13,17,30,FortalezaGremio,0
2491,2491,7522,2021,26,13/10/2021,Corinthians,Fluminense,1,1,0,0,1,1,0,2,2,4,9,13,CorinthiansFluminense,0
2492,2492,7523,2021,26,13/10/2021,Internacional,America-MG,1,2,0,0,1,2,0,3,3,21,23,44,InternacionalAmerica-MG,0
2493,2493,7524,2021,26,14/10/2021,Sao Paulo,Ceara,3,3,0,0,3,3,0,6,6,18,14,32,Sao PauloCeara,0
2494,2494,7525,2021,26,14/10/2021,Cuiaba,Sport,4,0,0,0,4,0,0,4,4,14,8,22,CuiabaSport,0
2495,2495,7526,2021,27,16/10/2021,Chapecoense,Fortaleza,3,1,0,0,3,1,0,4,4,20,12,32,ChapecoenseFortaleza,0
2496,2496,7527,2021,27,16/10/2021,America-MG,Bahia,1,2,0,0,1,2,0,3,3,12,22,34,America-MGBahia,0
2497,2497,7528,2021,27,17/10/2021,Athletico-PR,Fluminense,2,1,0,0,2,1,0,3,3,22,15,37,Athletico-PRFluminense,0
2498,2498,7529,2021,27,17/10/2021,Palmeiras,Internacional,3,4,0,1,3,5,1,7,8,13,21,34,PalmeirasInternacional,0
2499,2499,7530,2021,27,17/10/2021,Ceara,Bragantino,2,7,0,0,2,7,0,9,9,13,14,27,CearaBragantino,0
2500,2500,7531,2021,27,17/10/2021,Gremio,Juventude,1,3,0,0,1,3,0,4,4,24,15,39,GremioJuventude,1
2501,2501,7532,2021,27,17/10/2021,Atletico-GO,Atletico-MG,1,0,0,0,1,0,0,1,1,8,7,15,Atletico-GOAtletico-MG,0
2502,2502,7533,2021,27,17/10/2021,Sport,Santos,1,3,0,0,1,3,0,4,4,14,11,25,SportSantos,0
2503,2503,7534,2021,27,17/10/2021,Flamengo,Cuiaba,1,1,0,0,1,1,0,2,2,12,7,19,FlamengoCuiaba,0
2504,2504,7535,2021,27,18/10/2021,Sao Paulo,Corinthians,3,2,0,0,3,2,0,5,5,21,8,29,Sao PauloCorinthians,1
2505,2505,7536,2021,28,23/10/2021,Santos,America-MG,1,2,1,0,2,2,1,3,4,10,12,22,SantosAmerica-MG,0
2506,2506,7537,2021,28,23/10/2021,Juventude,Ceara,1,2,0,0,1,2,0,3,3,15,20,35,JuventudeCeara,0
2507,2507,7538,2021,28,23/10/2021,Fluminense,Flamengo,6,3,0,0,6,3,0,9,9,22,16,38,FluminenseFlamengo,1
2508,2508,7539,2021,28,23/10/2021,Fortaleza,Athletico-PR,2,2,0,0,2,2,0,4,4,13,12,25,FortalezaAthletico-PR,0
2509,2509,7540,2021,28,24/10/2021,Internacional,Corinthians,3,3,1,1,4,4,2,6,8,23,11,34,InternacionalCorinthians,0
3031,3031,7541,2021,28,24/10/2021,Atletico-MG,Cuiaba,0,0,0,0,0,0,0,0,0,12,13,25,Atletico-MGCuiaba,0
2510,2510,7542,2021,28,24/10/2021,Bragantino,Sao Paulo,3,0,0,0,3,0,0,3,3,14,19,33,BragantinoSao Paulo,1
2511,2511,7543,2021,28,24/10/2021,Bahia,Chapecoense,1,1,0,0,1,1,0,2,2,6,11,17,BahiaChapecoense,0
2512,2512,7544,2021,28,25/10/2021,Atletico-GO,Gremio,2,7,0,1,2,8,1,9,10,11,17,28,Atletico-GOGremio,0
2513,2513,7545,2021,28,25/10/2021,Palmeiras,Sport,1,3,0,0,1,3,0,4,4,10,20,30,PalmeirasSport,0
2514,2514,7546,2021,34,28/10/2021,Bragantino,Sport,3,6,0,0,3,6,0,9,9,17,14,31,BragantinoSport,0
2515,2515,7547,2021,34,20/11/2021,Atletico-MG,Juventude,1,2,0,0,1,2,0,3,3,20,13,33,Atletico-MGJuventude,0
2516,2516,7548,2021,34,20/11/2021,Fortaleza,Palmeiras,3,2,0,0,3,2,0,5,5,22,12,34,FortalezaPalmeiras,0
2517,2517,7549,2021,34,20/11/2021,Chapecoense,Gremio,1,1,0,0,1,1,0,2,2,19,18,37,ChapecoenseGremio,0
2518,2518,7550,2021,34,20/11/2021,Atletico-GO,Ceara,0,3,0,0,0,3,0,3,3,10,21,31,Atletico-GOCeara,0
2519,2519,7551,2021,34,20/11/2021,Internacional,Flamengo,2,1,0,0,2,1,0,3,3,14,13,27,InternacionalFlamengo,0
2520,2520,7552,2021,34,21/11/2021,Corinthians,Santos,1,0,0,0,1,0,0,1,1,6,8,14,CorinthiansSantos,1
2521,2521,7553,2021,34,21/11/2021,Fluminense,America-MG,1,2,0,0,1,2,0,3,3,21,17,38,FluminenseAmerica-MG,0
2522,2522,7554,2021,34,21/11/2021,Bahia,Cuiaba,1,0,0,0,1,0,0,1,1,12,9,21,BahiaCuiaba,0
2523,2523,7555,2021,34,24/11/2021,Sao Paulo,Athletico-PR,3,2,0,0,3,2,0,5,5,14,15,29,Sao PauloAthletico-PR,0
2524,2524,7556,2021,29,30/10/2021,Athletico-PR,Santos,1,2,0,0,1,2,0,3,3,11,9,20,Athletico-PRSantos,0
2525,2525,7557,2021,29,30/10/2021,Flamengo,Atletico-MG,4,2,0,0,4,2,0,6,6,22,19,41,FlamengoAtletico-MG,0
2526,2526,7558,2021,29,30/10/2021,Juventude,Bahia,2,1,0,0,2,1,0,3,3,13,17,30,JuventudeBahia,0
2527,2527,7559,2021,29,30/10/2021,America-MG,Fortaleza,0,5,0,0,0,5,0,5,5,13,19,32,America-MGFortaleza,0
2528,2528,7560,2021,29,31/10/2021,Gremio,Palmeiras,5,2,0,0,5,2,0,7,7,26,12,38,GremioPalmeiras,0
2529,2529,7561,2021,29,31/10/2021,Ceara,Fluminense,4,2,1,0,5,2,1,6,7,8,7,15,CearaFluminense,0
2530,2530,7562,2021,29,31/10/2021,Sao Paulo,Internacional,0,2,0,0,0,2,0,2,2,17,13,30,Sao PauloInternacional,0
2531,2531,7563,2021,29,31/10/2021,Sport,Atletico-GO,4,3,0,0,4,3,0,7,7,15,13,28,SportAtletico-GO,0
2532,2532,7564,2021,29,1/11/2021,Cuiaba,Bragantino,2,3,0,0,2,3,0,5,5,8,16,24,CuiabaBragantino,0
2533,2533,7565,2021,29,1/11/2021,Corinthians,Chapecoense,1,4,0,0,1,4,0,5,5,12,19,31,CorinthiansChapecoense,0
2534,2534,7566,2021,31,4/11/2021,Cuiaba,Chapecoense,1,1,0,0,1,1,0,2,2,13,15,28,CuiabaChapecoense,0
2535,2535,7567,2021,31,9/11/2021,Gremio,Fluminense,3,1,0,0,3,1,0,4,4,18,9,27,GremioFluminense,0
2536,2536,7568,2021,31,10/11/2021,Athletico-PR,Ceara,4,3,0,1,4,4,1,7,8,9,10,19,Athletico-PRCeara,0
2537,2537,7569,2021,31,10/11/2021,Atletico-MG,Corinthians,2,2,0,0,2,2,0,4,4,20,4,24,Atletico-MGCorinthians,0
2538,2538,7570,2021,31,10/11/2021,Santos,Bragantino,2,1,0,0,2,1,0,3,3,11,10,21,SantosBragantino,1
2539,2539,7571,2021,31,10/11/2021,Palmeiras,Atletico-GO,1,3,0,0,1,3,0,4,4,10,13,23,PalmeirasAtletico-GO,0
2540,2540,7572,2021,31,10/11/2021,Fortaleza,Sao Paulo,4,5,0,0,4,5,0,9,9,15,11,26,FortalezaSao Paulo,0
2541,2541,7573,2021,31,10/11/2021,Sport,America-MG,2,3,1,0,3,3,1,5,6,11,14,25,SportAmerica-MG,0
2542,2542,7574,2021,31,10/11/2021,Juventude,Internacional,2,4,0,0,2,4,0,6,6,19,15,34,JuventudeInternacional,1
2543,2543,7575,2021,31,11/11/2021,Flamengo,Bahia,0,2,1,2,1,4,3,2,5,14,9,23,FlamengoBahia,0
2544,2544,7576,2021,30,6/11/2021,Corinthians,Fortaleza,3,3,0,0,3,3,0,6,6,18,26,44,CorinthiansFortaleza,0
2545,2545,7577,2021,30,6/11/2021,Internacional,Gremio,1,3,1,1,2,4,2,4,6,19,17,36,InternacionalGremio,1
2546,2546,7578,2021,30,6/11/2021,Fluminense,Sport,1,1,0,0,1,1,0,2,2,11,12,23,FluminenseSport,0
2547,2547,7579,2021,30,7/11/2021,Bragantino,Athletico-PR,2,3,0,0,2,3,0,5,5,16,25,41,BragantinoAthletico-PR,0
2548,2548,7580,2021,30,7/11/2021,Atletico-MG,America-MG,3,2,0,0,3,2,0,5,5,21,10,31,Atletico-MGAmerica-MG,1
2549,2549,7581,2021,30,7/11/2021,Santos,Palmeiras,3,2,0,0,3,2,0,5,5,14,17,31,SantosPalmeiras,1
2550,2550,7582,2021,30,7/11/2021,Bahia,Sao Paulo,1,2,0,0,1,2,0,3,3,11,18,29,BahiaSao Paulo,0
2551,2551,7583,2021,30,7/11/2021,Ceara,Cuiaba,3,1,0,0,3,1,0,4,4,15,13,28,CearaCuiaba,0
2552,2552,7584,2021,30,8/11/2021,Chapecoense,Flamengo,3,3,1,1,4,4,2,6,8,14,11,25,ChapecoenseFlamengo,0
2553,2553,7585,2021,30,23/11/2021,Atletico-GO,Juventude,1,2,0,0,1,2,0,3,3,19,16,35,Atletico-GOJuventude,0
2554,2554,7586,2021,32,13/11/2021,Atletico-GO,Santos,2,3,0,0,2,3,0,5,5,13,13,26,Atletico-GOSantos,0
2555,2555,7587,2021,32,13/11/2021,America-MG,Gremio,3,1,0,0,3,1,0,4,4,14,16,30,America-MGGremio,0
2556,2556,7588,2021,32,13/11/2021,Bragantino,Fortaleza,3,4,0,0,3,4,0,7,7,25,12,37,BragantinoFortaleza,0
2557,2557,7589,2021,32,13/11/2021,Internacional,Athletico-PR,7,3,0,0,7,3,0,10,10,17,13,30,InternacionalAthletico-PR,0
2558,2558,7590,2021,32,13/11/2021,Corinthians,Cuiaba,1,1,0,0,1,1,0,2,2,15,9,24,CorinthiansCuiaba,0
2559,2559,7591,2021,32,14/11/2021,Sao Paulo,Flamengo,1,1,1,0,2,1,1,2,3,6,9,15,Sao PauloFlamengo,0
2560,2560,7592,2021,32,14/11/2021,Fluminense,Palmeiras,4,6,1,2,5,8,3,10,13,12,20,32,FluminensePalmeiras,0
2561,2561,7593,2021,32,14/11/2021,Ceara,Sport,1,2,0,0,1,2,0,3,3,12,17,29,CearaSport,0
2562,2562,7594,2021,32,14/11/2021,Chapecoense,Juventude,3,3,0,0,3,3,0,6,6,15,17,32,ChapecoenseJuventude,0
2563,2563,7595,2021,32,2/12/2021,Bahia,Atletico-MG,2,3,0,0,2,3,0,5,5,13,12,25,BahiaAtletico-MG,0
2564,2564,7596,2021,33,16/11/2021,Athletico-PR,Atletico-MG,1,2,0,0,1,2,0,3,3,15,14,29,Athletico-PRAtletico-MG,0
2565,2565,7597,2021,33,16/11/2021,Gremio,Bragantino,0,2,0,0,0,2,0,2,2,15,17,32,GremioBragantino,0
2566,2566,7598,2021,33,17/11/2021,America-MG,Atletico-GO,1,1,0,0,1,1,0,2,2,7,14,21,America-MGAtletico-GO,0
2567,2567,7599,2021,33,17/11/2021,Santos,Chapecoense,1,2,0,0,1,2,0,3,3,14,14,28,SantosChapecoense,0
2568,2568,7600,2021,33,17/11/2021,Cuiaba,Internacional,4,1,0,0,4,1,0,5,5,14,17,31,CuiabaInternacional,0
2569,2569,7601,2021,33,17/11/2021,Fortaleza,Ceara,1,4,0,0,1,4,0,5,5,14,14,28,FortalezaCeara,1
2570,2570,7602,2021,33,17/11/2021,Palmeiras,Sao Paulo,1,2,0,0,1,2,0,3,3,12,19,31,PalmeirasSao Paulo,1
2571,2571,7603,2021,33,17/11/2021,Juventude,Fluminense,2,1,0,0,2,1,0,3,3,20,19,39,JuventudeFluminense,0
2572,2572,7604,2021,33,17/11/2021,Flamengo,Corinthians,1,2,0,0,1,2,0,3,3,15,8,23,FlamengoCorinthians,0
2573,2573,7605,2021,33,18/11/2021,Sport,Bahia,1,3,0,0,1,3,0,4,4,19,14,33,SportBahia,0
2574,2574,7606,2021,35,23/11/2021,Palmeiras,Atletico-MG,4,3,0,0,4,3,0,7,7,16,22,38,PalmeirasAtletico-MG,0
2575,2575,7607,2021,35,24/11/2021,Fluminense,Internacional,5,5,0,1,5,6,1,10,11,20,18,38,FluminenseInternacional,0
2576,2576,7608,2021,35,25/11/2021,Santos,Fortaleza,3,2,0,0,3,2,0,5,5,15,15,30,SantosFortaleza,0
2577,2577,7609,2021,35,25/11/2021,Ceara,Corinthians,3,4,0,0,3,4,0,7,7,16,13,29,CearaCorinthians,0
2578,2578,7610,2021,35,29/11/2021,Atletico-GO,Bahia,5,3,0,1,5,4,1,8,9,16,20,36,Atletico-GOBahia,0
2579,2579,7611,2021,35,30/11/2021,Juventude,Bragantino,3,3,0,0,3,3,0,6,6,15,25,40,JuventudeBragantino,0
2580,2580,7612,2021,35,30/11/2021,America-MG,Chapecoense,2,2,0,0,2,2,0,4,4,10,11,21,America-MGChapecoense,0
2581,2581,7613,2021,35,2/12/2021,Gremio,Sao Paulo,3,2,0,0,3,2,0,5,5,17,13,30,GremioSao Paulo,0
2582,2582,7614,2021,35,3/12/2021,Athletico-PR,Cuiaba,4,6,0,1,4,7,1,10,11,15,14,29,Athletico-PRCuiaba,0
2583,2583,7615,2021,35,3/12/2021,Sport,Flamengo,2,3,0,0,2,3,0,5,5,13,11,24,SportFlamengo,0
2584,2584,7616,2021,36,26/11/2021,Bahia,Gremio,3,3,0,0,3,3,0,6,6,15,15,30,BahiaGremio,0
2585,2585,7617,2021,36,27/11/2021,Bragantino,America-MG,3,2,0,0,3,2,0,5,5,21,14,35,BragantinoAmerica-MG,0
2586,2586,7618,2021,36,27/11/2021,Sao Paulo,Sport,0,1,0,0,0,1,0,1,1,16,14,30,Sao PauloSport,0
2587,2587,7619,2021,36,28/11/2021,Corinthians,Athletico-PR,5,3,0,0,5,3,0,8,8,14,19,33,CorinthiansAthletico-PR,0
2588,2588,7620,2021,36,28/11/2021,Atletico-MG,Fluminense,6,3,0,0,6,3,0,9,9,22,18,40,Atletico-MGFluminense,0
2589,2589,7621,2021,36,28/11/2021,Internacional,Santos,1,2,0,0,1,2,0,3,3,16,17,33,InternacionalSantos,0
2590,2590,7622,2021,36,30/11/2021,Flamengo,Ceara,6,1,0,0,6,1,0,7,7,20,19,39,FlamengoCeara,0
2591,2591,7623,2021,36,30/11/2021,Cuiaba,Palmeiras,4,2,0,1,4,3,1,6,7,15,10,25,CuiabaPalmeiras,0
2592,2592,7624,2021,36,3/12/2021,Chapecoense,Atletico-GO,2,3,0,0,2,3,0,5,5,17,17,34,ChapecoenseAtletico-GO,0
2593,2593,7625,2021,36,3/12/2021,Fortaleza,Juventude,2,0,0,0,2,0,0,2,2,20,14,34,FortalezaJuventude,0
2594,2594,7626,2021,37,5/12/2021,Bahia,Fluminense,2,5,1,1,3,6,2,7,9,14,20,34,BahiaFluminense,0
2595,2595,7627,2021,37,5/12/2021,Corinthians,Gremio,1,3,0,0,1,3,0,4,4,7,22,29,CorinthiansGremio,0
2596,2596,7628,2021,37,5/12/2021,Atletico-MG,Bragantino,1,2,0,0,1,2,0,3,3,5,10,15,Atletico-MGBragantino,0
2597,2597,7629,2021,37,5/12/2021,Ceara,America-MG,0,2,0,0,0,2,0,2,2,14,13,27,CearaAmerica-MG,0
2598,2598,7630,2021,37,6/12/2021,Sao Paulo,Juventude,5,3,0,0,5,3,0,8,8,25,13,38,Sao PauloJuventude,0
2599,2599,7631,2021,37,6/12/2021,Athletico-PR,Palmeiras,1,1,0,0,1,1,0,2,2,11,10,21,Athletico-PRPalmeiras,0
2600,2600,7632,2021,37,6/12/2021,Cuiaba,Fortaleza,1,3,0,0,1,3,0,4,4,22,23,45,CuiabaFortaleza,0
2601,2601,7633,2021,37,6/12/2021,Internacional,Atletico-GO,3,2,0,0,3,2,0,5,5,14,9,23,InternacionalAtletico-GO,0
2602,2602,7634,2021,37,6/12/2021,Flamengo,Santos,3,3,0,0,3,3,0,6,6,23,14,37,FlamengoSantos,0
2603,2603,7635,2021,37,6/12/2021,Chapecoense,Sport,3,4,1,0,4,4,1,7,8,16,27,43,ChapecoenseSport,0
2604,2604,7636,2021,38,9/12/2021,Fortaleza,Bahia,4,2,0,0,4,2,0,6,6,15,17,32,FortalezaBahia,0
2605,2605,7637,2021,38,9/12/2021,Atletico-GO,Flamengo,4,2,0,0,4,2,0,6,6,15,7,22,Atletico-GOFlamengo,0
2606,2606,7638,2021,38,9/12/2021,Palmeiras,Ceara,2,0,0,0,2,0,0,2,2,18,4,22,PalmeirasCeara,0
2607,2607,7639,2021,38,9/12/2021,Fluminense,Chapecoense,3,2,0,0,3,2,0,5,5,12,10,22,FluminenseChapecoense,0
2608,2608,7640,2021,38,9/12/2021,America-MG,Sao Paulo,2,2,0,0,2,2,0,4,4,18,18,36,America-MGSao Paulo,0
2609,2609,7641,2021,38,9/12/2021,Bragantino,Internacional,4,5,0,0,4,5,0,9,9,23,26,49,BragantinoInternacional,0
2610,2610,7642,2021,38,9/12/2021,Sport,Athletico-PR,1,1,0,0,1,1,0,2,2,17,14,31,SportAthletico-PR,0
2611,2611,7643,2021,38,9/12/2021,Juventude,Corinthians,1,2,0,1,1,3,1,3,4,10,22,32,JuventudeCorinthians,0
2612,2612,7644,2021,38,9/12/2021,Gremio,Atletico-MG,3,1,0,0,3,1,0,4,4,15,11,26,GremioAtletico-MG,0
2613,2613,7645,2021,38,9/12/2021,Santos,Cuiaba,1,2,0,0,1,2,0,3,3,17,15,32,SantosCuiaba,0
2614,2614,7646,2022,1,9/4/2022,Fluminense,Santos,1,0,0,0,1,0,0,1,1,14,18,32,FluminenseSantos,0
2615,2615,7647,2022,1,9/4/2022,Atletico-GO,Flamengo,3,2,0,0,3,2,0,5,5,7,11,18,Atletico-GOFlamengo,0
2616,2616,7648,2022,1,9/4/2022,Palmeiras,Ceara,4,9,0,1,4,10,1,13,14,17,14,31,PalmeirasCeara,0
2617,2617,7649,2022,1,10/4/2022,Coritiba,Goias,2,4,0,0,2,4,0,6,6,10,12,22,CoritibaGoias,0
2618,2618,7650,2022,1,10/4/2022,Botafogo-RJ,Corinthians,1,4,0,0,1,4,0,5,5,6,18,24,Botafogo-RJCorinthians,0
2619,2619,7651,2022,1,10/4/2022,Atletico-MG,Internacional,2,4,0,0,2,4,0,6,6,12,18,30,Atletico-MGInternacional,0
2620,2620,7652,2022,1,10/4/2022,Fortaleza,Cuiaba,2,3,0,0,2,3,0,5,5,22,23,45,FortalezaCuiaba,0
2621,2621,7653,2022,1,10/4/2022,Avai,America-MG,3,3,0,2,3,5,2,6,8,20,18,38,AvaiAmerica-MG,0
2622,2622,7654,2022,1,10/4/2022,Sao Paulo,Athletico-PR,1,3,0,0,1,3,0,4,4,17,14,31,Sao PauloAthletico-PR,0
2623,2623,7655,2022,1,11/4/2022,Juventude,Bragantino,4,5,0,0,4,5,0,9,9,16,17,33,JuventudeBragantino,0
2624,2624,7656,2022,2,16/4/2022,Goias,Palmeiras,4,0,0,0,4,0,0,4,4,16,7,23,GoiasPalmeiras,0
2625,2625,7657,2022,2,16/4/2022,America-MG,Juventude,3,0,0,1,3,1,1,3,4,19,11,30,America-MGJuventude,0
2626,2626,7658,2022,2,16/4/2022,Corinthians,Avai,1,1,0,0,1,1,0,2,2,22,12,34,CorinthiansAvai,0
2627,2627,7659,2022,2,16/4/2022,Cuiaba,Fluminense,2,1,0,0,2,1,0,3,3,18,14,32,CuiabaFluminense,0
2628,2628,7660,2022,2,17/4/2022,Santos,Coritiba,2,4,0,0,2,4,0,6,6,22,10,32,SantosCoritiba,0
2629,2629,7661,2022,2,17/4/2022,Flamengo,Sao Paulo,2,6,0,0,2,6,0,8,8,17,25,42,FlamengoSao Paulo,0
2630,2630,7662,2022,2,17/4/2022,Athletico-PR,Atletico-MG,2,3,0,0,2,3,0,5,5,9,14,23,Athletico-PRAtletico-MG,0
2631,2631,7663,2022,2,17/4/2022,Internacional,Fortaleza,5,5,0,0,5,5,0,10,10,15,13,28,InternacionalFortaleza,0
2632,2632,7664,2022,2,17/4/2022,Bragantino,Atletico-GO,1,4,0,0,1,4,0,5,5,12,9,21,BragantinoAtletico-GO,0
2633,2633,7665,2022,2,17/4/2022,Ceara,Botafogo-RJ,1,4,1,0,2,4,1,5,6,16,15,31,CearaBotafogo-RJ,0
2634,2634,7666,2022,4,20/4/2022,Flamengo,Palmeiras,3,4,0,0,3,4,0,7,7,15,21,36,FlamengoPalmeiras,0
2635,2635,7667,2022,4,30/4/2022,Ceara,Bragantino,1,5,0,1,1,6,1,6,7,11,20,31,CearaBragantino,0
2636,2636,7668,2022,4,30/4/2022,America-MG,Athletico-PR,1,0,0,0,1,0,0,1,1,19,12,31,America-MGAthletico-PR,0
2637,2637,7669,2022,4,30/4/2022,Goias,Atletico-MG,5,4,0,0,5,4,0,9,9,20,15,35,GoiasAtletico-MG,0
2638,2638,7670,2022,4,30/4/2022,Cuiaba,Atletico-GO,2,0,0,0,2,0,0,2,2,12,14,26,CuiabaAtletico-GO,0
2639,2639,7671,2022,4,1/5/2022,Botafogo-RJ,Juventude,2,5,0,0,2,5,0,7,7,14,18,32,Botafogo-RJJuventude,0
2640,2640,7672,2022,4,1/5/2022,Corinthians,Fortaleza,1,3,0,0,1,3,0,4,4,14,14,28,CorinthiansFortaleza,0
2641,2641,7673,2022,4,1/5/2022,Coritiba,Fluminense,0,3,0,1,0,4,1,3,4,13,16,29,CoritibaFluminense,0
2642,2642,7674,2022,4,1/5/2022,Internacional,Avai,2,4,0,0,2,4,0,6,6,15,16,31,InternacionalAvai,0
2643,2643,7675,2022,4,2/5/2022,Sao Paulo,Santos,2,4,0,0,2,4,0,6,6,15,8,23,Sao PauloSantos,1
2644,2644,7676,2022,3,23/4/2022,Bragantino,Sao Paulo,5,2,0,0,5,2,0,7,7,13,12,25,BragantinoSao Paulo,1
2645,2645,7677,2022,3,23/4/2022,Athletico-PR,Flamengo,4,2,0,0,4,2,0,6,6,15,10,25,Athletico-PRFlamengo,0
2646,2646,7678,2022,3,23/4/2022,Palmeiras,Corinthians,1,2,0,0,1,2,0,3,3,13,14,27,PalmeirasCorinthians,1
2647,2647,7679,2022,3,23/4/2022,Fluminense,Internacional,5,3,0,0,5,3,0,8,8,15,12,27,FluminenseInternacional,0
2648,2648,7680,2022,3,23/4/2022,Atletico-MG,Coritiba,2,1,0,0,2,1,0,3,3,10,8,18,Atletico-MGCoritiba,0
2649,2649,7681,2022,3,24/4/2022,Santos,America-MG,2,0,0,0,2,0,0,2,2,16,8,24,SantosAmerica-MG,0
2650,2650,7682,2022,3,24/4/2022,Juventude,Cuiaba,2,4,1,0,3,4,1,6,7,18,19,37,JuventudeCuiaba,0
2651,2651,7683,2022,3,24/4/2022,Atletico-GO,Botafogo-RJ,2,1,0,0,2,1,0,3,3,11,5,16,Atletico-GOBotafogo-RJ,0
2652,2652,7684,2022,3,25/4/2022,Avai,Goias,5,5,1,0,6,5,1,10,11,20,20,40,AvaiGoias,0
2653,2653,7685,2022,3,1/6/2022,Fortaleza,Ceara,5,4,1,0,6,4,1,9,10,18,18,36,FortalezaCeara,1
2654,2654,7686,2022,5,7/5/2022,Atletico-MG,America-MG,4,4,0,1,4,5,1,8,9,7,22,29,Atletico-MGAmerica-MG,1
2655,2655,7687,2022,5,7/5/2022,Athletico-PR,Ceara,5,4,0,0,5,4,0,9,9,19,8,27,Athletico-PRCeara,0
2656,2656,7688,2022,5,8/5/2022,Flamengo,Botafogo-RJ,1,3,0,0,1,3,0,4,4,13,18,31,FlamengoBotafogo-RJ,1
2657,2657,7689,2022,5,8/5/2022,Palmeiras,Fluminense,1,2,0,0,1,2,0,3,3,10,13,23,PalmeirasFluminense,0
2658,2658,7690,2022,5,8/5/2022,Atletico-GO,Goias,4,3,0,1,4,4,1,7,8,12,11,23,Atletico-GOGoias,1
2659,2659,7691,2022,5,8/5/2022,Bragantino,Corinthians,1,2,0,0,1,2,0,3,3,11,9,20,BragantinoCorinthians,1
2660,2660,7692,2022,5,8/5/2022,Santos,Cuiaba,1,2,0,0,1,2,0,3,3,14,12,26,SantosCuiaba,0
2661,2661,7693,2022,5,8/5/2022,Juventude,Internacional,5,5,0,0,5,5,0,10,10,22,13,35,JuventudeInternacional,1
2662,2662,7694,2022,5,8/5/2022,Fortaleza,Sao Paulo,2,3,0,0,2,3,0,5,5,16,14,30,FortalezaSao Paulo,0
2663,2663,7695,2022,5,9/5/2022,Avai,Coritiba,3,3,0,0,3,3,0,6,6,14,13,27,AvaiCoritiba,0
2664,2664,7696,2022,7,11/5/2022,Bragantino,Atletico-MG,3,2,1,0,4,2,1,5,6,13,5,18,BragantinoAtletico-MG,0
2665,2665,7697,2022,7,21/5/2022,Atletico-GO,Coritiba,4,1,0,2,4,3,2,5,7,14,13,27,Atletico-GOCoritiba,0
2666,2666,7698,2022,7,21/5/2022,Flamengo,Goias,1,3,0,0,1,3,0,4,4,14,19,33,FlamengoGoias,0
2667,2667,7699,2022,7,21/5/2022,Santos,Ceara,1,5,0,1,1,6,1,6,7,9,13,22,SantosCeara,0
2668,2668,7700,2022,7,21/5/2022,Juventude,Palmeiras,3,0,0,0,3,0,0,3,3,20,6,26,JuventudePalmeiras,0
2669,2669,7701,2022,7,21/5/2022,Cuiaba,Internacional,2,7,2,0,4,7,2,9,11,9,12,21,CuiabaInternacional,0
2670,2670,7702,2022,7,21/5/2022,America-MG,Botafogo-RJ,2,1,0,0,2,1,0,3,3,19,9,28,America-MGBotafogo-RJ,0
2671,2671,7703,2022,7,22/5/2022,Corinthians,Sao Paulo,2,3,0,0,2,3,0,5,5,11,12,23,CorinthiansSao Paulo,1
2672,2672,7704,2022,7,22/5/2022,Fortaleza,Fluminense,1,1,0,0,1,1,0,2,2,13,14,27,FortalezaFluminense,0
2673,2673,7705,2022,7,22/5/2022,Athletico-PR,Avai,2,6,0,0,2,6,0,8,8,23,17,40,Athletico-PRAvai,0
2674,2674,7706,2022,6,14/5/2022,Palmeiras,Bragantino,2,2,0,0,2,2,0,4,4,11,14,25,PalmeirasBragantino,1
2675,2675,7707,2022,6,14/5/2022,Ceara,Flamengo,5,5,0,0,5,5,0,10,10,18,22,40,CearaFlamengo,0
2676,2676,7708,2022,6,14/5/2022,Internacional,Corinthians,2,2,0,0,2,2,0,4,4,8,7,15,InternacionalCorinthians,0
2677,2677,7709,2022,6,14/5/2022,Atletico-MG,Atletico-GO,1,2,0,0,1,2,0,3,3,16,14,30,Atletico-MGAtletico-GO,0
2678,2678,7710,2022,6,14/5/2022,Fluminense,Athletico-PR,3,2,0,0,3,2,0,5,5,12,12,24,FluminenseAthletico-PR,0
2679,2679,7711,2022,6,15/5/2022,Sao Paulo,Cuiaba,2,1,0,1,2,2,1,3,4,5,15,20,Sao PauloCuiaba,0
2680,2680,7712,2022,6,15/5/2022,Coritiba,America-MG,1,5,0,1,1,6,1,6,7,11,23,34,CoritibaAmerica-MG,0
2681,2681,7713,2022,6,15/5/2022,Botafogo-RJ,Fortaleza,3,1,0,1,3,2,1,4,5,14,15,29,Botafogo-RJFortaleza,0
2682,2682,7714,2022,6,15/5/2022,Avai,Juventude,2,5,0,2,2,7,2,7,9,18,16,34,AvaiJuventude,0
3032,3032,7715,2022,6,15/5/2022,Goias,Santos,0,0,0,0,0,0,0,0,0,14,11,25,GoiasSantos,0
2683,2683,7716,2022,8,28/5/2022,Goias,Bragantino,2,3,0,1,2,4,1,5,6,18,22,40,GoiasBragantino,0
2684,2684,7717,2022,8,28/5/2022,Sao Paulo,Ceara,3,5,1,0,4,5,1,8,9,19,10,29,Sao PauloCeara,0
2685,2685,7718,2022,8,28/5/2022,Fortaleza,Juventude,2,3,0,0,2,3,0,5,5,10,16,26,FortalezaJuventude,0
2686,2686,7719,2022,8,29/5/2022,Coritiba,Botafogo-RJ,5,3,0,0,5,3,0,8,8,10,12,22,CoritibaBotafogo-RJ,0
2687,2687,7720,2022,8,29/5/2022,Santos,Palmeiras,5,1,0,0,5,1,0,6,6,19,15,34,SantosPalmeiras,1
2688,2688,7721,2022,8,29/5/2022,Cuiaba,Athletico-PR,5,0,0,0,5,0,0,5,5,9,17,26,CuiabaAthletico-PR,0
2689,2689,7722,2022,8,29/5/2022,Corinthians,America-MG,2,1,0,0,2,1,0,3,3,13,19,32,CorinthiansAmerica-MG,0
2690,2690,7723,2022,8,29/5/2022,Fluminense,Flamengo,3,5,1,1,4,6,2,8,10,9,16,25,FluminenseFlamengo,1
2691,2691,7724,2022,8,29/5/2022,Atletico-MG,Avai,3,2,0,1,3,3,1,5,6,14,10,24,Atletico-MGAvai,0
2692,2692,7725,2022,8,30/5/2022,Internacional,Atletico-GO,1,2,0,0,1,2,0,3,3,7,16,23,InternacionalAtletico-GO,0
2693,2693,7726,2022,9,4/6/2022,America-MG,Cuiaba,0,1,0,0,0,1,0,1,1,11,11,22,America-MGCuiaba,0
2694,2694,7727,2022,9,4/6/2022,Athletico-PR,Santos,5,3,0,0,5,3,0,8,8,21,11,32,Athletico-PRSantos,0
2695,2695,7728,2022,9,4/6/2022,Ceara,Coritiba,1,4,0,0,1,4,0,5,5,14,9,23,CearaCoritiba,0
2696,2696,7729,2022,9,4/6/2022,Avai,Sao Paulo,2,2,0,0,2,2,0,4,4,11,23,34,AvaiSao Paulo,0
2697,2697,7730,2022,9,4/6/2022,Atletico-GO,Corinthians,3,3,0,0,3,3,0,6,6,9,11,20,Atletico-GOCorinthians,0
2698,2698,7731,2022,9,5/6/2022,Juventude,Fluminense,3,4,0,1,3,5,1,7,8,21,10,31,JuventudeFluminense,0
2699,2699,7732,2022,9,5/6/2022,Flamengo,Fortaleza,3,4,0,0,3,4,0,7,7,9,21,30,FlamengoFortaleza,0
2700,2700,7733,2022,9,5/6/2022,Palmeiras,Atletico-MG,1,3,0,0,1,3,0,4,4,8,19,27,PalmeirasAtletico-MG,0
2701,2701,7734,2022,9,5/6/2022,Bragantino,Internacional,3,3,0,0,3,3,0,6,6,20,12,32,BragantinoInternacional,0
2702,2702,7735,2022,9,6/6/2022,Botafogo-RJ,Goias,2,2,0,0,2,2,0,4,4,11,22,33,Botafogo-RJGoias,0
2703,2703,7736,2022,10,7/6/2022,Cuiaba,Corinthians,1,2,1,0,2,2,1,3,4,10,11,21,CuiabaCorinthians,0
2704,2704,7737,2022,10,8/6/2022,America-MG,Ceara,2,3,0,0,2,3,0,5,5,18,20,38,America-MGCeara,0
2705,2705,7738,2022,10,8/6/2022,Juventude,Athletico-PR,2,4,0,0,2,4,0,6,6,9,10,19,JuventudeAthletico-PR,0
2706,2706,7739,2022,10,8/6/2022,Atletico-GO,Avai,1,4,0,1,1,5,1,5,6,12,12,24,Atletico-GOAvai,0
2707,2707,7740,2022,10,8/6/2022,Bragantino,Flamengo,1,4,1,0,2,4,1,5,6,11,16,27,BragantinoFlamengo,0
2708,2708,7741,2022,10,8/6/2022,Fluminense,Atletico-MG,3,3,0,0,3,3,0,6,6,13,15,28,FluminenseAtletico-MG,0
2709,2709,7742,2022,10,8/6/2022,Santos,Internacional,2,1,0,0,2,1,0,3,3,11,16,27,SantosInternacional,0
2710,2710,7743,2022,10,9/6/2022,Palmeiras,Botafogo-RJ,1,1,0,0,1,1,0,2,2,16,14,30,PalmeirasBotafogo-RJ,0
2711,2711,7744,2022,10,9/6/2022,Coritiba,Sao Paulo,3,3,0,0,3,3,0,6,6,12,13,25,CoritibaSao Paulo,0
2712,2712,7745,2022,10,9/6/2022,Fortaleza,Goias,1,2,0,0,1,2,0,3,3,12,18,30,FortalezaGoias,0
2713,2713,7746,2022,11,11/6/2022,Corinthians,Juventude,1,4,0,0,1,4,0,5,5,15,12,27,CorinthiansJuventude,0
2714,2714,7747,2022,11,11/6/2022,Atletico-MG,Santos,4,4,0,1,4,5,1,8,9,11,16,27,Atletico-MGSantos,0
2715,2715,7748,2022,11,11/6/2022,Fluminense,Atletico-GO,3,2,1,0,4,2,1,5,6,10,13,23,FluminenseAtletico-GO,0
2716,2716,7749,2022,11,11/6/2022,Cuiaba,Bragantino,1,3,0,0,1,3,0,4,4,14,15,29,CuiabaBragantino,0
2717,2717,7750,2022,11,11/6/2022,Internacional,Flamengo,3,3,0,0,3,3,0,6,6,15,14,29,InternacionalFlamengo,0
2718,2718,7751,2022,11,12/6/2022,Goias,Ceara,6,2,0,1,6,3,1,8,9,20,14,34,GoiasCeara,0
2719,2719,7752,2022,11,12/6/2022,Sao Paulo,America-MG,2,2,0,0,2,2,0,4,4,14,16,30,Sao PauloAmerica-MG,0
2720,2720,7753,2022,11,12/6/2022,Coritiba,Palmeiras,1,2,1,0,2,2,1,3,4,11,13,24,CoritibaPalmeiras,0
2721,2721,7754,2022,11,12/6/2022,Fortaleza,Athletico-PR,1,3,0,0,1,3,0,4,4,13,12,25,FortalezaAthletico-PR,0
2722,2722,7755,2022,11,13/6/2022,Botafogo-RJ,Avai,4,5,0,1,4,6,1,9,10,19,22,41,Botafogo-RJAvai,0
2723,2723,7756,2022,12,14/6/2022,Juventude,Santos,1,2,1,0,2,2,1,3,4,19,14,33,JuventudeSantos,0
2724,2724,7757,2022,12,15/6/2022,Ceara,Atletico-MG,2,3,0,0,2,3,0,5,5,14,17,31,CearaAtletico-MG,0
2725,2725,7758,2022,12,15/6/2022,Bragantino,Coritiba,2,1,0,0,2,1,0,3,3,13,12,25,BragantinoCoritiba,0
2726,2726,7759,2022,12,15/6/2022,Goias,Internacional,4,3,0,0,4,3,0,7,7,11,14,25,GoiasInternacional,0
2727,2727,7760,2022,12,15/6/2022,Flamengo,Cuiaba,1,2,0,0,1,2,0,3,3,17,14,31,FlamengoCuiaba,0
2728,2728,7761,2022,12,15/6/2022,Athletico-PR,Corinthians,2,2,1,1,3,3,2,4,6,12,9,21,Athletico-PRCorinthians,0
2729,2729,7762,2022,12,15/6/2022,America-MG,Fluminense,3,1,1,0,4,1,1,4,5,12,9,21,America-MGFluminense,0
2730,2730,7763,2022,12,16/6/2022,Botafogo-RJ,Sao Paulo,6,3,0,0,6,3,0,9,9,17,17,34,Botafogo-RJSao Paulo,0
2731,2731,7764,2022,12,16/6/2022,Palmeiras,Atletico-GO,2,1,0,1,2,2,1,3,4,12,16,28,PalmeirasAtletico-GO,0
2732,2732,7765,2022,12,16/6/2022,Avai,Fortaleza,1,3,0,0,1,3,0,4,4,16,17,33,AvaiFortaleza,0
2733,2733,7766,2022,13,18/6/2022,Cuiaba,Ceara,0,2,0,0,0,2,0,2,2,15,10,25,CuiabaCeara,0
2734,2734,7767,2022,13,18/6/2022,Santos,Bragantino,4,3,0,0,4,3,0,7,7,13,18,31,SantosBragantino,1
2735,2735,7768,2022,13,19/6/2022,Atletico-MG,Flamengo,4,1,0,0,4,1,0,5,5,18,13,31,Atletico-MGFlamengo,0
2736,2736,7769,2022,13,19/6/2022,Coritiba,Athletico-PR,5,6,2,0,7,6,2,11,13,12,11,23,CoritibaAthletico-PR,1
2737,2737,7770,2022,13,19/6/2022,Corinthians,Goias,1,4,0,0,1,4,0,5,5,7,13,20,CorinthiansGoias,0
2738,2738,7771,2022,13,19/6/2022,Internacional,Botafogo-RJ,5,6,2,2,7,8,4,11,15,13,13,26,InternacionalBotafogo-RJ,0
2739,2739,7772,2022,13,19/6/2022,Fortaleza,America-MG,1,0,0,0,1,0,0,1,1,8,5,13,FortalezaAmerica-MG,0
2740,2740,7773,2022,13,19/6/2022,Atletico-GO,Juventude,3,4,0,1,3,5,1,7,8,15,11,26,Atletico-GOJuventude,0
2741,2741,7774,2022,13,19/6/2022,Fluminense,Avai,0,3,0,0,0,3,0,3,3,8,15,23,FluminenseAvai,0
2742,2742,7775,2022,13,20/6/2022,Sao Paulo,Palmeiras,3,1,0,0,3,1,0,4,4,17,9,26,Sao PauloPalmeiras,1
2743,2743,7776,2022,14,24/6/2022,Internacional,Coritiba,2,4,0,0,2,4,0,6,6,9,16,25,InternacionalCoritiba,0
2744,2744,7777,2022,14,25/6/2022,Athletico-PR,Bragantino,4,1,0,0,4,1,0,5,5,14,11,25,Athletico-PRBragantino,0
2745,2745,7778,2022,14,25/6/2022,Flamengo,America-MG,1,2,0,0,1,2,0,3,3,17,13,30,FlamengoAmerica-MG,0
2746,2746,7779,2022,14,25/6/2022,Corinthians,Santos,3,3,0,0,3,3,0,6,6,20,10,30,CorinthiansSantos,1
2747,2747,7780,2022,14,25/6/2022,Atletico-MG,Fortaleza,0,5,0,0,0,5,0,5,5,14,15,29,Atletico-MGFortaleza,0
2748,2748,7781,2022,14,26/6/2022,Avai,Palmeiras,4,1,0,0,4,1,0,5,5,18,17,35,AvaiPalmeiras,0
2749,2749,7782,2022,14,26/6/2022,Botafogo-RJ,Fluminense,3,2,0,0,3,2,0,5,5,18,14,32,Botafogo-RJFluminense,1
2750,2750,7783,2022,14,26/6/2022,Goias,Cuiaba,3,4,0,1,3,5,1,7,8,14,16,30,GoiasCuiaba,0
2751,2751,7784,2022,14,26/6/2022,Ceara,Atletico-GO,2,2,0,0,2,2,0,4,4,16,18,34,CearaAtletico-GO,0
2752,2752,7785,2022,14,26/6/2022,Sao Paulo,Juventude,3,4,0,0,3,4,0,7,7,15,7,22,Sao PauloJuventude,0
2753,2753,7786,2022,15,2/7/2022,Juventude,Atletico-MG,2,1,0,0,2,1,0,3,3,11,11,22,JuventudeAtletico-MG,0
2754,2754,7787,2022,15,2/7/2022,Fluminense,Corinthians,0,3,0,0,0,3,0,3,3,11,12,23,FluminenseCorinthians,0
2755,2755,7788,2022,15,2/7/2022,Santos,Flamengo,4,2,0,0,4,2,0,6,6,15,13,28,SantosFlamengo,0
2756,2756,7789,2022,15,2/7/2022,Ceara,Internacional,4,3,0,1,4,4,1,7,8,24,20,44,CearaInternacional,0
2757,2757,7790,2022,15,2/7/2022,Palmeiras,Athletico-PR,1,2,1,0,2,2,1,3,4,12,15,27,PalmeirasAthletico-PR,0
3033,3033,7791,2022,15,3/7/2022,Avai,Cuiaba,0,0,0,0,0,0,0,0,0,10,12,22,AvaiCuiaba,0
2758,2758,7792,2022,15,3/7/2022,Atletico-GO,Sao Paulo,5,7,0,0,5,7,0,12,12,9,20,29,Atletico-GOSao Paulo,0
2759,2759,7793,2022,15,3/7/2022,America-MG,Goias,2,2,0,0,2,2,0,4,4,14,8,22,America-MGGoias,0
2760,2760,7794,2022,15,3/7/2022,Coritiba,Fortaleza,2,3,1,0,3,3,1,5,6,11,22,33,CoritibaFortaleza,0
2761,2761,7795,2022,15,4/7/2022,Bragantino,Botafogo-RJ,1,4,1,0,2,4,1,5,6,11,19,30,BragantinoBotafogo-RJ,0
2762,2762,7796,2022,16,9/7/2022,Bragantino,Avai,1,3,0,0,1,3,0,4,4,5,6,11,BragantinoAvai,0
2763,2763,7797,2022,16,9/7/2022,Fluminense,Ceara,2,3,0,0,2,3,0,5,5,16,17,33,FluminenseCeara,0
2764,2764,7798,2022,16,9/7/2022,Goias,Athletico-PR,2,1,0,0,2,1,0,3,3,15,10,25,GoiasAthletico-PR,0
2765,2765,7799,2022,16,10/7/2022,Coritiba,Juventude,1,2,0,0,1,2,0,3,3,19,11,30,CoritibaJuventude,0
2766,2766,7800,2022,16,10/7/2022,Corinthians,Flamengo,2,4,0,0,2,4,0,6,6,7,12,19,CorinthiansFlamengo,0
2767,2767,7801,2022,16,10/7/2022,Santos,Atletico-GO,5,4,0,0,5,4,0,9,9,13,18,31,SantosAtletico-GO,0
2768,2768,7802,2022,16,10/7/2022,Fortaleza,Palmeiras,0,1,0,0,0,1,0,1,1,9,15,24,FortalezaPalmeiras,0
2769,2769,7803,2022,16,10/7/2022,Atletico-MG,Sao Paulo,1,1,0,0,1,1,0,2,2,12,16,28,Atletico-MGSao Paulo,0
2770,2770,7804,2022,16,10/7/2022,Cuiaba,Botafogo-RJ,1,2,0,2,1,4,2,3,5,7,11,18,CuiabaBotafogo-RJ,0
2771,2771,7805,2022,16,11/7/2022,Internacional,America-MG,0,5,0,0,0,5,0,5,5,5,8,13,InternacionalAmerica-MG,0
2772,2772,7806,2022,17,16/7/2022,Athletico-PR,Internacional,1,2,0,0,1,2,0,3,3,7,13,20,Athletico-PRInternacional,0
2773,2773,7807,2022,17,16/7/2022,Flamengo,Coritiba,0,1,0,0,0,1,0,1,1,13,11,24,FlamengoCoritiba,0
2774,2774,7808,2022,17,16/7/2022,Avai,Santos,5,3,0,0,5,3,0,8,8,17,12,29,AvaiSantos,0
2775,2775,7809,2022,17,16/7/2022,Ceara,Corinthians,1,1,0,0,1,1,0,2,2,18,5,23,CearaCorinthians,0
2776,2776,7810,2022,17,17/7/2022,Juventude,Goias,2,3,0,0,2,3,0,5,5,16,16,32,JuventudeGoias,0
2777,2777,7811,2022,17,17/7/2022,Sao Paulo,Fluminense,4,2,0,0,4,2,0,6,6,17,7,24,Sao PauloFluminense,0
2778,2778,7812,2022,17,17/7/2022,Botafogo-RJ,Atletico-MG,4,3,0,0,4,3,0,7,7,21,18,39,Botafogo-RJAtletico-MG,0
2779,2779,7813,2022,17,17/7/2022,Atletico-GO,Fortaleza,1,0,0,0,1,0,0,1,1,7,9,16,Atletico-GOFortaleza,0
2780,2780,7814,2022,17,17/7/2022,America-MG,Bragantino,3,1,0,0,3,1,0,4,4,8,18,26,America-MGBragantino,0
2781,2781,7815,2022,17,18/7/2022,Palmeiras,Cuiaba,3,1,0,0,3,1,0,4,4,17,12,29,PalmeirasCuiaba,0
2782,2782,7816,2022,18,19/7/2022,Ceara,Avai,0,2,0,0,0,2,0,2,2,17,14,31,CearaAvai,0
2783,2783,7817,2022,18,20/7/2022,Bragantino,Fortaleza,4,3,0,0,4,3,0,7,7,14,18,32,BragantinoFortaleza,0
2784,2784,7818,2022,18,20/7/2022,Goias,Fluminense,2,0,0,0,2,0,0,2,2,19,9,28,GoiasFluminense,0
2785,2785,7819,2022,18,20/7/2022,Athletico-PR,Atletico-GO,3,0,0,0,3,0,0,3,3,15,8,23,Athletico-PRAtletico-GO,0
2786,2786,7820,2022,18,20/7/2022,Flamengo,Juventude,3,3,0,1,3,4,1,6,7,14,13,27,FlamengoJuventude,0
2787,2787,7821,2022,18,20/7/2022,Internacional,Sao Paulo,4,5,0,0,4,5,0,9,9,11,10,21,InternacionalSao Paulo,0
2788,2788,7822,2022,18,20/7/2022,Santos,Botafogo-RJ,2,2,0,0,2,2,0,4,4,15,18,33,SantosBotafogo-RJ,0
2789,2789,7823,2022,18,20/7/2022,Corinthians,Coritiba,1,3,0,0,1,3,0,4,4,16,15,31,CorinthiansCoritiba,0
2790,2790,7824,2022,18,21/7/2022,Cuiaba,Atletico-MG,1,1,0,0,1,1,0,2,2,7,10,17,CuiabaAtletico-MG,0
2791,2791,7825,2022,18,21/7/2022,America-MG,Palmeiras,5,3,0,0,5,3,0,8,8,16,6,22,America-MGPalmeiras,0
2792,2792,7826,2022,19,23/7/2022,Sao Paulo,Goias,2,5,0,0,2,5,0,7,7,7,11,18,Sao PauloGoias,0
2793,2793,7827,2022,19,23/7/2022,Botafogo-RJ,Athletico-PR,0,2,0,0,0,2,0,2,2,16,15,31,Botafogo-RJAthletico-PR,0
2794,2794,7828,2022,19,24/7/2022,Avai,Flamengo,1,1,0,0,1,1,0,2,2,19,19,38,AvaiFlamengo,0
2795,2795,7829,2022,19,24/7/2022,Fluminense,Bragantino,5,2,1,0,6,2,1,7,8,11,20,31,FluminenseBragantino,0
2796,2796,7830,2022,19,24/7/2022,Palmeiras,Internacional,0,1,0,0,0,1,0,1,1,13,15,28,PalmeirasInternacional,0
2797,2797,7831,2022,19,24/7/2022,Juventude,Ceara,1,3,0,0,1,3,0,4,4,20,14,34,JuventudeCeara,0
2798,2798,7832,2022,19,24/7/2022,Atletico-MG,Corinthians,2,1,0,0,2,1,0,3,3,11,12,23,Atletico-MGCorinthians,0
2799,2799,7833,2022,19,24/7/2022,Atletico-GO,America-MG,0,1,0,0,0,1,0,1,1,4,12,16,Atletico-GOAmerica-MG,0
2800,2800,7834,2022,19,24/7/2022,Fortaleza,Santos,4,4,0,0,4,4,0,8,8,11,11,22,FortalezaSantos,0
2801,2801,7835,2022,19,25/7/2022,Coritiba,Cuiaba,5,3,1,0,6,3,1,8,9,16,12,28,CoritibaCuiaba,0
2802,2802,7836,2022,20,30/7/2022,Goias,Coritiba,1,2,0,1,1,3,1,3,4,18,11,29,GoiasCoritiba,0
2803,2803,7837,2022,20,30/7/2022,Ceara,Palmeiras,3,3,1,0,4,3,1,6,7,14,11,25,CearaPalmeiras,0
3034,3034,7838,2022,20,30/7/2022,Corinthians,Botafogo-RJ,0,0,0,0,0,0,0,0,0,6,6,12,CorinthiansBotafogo-RJ,0
2804,2804,7839,2022,20,30/7/2022,Flamengo,Atletico-GO,0,7,0,1,0,8,1,7,8,12,16,28,FlamengoAtletico-GO,0
2805,2805,7840,2022,20,31/7/2022,Athletico-PR,Sao Paulo,3,4,0,0,3,4,0,7,7,15,13,28,Athletico-PRSao Paulo,0
2806,2806,7841,2022,20,31/7/2022,Internacional,Atletico-MG,1,1,0,0,1,1,0,2,2,13,12,25,InternacionalAtletico-MG,0
2807,2807,7842,2022,20,31/7/2022,Cuiaba,Fortaleza,2,4,0,0,2,4,0,6,6,11,10,21,CuiabaFortaleza,0
2808,2808,7843,2022,20,31/7/2022,America-MG,Avai,1,0,0,0,1,0,0,1,1,16,17,33,America-MGAvai,0
2809,2809,7844,2022,20,31/7/2022,Bragantino,Juventude,1,1,0,0,1,1,0,2,2,11,15,26,BragantinoJuventude,0
2810,2810,7845,2022,20,1/8/2022,Santos,Fluminense,2,5,0,0,2,5,0,7,7,14,12,26,SantosFluminense,0
2811,2811,7846,2022,21,6/8/2022,Juventude,America-MG,1,2,0,0,1,2,0,3,3,12,18,30,JuventudeAmerica-MG,0
2812,2812,7847,2022,21,6/8/2022,Botafogo-RJ,Ceara,3,4,0,0,3,4,0,7,7,23,9,32,Botafogo-RJCeara,0
2813,2813,7848,2022,21,6/8/2022,Avai,Corinthians,2,1,0,0,2,1,0,3,3,11,12,23,AvaiCorinthians,0
2814,2814,7849,2022,21,6/8/2022,Atletico-GO,Bragantino,2,1,0,0,2,1,0,3,3,10,10,20,Atletico-GOBragantino,0
2815,2815,7850,2022,21,6/8/2022,Sao Paulo,Flamengo,2,2,0,0,2,2,0,4,4,12,7,19,Sao PauloFlamengo,0
2816,2816,7851,2022,21,7/8/2022,Fluminense,Cuiaba,2,1,0,0,2,1,0,3,3,11,14,25,FluminenseCuiaba,0
2817,2817,7852,2022,21,7/8/2022,Palmeiras,Goias,2,3,0,0,2,3,0,5,5,12,10,22,PalmeirasGoias,0
2818,2818,7853,2022,21,7/8/2022,Fortaleza,Internacional,1,5,1,0,2,5,1,6,7,12,15,27,FortalezaInternacional,0
2819,2819,7854,2022,21,7/8/2022,Atletico-MG,Athletico-PR,1,2,0,0,1,2,0,3,3,10,14,24,Atletico-MGAthletico-PR,0
2820,2820,7855,2022,21,8/8/2022,Coritiba,Santos,3,3,0,0,3,3,0,6,6,23,10,33,CoritibaSantos,0
2821,2821,7856,2022,22,13/8/2022,Goias,Avai,1,2,1,0,2,2,1,3,4,13,10,23,GoiasAvai,0
2822,2822,7857,2022,22,13/8/2022,Corinthians,Palmeiras,2,2,0,0,2,2,0,4,4,15,10,25,CorinthiansPalmeiras,1
2823,2823,7858,2022,22,13/8/2022,Cuiaba,Juventude,4,5,0,1,4,6,1,9,10,14,14,28,CuiabaJuventude,0
2824,2824,7859,2022,22,13/8/2022,Botafogo-RJ,Atletico-GO,1,3,1,0,2,3,1,4,5,18,10,28,Botafogo-RJAtletico-GO,0
2825,2825,7860,2022,22,14/8/2022,Coritiba,Atletico-MG,3,0,0,0,3,0,0,3,3,7,20,27,CoritibaAtletico-MG,0
2826,2826,7861,2022,22,14/8/2022,Ceara,Fortaleza,3,4,0,0,3,4,0,7,7,9,13,22,CearaFortaleza,1
2827,2827,7862,2022,22,14/8/2022,Flamengo,Athletico-PR,3,2,0,0,3,2,0,5,5,13,14,27,FlamengoAthletico-PR,0
2828,2828,7863,2022,22,14/8/2022,Sao Paulo,Bragantino,1,0,0,0,1,0,0,1,1,17,10,27,Sao PauloBragantino,1
2829,2829,7864,2022,22,14/8/2022,America-MG,Santos,1,0,0,0,1,0,0,1,1,16,9,25,America-MGSantos,0
2830,2830,7865,2022,22,14/8/2022,Internacional,Fluminense,1,1,0,0,1,1,0,2,2,21,12,33,InternacionalFluminense,0
3035,3035,7866,2022,23,20/8/2022,Atletico-MG,Goias,0,0,0,0,0,0,0,0,0,10,13,23,Atletico-MGGoias,0
2831,2831,7867,2022,23,20/8/2022,Fluminense,Coritiba,1,2,0,0,1,2,0,3,3,13,13,26,FluminenseCoritiba,0
2832,2832,7868,2022,23,21/8/2022,Juventude,Botafogo-RJ,2,2,0,0,2,2,0,4,4,19,11,30,JuventudeBotafogo-RJ,0
2833,2833,7869,2022,23,21/8/2022,Palmeiras,Flamengo,0,2,0,0,0,2,0,2,2,11,16,27,PalmeirasFlamengo,0
3036,3036,7870,2022,23,21/8/2022,Athletico-PR,America-MG,0,0,0,0,0,0,0,0,0,10,10,20,Athletico-PRAmerica-MG,0
2834,2834,7871,2022,23,21/8/2022,Atletico-GO,Cuiaba,2,2,1,0,3,2,1,4,5,14,8,22,Atletico-GOCuiaba,0
2835,2835,7872,2022,23,21/8/2022,Fortaleza,Corinthians,1,2,0,0,1,2,0,3,3,14,7,21,FortalezaCorinthians,0
2836,2836,7873,2022,23,21/8/2022,Bragantino,Ceara,3,4,0,0,3,4,0,7,7,23,16,39,BragantinoCeara,0
2837,2837,7874,2022,23,21/8/2022,Santos,Sao Paulo,4,2,0,0,4,2,0,6,6,12,9,21,SantosSao Paulo,1
2838,2838,7875,2022,23,22/8/2022,Avai,Internacional,5,1,0,0,5,1,0,6,6,15,9,24,AvaiInternacional,0
2839,2839,7876,2022,24,27/8/2022,Goias,Atletico-GO,2,2,1,1,3,3,2,4,6,14,9,23,GoiasAtletico-GO,1
2840,2840,7877,2022,24,27/8/2022,Coritiba,Avai,4,3,0,0,4,3,0,7,7,14,14,28,CoritibaAvai,0
2841,2841,7878,2022,24,27/8/2022,Fluminense,Palmeiras,3,3,0,0,3,3,0,6,6,16,16,32,FluminensePalmeiras,0
2842,2842,7879,2022,24,27/8/2022,Ceara,Athletico-PR,0,1,0,0,0,1,0,1,1,9,15,24,CearaAthletico-PR,0
2843,2843,7880,2022,24,28/8/2022,Sao Paulo,Fortaleza,2,2,0,0,2,2,0,4,4,10,10,20,Sao PauloFortaleza,0
2844,2844,7881,2022,24,28/8/2022,America-MG,Atletico-MG,4,4,0,0,4,4,0,8,8,23,14,37,America-MGAtletico-MG,1
2845,2845,7882,2022,24,28/8/2022,Botafogo-RJ,Flamengo,3,2,0,0,3,2,0,5,5,19,14,33,Botafogo-RJFlamengo,1
3037,3037,7883,2022,24,28/8/2022,Cuiaba,Santos,0,0,0,0,0,0,0,0,0,13,6,19,CuiabaSantos,0
2846,2846,7884,2022,24,29/8/2022,Internacional,Juventude,0,3,0,0,0,3,0,3,3,4,10,14,InternacionalJuventude,1
2847,2847,7885,2022,24,29/8/2022,Corinthians,Bragantino,1,1,0,0,1,1,0,2,2,12,8,20,CorinthiansBragantino,1
2848,2848,7886,2022,25,3/9/2022,Juventude,Avai,6,6,0,0,6,6,0,12,12,18,15,33,JuventudeAvai,0
2849,2849,7887,2022,25,3/9/2022,Bragantino,Palmeiras,4,4,0,0,4,4,0,8,8,14,12,26,BragantinoPalmeiras,1
2850,2850,7888,2022,25,3/9/2022,Athletico-PR,Fluminense,2,0,0,0,2,0,0,2,2,15,7,22,Athletico-PRFluminense,0
2851,2851,7889,2022,25,3/9/2022,America-MG,Coritiba,2,3,0,0,2,3,0,5,5,19,8,27,America-MGCoritiba,0
2852,2852,7890,2022,25,4/9/2022,Flamengo,Ceara,4,6,1,1,5,7,2,10,12,12,19,31,FlamengoCeara,0
2853,2853,7891,2022,25,4/9/2022,Corinthians,Internacional,2,2,0,0,2,2,0,4,4,10,14,24,CorinthiansInternacional,0
2854,2854,7892,2022,25,4/9/2022,Fortaleza,Botafogo-RJ,1,2,0,0,1,2,0,3,3,15,14,29,FortalezaBotafogo-RJ,0
2855,2855,7893,2022,25,4/9/2022,Atletico-GO,Atletico-MG,1,2,0,0,1,2,0,3,3,12,6,18,Atletico-GOAtletico-MG,0
2856,2856,7894,2022,25,4/9/2022,Cuiaba,Sao Paulo,3,2,0,1,3,3,1,5,6,18,9,27,CuiabaSao Paulo,0
2857,2857,7895,2022,25,5/9/2022,Santos,Goias,1,2,0,0,1,2,0,3,3,8,16,24,SantosGoias,0
2858,2858,7896,2022,26,7/9/2022,Atletico-MG,Bragantino,1,2,0,0,1,2,0,3,3,8,10,18,Atletico-MGBragantino,0
2859,2859,7897,2022,26,10/9/2022,Internacional,Cuiaba,1,3,0,0,1,3,0,4,4,16,14,30,InternacionalCuiaba,0
2860,2860,7898,2022,26,10/9/2022,Ceara,Santos,4,3,0,0,4,3,0,7,7,24,17,41,CearaSantos,0
2861,2861,7899,2022,26,10/9/2022,Fluminense,Fortaleza,1,2,0,0,1,2,0,3,3,7,19,26,FluminenseFortaleza,0
2862,2862,7900,2022,26,10/9/2022,Palmeiras,Juventude,0,3,0,0,0,3,0,3,3,6,15,21,PalmeirasJuventude,0
2863,2863,7901,2022,26,11/9/2022,Avai,Athletico-PR,3,4,0,1,3,5,1,7,8,17,20,37,AvaiAthletico-PR,0
2864,2864,7902,2022,26,11/9/2022,Botafogo-RJ,America-MG,1,5,0,0,1,5,0,6,6,11,20,31,Botafogo-RJAmerica-MG,0
2865,2865,7903,2022,26,11/9/2022,Sao Paulo,Corinthians,3,1,0,0,3,1,0,4,4,11,14,25,Sao PauloCorinthians,1
2866,2866,7904,2022,26,11/9/2022,Coritiba,Atletico-GO,6,3,0,1,6,4,1,9,10,16,11,27,CoritibaAtletico-GO,0
2867,2867,7905,2022,26,11/9/2022,Goias,Flamengo,3,1,0,0,3,1,0,4,4,14,14,28,GoiasFlamengo,0
2868,2868,7906,2022,27,17/9/2022,Avai,Atletico-MG,4,3,0,0,4,3,0,7,7,16,20,36,AvaiAtletico-MG,0
2869,2869,7907,2022,27,17/9/2022,Botafogo-RJ,Coritiba,2,4,0,0,2,4,0,6,6,12,17,29,Botafogo-RJCoritiba,0
2870,2870,7908,2022,27,18/9/2022,Bragantino,Goias,0,5,0,0,0,5,0,5,5,14,16,30,BragantinoGoias,0
2871,2871,7909,2022,27,18/9/2022,Flamengo,Fluminense,1,5,2,3,3,8,5,6,11,12,10,22,FlamengoFluminense,0
2872,2872,7910,2022,27,18/9/2022,Ceara,Sao Paulo,5,2,2,0,7,2,2,7,9,15,11,26,CearaSao Paulo,0
2873,2873,7911,2022,27,18/9/2022,America-MG,Corinthians,1,3,0,0,1,3,0,4,4,14,12,26,America-MGCorinthians,0
2874,2874,7912,2022,27,18/9/2022,Juventude,Fortaleza,2,3,0,0,2,3,0,5,5,14,17,31,JuventudeFortaleza,0
2875,2875,7913,2022,27,18/9/2022,Palmeiras,Santos,3,4,1,0,4,4,1,7,8,12,12,24,PalmeirasSantos,1
2876,2876,7914,2022,27,18/9/2022,Athletico-PR,Cuiaba,3,2,0,1,3,3,1,5,6,9,10,19,Athletico-PRCuiaba,0
2877,2877,7915,2022,27,19/9/2022,Atletico-GO,Internacional,3,2,0,0,3,2,0,5,5,19,13,32,Atletico-GOInternacional,0
2878,2878,7916,2022,28,25/9/2022,Sao Paulo,Avai,2,4,0,0,2,4,0,6,6,13,8,21,Sao PauloAvai,0
2879,2879,7917,2022,28,27/9/2022,Santos,Athletico-PR,3,3,0,0,3,3,0,6,6,19,21,40,SantosAthletico-PR,0
2880,2880,7918,2022,28,28/9/2022,Coritiba,Ceara,2,4,0,0,2,4,0,6,6,12,9,21,CoritibaCeara,0
2881,2881,7919,2022,28,28/9/2022,Corinthians,Atletico-GO,0,3,0,0,0,3,0,3,3,5,14,19,CorinthiansAtletico-GO,0
2882,2882,7920,2022,28,28/9/2022,Fluminense,Juventude,1,1,0,0,1,1,0,2,2,5,9,14,FluminenseJuventude,0
2883,2883,7921,2022,28,28/9/2022,Fortaleza,Flamengo,2,5,0,0,2,5,0,7,7,15,15,30,FortalezaFlamengo,0
2884,2884,7922,2022,28,28/9/2022,Cuiaba,America-MG,1,6,0,0,1,6,0,7,7,13,14,27,CuiabaAmerica-MG,0
2885,2885,7923,2022,28,28/9/2022,Internacional,Bragantino,1,2,0,0,1,2,0,3,3,14,15,29,InternacionalBragantino,0
2886,2886,7924,2022,28,28/9/2022,Atletico-MG,Palmeiras,3,3,0,0,3,3,0,6,6,11,13,24,Atletico-MGPalmeiras,0
2887,2887,7925,2022,28,28/9/2022,Goias,Botafogo-RJ,4,4,0,0,4,4,0,8,8,16,14,30,GoiasBotafogo-RJ,0
2888,2888,7926,2022,29,1/10/2022,Atletico-MG,Fluminense,2,3,0,1,2,4,1,5,6,16,4,20,Atletico-MGFluminense,0
2889,2889,7927,2022,29,1/10/2022,Internacional,Santos,1,4,0,0,1,4,0,5,5,7,13,20,InternacionalSantos,0
2890,2890,7928,2022,29,1/10/2022,Ceara,America-MG,3,4,0,0,3,4,0,7,7,15,23,38,CearaAmerica-MG,0
2891,2891,7929,2022,29,1/10/2022,Avai,Atletico-GO,2,4,0,0,2,4,0,6,6,7,13,20,AvaiAtletico-GO,0
2892,2892,7930,2022,29,1/10/2022,Athletico-PR,Juventude,3,5,0,0,3,5,0,8,8,12,11,23,Athletico-PRJuventude,0
2893,2893,7931,2022,29,1/10/2022,Flamengo,Bragantino,1,0,0,1,1,1,1,1,2,7,6,13,FlamengoBragantino,0
2894,2894,7932,2022,29,1/10/2022,Goias,Fortaleza,3,2,0,0,3,2,0,5,5,11,15,26,GoiasFortaleza,0
2895,2895,7933,2022,29,1/10/2022,Corinthians,Cuiaba,1,0,0,0,1,0,0,1,1,11,5,16,CorinthiansCuiaba,0
2896,2896,7934,2022,29,3/10/2022,Botafogo-RJ,Palmeiras,4,2,0,1,4,3,1,6,7,16,14,30,Botafogo-RJPalmeiras,0
2897,2897,7935,2022,29,20/10/2022,Sao Paulo,Coritiba,2,6,0,0,2,6,0,8,8,12,12,24,Sao PauloCoritiba,0
2898,2898,7936,2022,30,4/10/2022,Juventude,Corinthians,1,2,0,0,1,2,0,3,3,9,7,16,JuventudeCorinthians,0
2899,2899,7937,2022,30,5/10/2022,Atletico-GO,Fluminense,4,0,0,0,4,0,0,4,4,16,13,29,Atletico-GOFluminense,0
2900,2900,7938,2022,30,5/10/2022,Ceara,Goias,4,4,1,0,5,4,1,8,9,19,24,43,CearaGoias,0
2901,2901,7939,2022,30,5/10/2022,Bragantino,Cuiaba,2,3,0,0,2,3,0,5,5,14,10,24,BragantinoCuiaba,0
2902,2902,7940,2022,30,5/10/2022,Athletico-PR,Fortaleza,2,1,0,0,2,1,0,3,3,11,10,21,Athletico-PRFortaleza,0
2903,2903,7941,2022,30,5/10/2022,Flamengo,Internacional,3,2,0,0,3,2,0,5,5,13,8,21,FlamengoInternacional,0
2904,2904,7942,2022,30,5/10/2022,Santos,Atletico-MG,2,4,1,0,3,4,1,6,7,18,18,36,SantosAtletico-MG,0
2905,2905,7943,2022,30,6/10/2022,Palmeiras,Coritiba,1,2,0,0,1,2,0,3,3,16,13,29,PalmeirasCoritiba,0
2906,2906,7944,2022,30,6/10/2022,America-MG,Sao Paulo,2,4,0,0,2,4,0,6,6,13,13,26,America-MGSao Paulo,0
2907,2907,7945,2022,30,6/10/2022,Avai,Botafogo-RJ,2,4,0,0,2,4,0,6,6,17,20,37,AvaiBotafogo-RJ,0
2908,2908,7946,2022,31,8/10/2022,Cuiaba,Flamengo,2,2,0,0,2,2,0,4,4,14,11,25,CuiabaFlamengo,0
2909,2909,7947,2022,31,8/10/2022,Corinthians,Athletico-PR,1,0,0,0,1,0,0,1,1,10,16,26,CorinthiansAthletico-PR,0
2910,2910,7948,2022,31,9/10/2022,Internacional,Goias,1,7,0,0,1,7,0,8,8,15,23,38,InternacionalGoias,0
2911,2911,7949,2022,31,9/10/2022,Sao Paulo,Botafogo-RJ,3,2,1,0,4,2,1,5,6,16,8,24,Sao PauloBotafogo-RJ,0
2912,2912,7950,2022,31,9/10/2022,Fortaleza,Avai,1,1,0,0,1,1,0,2,2,16,11,27,FortalezaAvai,0
2913,2913,7951,2022,31,9/10/2022,Coritiba,Bragantino,0,3,1,0,1,3,1,3,4,7,12,19,CoritibaBragantino,0
2914,2914,7952,2022,31,9/10/2022,Atletico-MG,Ceara,3,5,0,0,3,5,0,8,8,12,18,30,Atletico-MGCeara,0
2915,2915,7953,2022,31,9/10/2022,Fluminense,America-MG,1,3,0,0,1,3,0,4,4,8,18,26,FluminenseAmerica-MG,0
2916,2916,7954,2022,31,10/10/2022,Atletico-GO,Palmeiras,4,2,0,0,4,2,0,6,6,15,8,23,Atletico-GOPalmeiras,0
2917,2917,7955,2022,31,10/10/2022,Santos,Juventude,2,0,0,0,2,0,0,2,2,13,10,23,SantosJuventude,0
2918,2918,7956,2022,32,15/10/2022,Flamengo,Atletico-MG,4,0,0,0,4,0,0,4,4,12,12,24,FlamengoAtletico-MG,0
2919,2919,7957,2022,32,15/10/2022,America-MG,Fortaleza,1,3,0,1,1,4,1,4,5,10,24,34,America-MGFortaleza,0
2920,2920,7958,2022,32,16/10/2022,Ceara,Cuiaba,4,5,0,1,4,6,1,9,10,11,20,31,CearaCuiaba,0
2921,2921,7959,2022,32,16/10/2022,Palmeiras,Sao Paulo,3,3,0,2,3,5,2,6,8,9,14,23,PalmeirasSao Paulo,1
2922,2922,7960,2022,32,16/10/2022,Juventude,Atletico-GO,2,1,0,0,2,1,0,3,3,10,19,29,JuventudeAtletico-GO,0
2923,2923,7961,2022,32,16/10/2022,Botafogo-RJ,Internacional,3,5,0,0,3,5,0,8,8,15,13,28,Botafogo-RJInternacional,0
2924,2924,7962,2022,32,16/10/2022,Avai,Fluminense,2,0,0,0,2,0,0,2,2,12,15,27,AvaiFluminense,0
2925,2925,7963,2022,32,16/10/2022,Athletico-PR,Coritiba,3,2,0,0,3,2,0,5,5,21,11,32,Athletico-PRCoritiba,1
2926,2926,7964,2022,32,17/10/2022,Bragantino,Santos,3,4,1,0,4,4,1,7,8,21,11,32,BragantinoSantos,1
2927,2927,7965,2022,32,29/10/2022,Goias,Corinthians,2,3,0,0,2,3,0,5,5,11,11,22,GoiasCorinthians,0
2928,2928,7966,2022,33,22/10/2022,Bragantino,Athletico-PR,0,3,0,0,0,3,0,3,3,16,13,29,BragantinoAthletico-PR,0
2929,2929,7967,2022,33,22/10/2022,America-MG,Flamengo,1,1,0,0,1,1,0,2,2,17,10,27,America-MGFlamengo,0
2930,2930,7968,2022,33,22/10/2022,Santos,Corinthians,2,4,1,1,3,5,2,6,8,15,11,26,SantosCorinthians,1
2931,2931,7969,2022,33,22/10/2022,Palmeiras,Avai,2,2,0,0,2,2,0,4,4,12,7,19,PalmeirasAvai,0
2932,2932,7970,2022,33,23/10/2022,Fluminense,Botafogo-RJ,3,2,0,0,3,2,0,5,5,15,11,26,FluminenseBotafogo-RJ,1
2933,2933,7971,2022,33,23/10/2022,Juventude,Sao Paulo,2,2,0,0,2,2,0,4,4,6,10,16,JuventudeSao Paulo,0
2934,2934,7972,2022,33,23/10/2022,Coritiba,Internacional,3,1,0,0,3,1,0,4,4,16,10,26,CoritibaInternacional,0
2935,2935,7973,2022,33,23/10/2022,Atletico-GO,Ceara,3,2,0,0,3,2,0,5,5,20,13,33,Atletico-GOCeara,0
2936,2936,7974,2022,33,23/10/2022,Cuiaba,Goias,3,4,0,0,3,4,0,7,7,11,16,27,CuiabaGoias,0
2937,2937,7975,2022,33,24/10/2022,Fortaleza,Atletico-MG,4,1,0,0,4,1,0,5,5,22,10,32,FortalezaAtletico-MG,0
2938,2938,7976,2022,34,25/10/2022,Flamengo,Santos,3,4,0,0,3,4,0,7,7,14,16,30,FlamengoSantos,0
2939,2939,7977,2022,34,25/10/2022,Athletico-PR,Palmeiras,3,5,1,0,4,5,1,8,9,7,10,17,Athletico-PRPalmeiras,0
2940,2940,7978,2022,34,26/10/2022,Botafogo-RJ,Bragantino,1,4,0,0,1,4,0,5,5,12,12,24,Botafogo-RJBragantino,0
2941,2941,7979,2022,34,26/10/2022,Corinthians,Fluminense,2,3,0,0,2,3,0,5,5,16,9,25,CorinthiansFluminense,0
2942,2942,7980,2022,34,26/10/2022,Internacional,Ceara,0,2,0,0,0,2,0,2,2,8,15,23,InternacionalCeara,0
2943,2943,7981,2022,34,26/10/2022,Goias,America-MG,2,3,0,0,2,3,0,5,5,14,23,37,GoiasAmerica-MG,0
2944,2944,7982,2022,34,27/10/2022,Fortaleza,Coritiba,1,1,0,1,1,2,1,2,3,15,12,27,FortalezaCoritiba,0
2945,2945,7983,2022,34,27/10/2022,Sao Paulo,Atletico-GO,2,4,0,1,2,5,1,6,7,10,12,22,Sao PauloAtletico-GO,0
2946,2946,7984,2022,34,27/10/2022,Atletico-MG,Juventude,2,1,0,0,2,1,0,3,3,13,13,26,Atletico-MGJuventude,0
2947,2947,7985,2022,34,27/10/2022,Cuiaba,Avai,1,1,0,0,1,1,0,2,2,15,11,26,CuiabaAvai,0
2948,2948,7986,2022,35,31/10/2022,Ceara,Fluminense,2,2,1,0,3,2,1,4,5,11,8,19,CearaFluminense,0
2949,2949,7987,2022,35,1/11/2022,Botafogo-RJ,Cuiaba,1,1,0,0,1,1,0,2,2,4,18,22,Botafogo-RJCuiaba,0
2950,2950,7988,2022,35,1/11/2022,Sao Paulo,Atletico-MG,3,5,0,0,3,5,0,8,8,10,16,26,Sao PauloAtletico-MG,0
2951,2951,7989,2022,35,2/11/2022,Athletico-PR,Goias,2,1,0,0,2,1,0,3,3,10,11,21,Athletico-PRGoias,0
3038,3038,7990,2022,35,2/11/2022,America-MG,Internacional,0,0,0,0,0,0,0,0,0,9,12,21,America-MGInternacional,0
2952,2952,7991,2022,35,2/11/2022,Juventude,Coritiba,3,4,0,0,3,4,0,7,7,11,18,29,JuventudeCoritiba,0
2953,2953,7992,2022,35,2/11/2022,Avai,Bragantino,2,1,0,0,2,1,0,3,3,17,17,34,AvaiBragantino,0
2954,2954,7993,2022,35,2/11/2022,Atletico-GO,Santos,3,2,0,0,3,2,0,5,5,15,10,25,Atletico-GOSantos,0
2955,2955,7994,2022,35,2/11/2022,Palmeiras,Fortaleza,3,1,0,0,3,1,0,4,4,11,16,27,PalmeirasFortaleza,0
2956,2956,7995,2022,35,2/11/2022,Flamengo,Corinthians,0,1,0,0,0,1,0,1,1,9,14,23,FlamengoCorinthians,0
2957,2957,7996,2022,36,5/11/2022,Santos,Avai,3,0,0,0,3,0,0,3,3,14,13,27,SantosAvai,0
2958,2958,7997,2022,36,5/11/2022,Fluminense,Sao Paulo,1,1,0,1,1,2,1,2,3,16,16,32,FluminenseSao Paulo,0
2959,2959,7998,2022,36,5/11/2022,Bragantino,America-MG,6,2,0,0,6,2,0,8,8,17,9,26,BragantinoAmerica-MG,0
2960,2960,7999,2022,36,5/11/2022,Goias,Juventude,4,6,0,0,4,6,0,10,10,15,22,37,GoiasJuventude,0
2961,2961,8000,2022,36,5/11/2022,Corinthians,Ceara,4,4,0,0,4,4,0,8,8,10,12,22,CorinthiansCeara,0
2962,2962,8001,2022,36,5/11/2022,Internacional,Athletico-PR,0,1,0,1,0,2,1,1,2,5,20,25,InternacionalAthletico-PR,0
2963,2963,8002,2022,36,6/11/2022,Fortaleza,Atletico-GO,2,5,0,1,2,6,1,7,8,9,12,21,FortalezaAtletico-GO,0
2964,2964,8003,2022,36,6/11/2022,Coritiba,Flamengo,5,3,0,0,5,3,0,8,8,13,11,24,CoritibaFlamengo,0
2965,2965,8004,2022,36,6/11/2022,Cuiaba,Palmeiras,2,0,0,0,2,0,0,2,2,13,8,21,CuiabaPalmeiras,0
2966,2966,8005,2022,36,7/11/2022,Atletico-MG,Botafogo-RJ,2,5,0,0,2,5,0,7,7,10,19,29,Atletico-MGBotafogo-RJ,0
2967,2967,8006,2022,37,8/11/2022,Sao Paulo,Internacional,4,5,0,0,4,5,0,9,9,11,12,23,Sao PauloInternacional,0
2968,2968,8007,2022,37,9/11/2022,Coritiba,Corinthians,4,5,0,1,4,6,1,9,10,15,8,23,CoritibaCorinthians,0
2969,2969,8008,2022,37,9/11/2022,Fluminense,Goias,3,2,0,2,3,4,2,5,7,10,11,21,FluminenseGoias,0
2970,2970,8009,2022,37,9/11/2022,Avai,Ceara,4,5,0,0,4,5,0,9,9,17,21,38,AvaiCeara,0
2971,2971,8010,2022,37,9/11/2022,Fortaleza,Bragantino,1,4,0,0,1,4,0,5,5,17,12,29,FortalezaBragantino,0
2972,2972,8011,2022,37,9/11/2022,Juventude,Flamengo,7,3,0,0,7,3,0,10,10,17,14,31,JuventudeFlamengo,0
2973,2973,8012,2022,37,9/11/2022,Palmeiras,America-MG,4,2,0,0,4,2,0,6,6,11,11,22,PalmeirasAmerica-MG,0
2974,2974,8013,2022,37,9/11/2022,Atletico-GO,Athletico-PR,1,0,0,0,1,0,0,1,1,8,12,20,Atletico-GOAthletico-PR,0
2975,2975,8014,2022,37,10/11/2022,Botafogo-RJ,Santos,2,4,0,1,2,5,1,6,7,15,17,32,Botafogo-RJSantos,0
2976,2976,8015,2022,37,10/11/2022,Atletico-MG,Cuiaba,1,4,0,0,1,4,0,5,5,12,11,23,Atletico-MGCuiaba,0
2977,2977,8016,2022,38,12/11/2022,Flamengo,Avai,0,1,0,0,0,1,0,1,1,14,11,25,FlamengoAvai,0
2978,2978,8017,2022,38,13/11/2022,Athletico-PR,Botafogo-RJ,1,1,0,0,1,1,0,2,2,19,13,32,Athletico-PRBotafogo-RJ,0
2979,2979,8018,2022,38,13/11/2022,Ceara,Juventude,4,4,0,0,4,4,0,8,8,16,16,32,CearaJuventude,0
2980,2980,8019,2022,38,13/11/2022,America-MG,Atletico-GO,3,2,0,1,3,3,1,5,6,14,12,26,America-MGAtletico-GO,0
2981,2981,8020,2022,38,13/11/2022,Santos,Fortaleza,1,3,0,0,1,3,0,4,4,17,14,31,SantosFortaleza,0
2982,2982,8021,2022,38,13/11/2022,Cuiaba,Coritiba,1,4,0,1,1,5,1,5,6,9,8,17,CuiabaCoritiba,0
2983,2983,8022,2022,38,13/11/2022,Bragantino,Fluminense,3,2,0,0,3,2,0,5,5,16,15,31,BragantinoFluminense,0
2984,2984,8023,2022,38,13/11/2022,Corinthians,Atletico-MG,3,6,0,0,3,6,0,9,9,11,19,30,CorinthiansAtletico-MG,0
2985,2985,8024,2022,38,13/11/2022,Internacional,Palmeiras,2,3,0,0,2,3,0,5,5,13,17,30,InternacionalPalmeiras,0
2986,2986,8025,2022,38,13/11/2022,Goias,Sao Paulo,2,1,0,0,2,1,0,3,3,12,14,26,GoiasSao Paulo,0
