,Unnamed: 0,ID,clube_mandante,cartao_amarelo_mandante,cartao_vermelho_mandante,passes_mandante,faltas_mandante,clube_visitante,cartao_amarelo_visitante,cartao_vermelho_visitante,passes_visitante,faltas_visitante,total_faltas_partida,total_passes_partida,total_cartoes_amarelos,total_cartoes_vermelhos,total_cartoes_partida,data,campeonato
4986,4986,4987,Chapecoense,2,0,326,20,Coritiba,2,0,388,21,41,714,4,0,4,9/5/2015,13
4987,4987,4988,Palmeiras,2,0,406,20,Atletico-MG,4,0,426,14,34,832,6,0,6,9/5/2015,13
4988,4988,4989,Fluminense,2,0,702,9,Joinville,0,1,250,14,23,952,2,1,3,9/5/2015,13
4989,4989,4990,Gremio,3,0,401,17,Ponte Preta,4,1,473,21,38,874,7,1,8,10/5/2015,13
4990,4990,4991,Athletico-PR,1,0,335,17,Internacional,2,0,502,17,34,837,3,0,3,10/5/2015,13
4991,4991,4992,Sao Paulo,2,0,502,17,Flamengo,1,0,430,12,29,932,3,0,3,10/5/2015,13
4992,4992,4993,Cruzeiro,3,0,487,17,Corinthians,1,0,391,15,32,878,4,0,4,10/5/2015,13
4993,4993,4994,Sport,1,0,449,17,Figueirense,2,1,391,14,31,840,3,1,4,10/5/2015,13
4994,4994,4995,Avai,2,0,462,10,Santos,1,1,452,11,21,914,3,1,4,10/5/2015,13
4995,4995,4996,Vasco,3,0,439,16,Goias,5,0,279,27,43,718,8,0,8,10/5/2015,13
4996,4996,4997,Goias,2,0,334,14,Athletico-PR,1,1,477,18,32,811,3,1,4,16/5/2015,13
4997,4997,4998,Coritiba,2,0,353,22,Gremio,3,0,456,13,35,809,5,0,5,16/5/2015,13
4998,4998,4999,Corinthians,2,0,437,16,Chapecoense,4,0,487,13,29,924,6,0,6,16/5/2015,13
4999,4999,5000,Figueirense,2,0,381,18,Vasco,6,0,436,13,31,817,8,0,8,17/5/2015,13
5000,5000,5001,Atletico-MG,2,0,466,17,Fluminense,1,0,411,9,26,877,3,0,3,17/5/2015,13
5001,5001,5002,Flamengo,2,0,492,10,Sport,3,0,373,7,17,865,5,0,5,17/5/2015,13
5002,5002,5003,Santos,1,0,351,18,Cruzeiro,4,0,445,13,31,796,5,0,5,17/5/2015,13
5003,5003,5004,Joinville,3,0,377,17,Palmeiras,1,0,589,12,29,966,4,0,4,17/5/2015,13
5004,5004,5005,Ponte Preta,1,0,373,15,Sao Paulo,3,0,549,14,29,922,4,0,4,17/5/2015,13
5005,5005,5006,Internacional,3,0,451,17,Avai,7,0,345,26,43,796,10,0,10,17/5/2015,13
5006,5006,5007,Sao Paulo,2,0,642,12,Joinville,0,0,380,11,23,1022,2,0,2,23/5/2015,13
5007,5007,5008,Vasco,6,0,466,15,Internacional,2,1,312,16,31,778,8,1,9,23/5/2015,13
5008,5008,5009,Gremio,6,0,536,16,Figueirense,5,0,326,24,40,862,11,0,11,23/5/2015,13
5009,5009,5010,Palmeiras,6,1,445,13,Goias,4,1,171,24,37,616,10,2,12,24/5/2015,13
5010,5010,5011,Chapecoense,5,0,307,13,Santos,6,0,462,20,33,769,11,0,11,24/5/2015,13
5011,5011,5012,Athletico-PR,4,1,324,7,Atletico-MG,0,0,537,8,15,861,4,1,5,24/5/2015,13
5012,5012,5013,Fluminense,2,0,355,19,Corinthians,2,0,500,6,25,855,4,0,4,24/5/2015,13
5013,5013,5014,Avai,5,0,338,15,Flamengo,6,0,443,17,32,781,11,0,11,24/5/2015,13
5014,5014,5015,Cruzeiro,2,0,390,17,Ponte Preta,2,0,357,11,28,747,4,0,4,24/5/2015,13
5015,5015,5016,Sport,1,0,388,13,Coritiba,4,0,385,17,30,773,5,0,5,24/5/2015,13
5016,5016,5017,Ponte Preta,4,0,438,20,Chapecoense,1,1,483,15,35,921,5,1,6,30/5/2015,13
5017,5017,5018,Coritiba,4,0,413,17,Avai,4,0,310,21,38,723,8,0,8,30/5/2015,13
5018,5018,5019,Joinville,0,0,464,12,Athletico-PR,4,0,399,13,25,863,4,0,4,30/5/2015,13
5019,5019,5020,Santos,1,0,472,9,Sport,2,0,415,11,20,887,3,0,3,31/5/2015,13
5020,5020,5021,Goias,1,0,345,14,Gremio,1,0,495,14,28,840,2,0,2,31/5/2015,13
5021,5021,5022,Atletico-MG,0,0,457,16,Vasco,3,0,413,12,28,870,3,0,3,31/5/2015,13
5022,5022,5023,Corinthians,5,0,477,21,Palmeiras,5,0,409,21,42,886,10,0,10,31/5/2015,13
5023,5023,5024,Internacional,3,0,516,19,Sao Paulo,0,1,434,17,36,950,3,1,4,31/5/2015,13
5024,5024,5025,Flamengo,5,1,475,24,Fluminense,3,1,253,23,47,728,8,2,10,31/5/2015,13
5025,5025,5026,Figueirense,3,0,266,17,Cruzeiro,5,1,545,11,28,811,8,1,9,31/5/2015,13
5026,5026,5027,Athletico-PR,1,0,385,12,Figueirense,4,0,442,8,20,827,5,0,5,3/6/2015,13
5027,5027,5028,Vasco,1,2,441,15,Ponte Preta,3,0,417,18,33,858,4,2,6,3/6/2015,13
5028,5028,5029,Chapecoense,3,0,349,16,Joinville,5,0,314,12,28,663,8,0,8,3/6/2015,13
5029,5029,5030,Sao Paulo,5,0,531,14,Santos,3,1,329,15,29,860,8,1,9,3/6/2015,13
5030,5030,5031,Cruzeiro,2,0,410,16,Flamengo,3,0,378,17,33,788,5,0,5,3/6/2015,13
5031,5031,5032,Avai,3,0,395,12,Atletico-MG,3,0,479,15,27,874,6,0,6,3/6/2015,13
5032,5032,5033,Gremio,2,0,397,22,Corinthians,3,0,627,10,32,1024,5,0,5,3/6/2015,13
5033,5033,5034,Fluminense,1,0,451,13,Coritiba,4,0,414,24,37,865,5,0,5,4/6/2015,13
5034,5034,5035,Sport,2,0,597,11,Goias,4,0,296,13,24,893,6,0,6,4/6/2015,13
5035,5035,5036,Palmeiras,1,0,456,15,Internacional,4,0,354,13,28,810,5,0,5,4/6/2015,13
5036,5036,5037,Atletico-MG,0,0,462,12,Cruzeiro,0,0,268,13,25,730,0,0,0,6/6/2015,13
5037,5037,5038,Flamengo,1,0,437,13,Chapecoense,0,1,262,12,25,699,1,1,2,6/6/2015,13
5038,5038,5039,Santos,2,0,451,17,Ponte Preta,2,0,416,15,32,867,4,0,4,6/6/2015,13
5039,5039,5040,Athletico-PR,4,0,380,15,Vasco,3,0,480,7,22,860,7,0,7,6/6/2015,13
5040,5040,5041,Joinville,1,0,432,8,Corinthians,1,0,430,9,17,862,2,0,2,6/6/2015,13
5041,5041,5042,Sao Paulo,3,0,631,19,Gremio,2,0,436,14,33,1067,5,0,5,6/6/2015,13
5042,5042,5043,Internacional,3,1,424,5,Coritiba,5,0,401,16,21,825,8,1,9,7/6/2015,13
5043,5043,5044,Figueirense,3,0,253,22,Palmeiras,3,0,506,14,36,759,6,0,6,7/6/2015,13
5044,5044,5045,Goias,2,0,496,15,Avai,4,0,401,17,32,897,6,0,6,7/6/2015,13
5045,5045,5046,Fluminense,3,0,408,12,Sport,2,0,479,10,22,887,5,0,5,7/6/2015,13
5046,5046,5047,Atletico-MG,1,0,520,8,Santos,4,0,320,15,23,840,5,0,5,10/6/2015,13
5047,5047,5048,Coritiba,2,0,478,17,Flamengo,3,1,380,14,31,858,5,1,6,13/6/2015,13
5048,5048,5049,Chapecoense,2,0,460,5,Sao Paulo,4,0,322,29,34,782,6,0,6,13/6/2015,13
5049,5049,5050,Corinthians,0,0,392,10,Internacional,2,0,427,9,19,819,2,0,2,13/6/2015,13
5050,5050,5051,Sport,0,0,379,10,Joinville,4,0,417,13,23,796,4,0,4,13/6/2015,13
5051,5051,5052,Vasco,2,0,536,13,Cruzeiro,4,0,362,25,38,898,6,0,6,13/6/2015,13
5052,5052,5053,Ponte Preta,3,0,430,24,Goias,3,0,279,19,43,709,6,0,6,14/6/2015,13
5053,5053,5054,Avai,4,0,304,14,Figueirense,3,0,229,26,40,533,7,0,7,14/6/2015,13
5054,5054,5055,Palmeiras,0,0,564,6,Fluminense,6,2,283,13,19,847,6,2,8,14/6/2015,13
5055,5055,5056,Gremio,1,0,428,8,Athletico-PR,4,0,344,22,30,772,5,0,5,14/6/2015,13
5056,5056,5057,Figueirense,4,0,267,16,Internacional,2,0,425,18,34,692,6,0,6,18/6/2015,13
5057,5057,5058,Sport,2,0,425,10,Vasco,3,0,482,12,22,907,5,0,5,20/6/2015,13
5058,5058,5059,Flamengo,0,0,504,8,Atletico-MG,0,1,457,14,22,961,0,1,1,20/6/2015,13
5059,5059,5060,Santos,4,1,351,19,Corinthians,3,1,502,17,36,853,7,2,9,20/6/2015,13
5060,5060,5061,Gremio,4,0,485,11,Palmeiras,3,0,476,9,20,961,7,0,7,20/6/2015,13
5061,5061,5062,Cruzeiro,4,0,526,9,Chapecoense,3,0,323,16,25,849,7,0,7,21/6/2015,13
5062,5062,5063,Joinville,4,1,377,13,Goias,4,1,394,12,25,771,8,2,10,21/6/2015,13
5063,5063,5064,Athletico-PR,2,0,381,10,Coritiba,3,2,384,20,30,765,5,2,7,21/6/2015,13
5064,5064,5065,Sao Paulo,1,0,414,14,Avai,5,0,314,13,27,728,6,0,6,21/6/2015,13
5065,5065,5066,Fluminense,2,0,452,16,Ponte Preta,3,0,473,18,34,925,5,0,5,24/6/2015,13
5066,5066,5067,Avai,3,0,375,14,Gremio,3,0,406,16,30,781,6,0,6,27/6/2015,13
5067,5067,5068,Chapecoense,1,0,433,7,Sport,6,0,265,16,23,698,7,0,7,27/6/2015,13
5068,5068,5069,Corinthians,0,0,473,10,Figueirense,2,0,452,11,21,925,2,0,2,27/6/2015,13
5069,5069,5070,Atletico-MG,2,0,505,11,Joinville,1,0,376,13,24,881,3,0,3,28/6/2015,13
5070,5070,5071,Palmeiras,1,0,344,18,Sao Paulo,3,0,503,14,32,847,4,0,4,28/6/2015,13
5071,5071,5072,Goias,2,0,371,15,Fluminense,2,1,443,12,27,814,4,1,5,28/6/2015,13
5072,5072,5073,Ponte Preta,1,0,408,16,Athletico-PR,2,0,371,27,43,779,3,0,3,28/6/2015,13
5073,5073,5074,Coritiba,5,0,362,22,Cruzeiro,5,0,373,15,37,735,10,0,10,28/6/2015,13
5074,5074,5075,Vasco,4,0,255,18,Flamengo,0,0,535,10,28,790,4,0,4,28/6/2015,13
5075,5075,5076,Internacional,3,0,506,4,Santos,2,1,324,12,16,830,5,1,6,28/6/2015,13
5076,5076,5077,Sport,2,0,322,13,Internacional,2,1,469,8,21,791,4,1,5,1/7/2015,13
5077,5077,5078,Vasco,3,1,375,16,Avai,2,1,404,11,27,779,5,2,7,1/7/2015,13
5078,5078,5079,Palmeiras,0,0,428,15,Chapecoense,3,0,472,17,32,900,3,0,3,1/7/2015,13
5079,5079,5080,Atletico-MG,3,0,564,8,Coritiba,5,0,394,11,19,958,8,0,8,1/7/2015,13
5080,5080,5081,Joinville,3,0,580,14,Flamengo,2,0,337,11,25,917,5,0,5,1/7/2015,13
5081,5081,5082,Gremio,5,0,478,21,Cruzeiro,6,0,353,21,42,831,11,0,11,1/7/2015,13
5082,5082,5083,Athletico-PR,2,0,432,17,Sao Paulo,0,0,501,8,25,933,2,0,2,1/7/2015,13
5083,5083,5084,Corinthians,1,0,468,5,Ponte Preta,2,0,522,12,17,990,3,0,3,2/7/2015,13
5084,5084,5085,Figueirense,1,1,395,17,Goias,2,0,443,20,37,838,3,1,4,2/7/2015,13
5085,5085,5086,Fluminense,2,0,442,7,Santos,3,0,424,21,28,866,5,0,5,2/7/2015,13
5086,5086,5087,Coritiba,1,0,454,22,Joinville,2,0,333,17,39,787,3,0,3,4/7/2015,13
5087,5087,5088,Chapecoense,1,0,508,12,Vasco,1,2,261,12,24,769,2,2,4,4/7/2015,13
5088,5088,5089,Cruzeiro,0,0,424,10,Athletico-PR,2,1,370,18,28,794,2,1,3,4/7/2015,13
5089,5089,5090,Avai,5,1,293,16,Sport,2,0,500,14,30,793,7,1,8,5/7/2015,13
5090,5090,5091,Goias,2,0,382,12,Corinthians,2,0,605,12,24,987,4,0,4,5/7/2015,13
5091,5091,5092,Sao Paulo,1,0,492,18,Fluminense,2,0,333,16,34,825,3,0,3,5/7/2015,13
5092,5092,5093,Santos,3,1,462,13,Gremio,1,0,654,12,25,1116,4,1,5,5/7/2015,13
5093,5093,5094,Ponte Preta,3,0,506,12,Palmeiras,3,0,464,22,34,970,6,0,6,5/7/2015,13
5094,5094,5095,Flamengo,3,0,549,9,Figueirense,2,0,346,20,29,895,5,0,5,5/7/2015,13
5095,5095,5096,Internacional,1,1,452,5,Atletico-MG,3,0,537,11,16,989,4,1,5,5/7/2015,13
5096,5096,5097,Chapecoense,1,0,365,8,Gremio,2,0,529,7,15,894,3,0,3,8/7/2015,13
5097,5097,5098,Goias,0,0,374,7,Santos,3,0,546,8,15,920,3,0,3,8/7/2015,13
5098,5098,5099,Coritiba,4,0,422,18,Ponte Preta,6,0,396,17,35,818,10,0,10,8/7/2015,13
5099,5099,5100,Figueirense,1,0,337,11,Joinville,2,0,325,21,32,662,3,0,3,8/7/2015,13
5100,5100,5101,Palmeiras,2,0,430,12,Avai,6,0,329,11,23,759,8,0,8,8/7/2015,13
5101,5101,5102,Atletico-MG,2,0,462,17,Sport,2,0,404,12,29,866,4,0,4,8/7/2015,13
5102,5102,5103,Internacional,3,0,563,17,Flamengo,2,0,385,19,36,948,5,0,5,8/7/2015,13
5103,5103,5104,Vasco,3,0,475,12,Sao Paulo,0,0,507,10,22,982,3,0,3,8/7/2015,13
5104,5104,5105,Corinthians,1,0,453,6,Athletico-PR,2,0,478,13,19,931,3,0,3,9/7/2015,13
5105,5105,5106,Fluminense,2,0,297,10,Cruzeiro,2,0,454,15,25,751,4,0,4,9/7/2015,13
5106,5106,5107,Santos,1,0,391,12,Figueirense,5,0,419,12,24,810,6,0,6,11/7/2015,13
5107,5107,5108,Gremio,1,0,590,16,Vasco,3,0,372,12,28,962,4,0,4,11/7/2015,13
5108,5108,5109,Ponte Preta,1,0,406,13,Atletico-MG,3,0,503,19,32,909,4,0,4,11/7/2015,13
5109,5109,5110,Sao Paulo,1,0,447,18,Coritiba,3,0,397,14,32,844,4,0,4,12/7/2015,13
5110,5110,5111,Joinville,4,0,456,17,Internacional,3,0,283,19,36,739,7,0,7,12/7/2015,13
5111,5111,5112,Flamengo,0,0,535,7,Corinthians,2,0,394,15,22,929,2,0,2,12/7/2015,13
5112,5112,5113,Athletico-PR,1,0,456,12,Fluminense,2,0,322,11,23,778,3,0,3,12/7/2015,13
5113,5113,5114,Cruzeiro,2,0,537,17,Goias,1,0,315,13,30,852,3,0,3,12/7/2015,13
5114,5114,5115,Sport,2,0,506,10,Palmeiras,1,0,351,17,27,857,3,0,3,12/7/2015,13
5115,5115,5116,Avai,4,0,280,15,Chapecoense,2,0,433,14,29,713,6,0,6,12/7/2015,13
5116,5116,5117,Internacional,1,0,540,18,Goias,1,0,315,12,30,855,2,0,2,18/7/2015,13
5117,5117,5118,Flamengo,1,0,323,12,Gremio,5,0,506,11,23,829,6,0,6,18/7/2015,13
5118,5118,5119,Corinthians,1,0,392,12,Atletico-MG,1,0,467,15,27,859,2,0,2,18/7/2015,13
5119,5119,5120,Athletico-PR,2,0,439,14,Chapecoense,3,0,350,13,27,789,5,0,5,19/7/2015,13
5120,5120,5121,Figueirense,1,0,356,20,Coritiba,2,0,523,18,38,879,3,0,3,19/7/2015,13
5121,5121,5122,Sport,1,0,408,9,Sao Paulo,0,2,468,12,21,876,1,2,3,19/7/2015,13
5122,5122,5123,Fluminense,2,0,375,15,Vasco,6,0,287,17,32,662,8,0,8,19/7/2015,13
5123,5123,5124,Palmeiras,3,0,301,24,Santos,3,0,374,10,34,675,6,0,6,19/7/2015,13
5124,5124,5125,Cruzeiro,1,0,554,7,Avai,3,0,263,16,23,817,4,0,4,19/7/2015,13
5125,5125,5126,Joinville,2,0,451,11,Ponte Preta,5,0,397,14,25,848,7,0,7,19/7/2015,13
5126,5126,5127,Avai,3,0,362,5,Athletico-PR,3,0,442,17,22,804,6,0,6,25/7/2015,13
5127,5127,5128,Gremio,0,0,582,6,Sport,0,0,462,8,14,1044,0,0,0,25/7/2015,13
5128,5128,5129,Atletico-MG,2,0,508,16,Figueirense,4,0,311,19,35,819,6,0,6,25/7/2015,13
5129,5129,5130,Chapecoense,2,0,372,15,Fluminense,3,1,373,16,31,745,5,1,6,26/7/2015,13
5130,5130,5131,Santos,2,0,481,4,Joinville,2,0,482,12,16,963,4,0,4,26/7/2015,13
5131,5131,5132,Ponte Preta,2,0,416,10,Internacional,2,0,315,19,29,731,4,0,4,26/7/2015,13
5132,5132,5133,Coritiba,3,0,461,7,Corinthians,3,0,405,18,25,866,6,0,6,26/7/2015,13
5133,5133,5134,Sao Paulo,0,0,428,16,Cruzeiro,1,0,457,14,30,885,1,0,1,26/7/2015,13
5134,5134,5135,Goias,2,0,330,11,Flamengo,1,0,448,6,17,778,3,0,3,26/7/2015,13
5135,5135,5136,Vasco,3,0,446,14,Palmeiras,1,0,363,21,35,809,4,0,4,26/7/2015,13
5136,5136,5137,Corinthians,0,0,552,7,Vasco,3,0,357,15,22,909,3,0,3,29/7/2015,13
5137,5137,5138,Atletico-MG,0,0,521,6,Sao Paulo,1,0,550,6,12,1071,1,0,1,29/7/2015,13
5138,5138,5139,Fluminense,3,0,399,16,Gremio,1,1,484,13,29,883,4,1,5,1/8/2015,13
5139,5139,5140,Coritiba,4,0,459,11,Goias,4,0,297,19,30,756,8,0,8,2/8/2015,13
5140,5140,5141,Palmeiras,1,0,433,13,Athletico-PR,2,0,442,18,31,875,3,0,3,2/8/2015,13
5141,5141,5142,Joinville,2,0,393,22,Avai,1,0,392,9,31,785,3,0,3,2/8/2015,13
5142,5142,5143,Internacional,3,0,509,4,Chapecoense,2,0,301,13,17,810,5,0,5,2/8/2015,13
5143,5143,5144,Figueirense,2,0,303,19,Ponte Preta,3,0,388,18,37,691,5,0,5,2/8/2015,13
5144,5144,5145,Flamengo,4,0,443,17,Santos,2,0,395,14,31,838,6,0,6,2/8/2015,13
5145,5145,5146,Sport,1,0,457,15,Cruzeiro,2,0,473,17,32,930,3,0,3,2/8/2015,13
5146,5146,5147,Avai,2,0,221,14,Fluminense,2,0,526,12,26,747,4,0,4,8/8/2015,13
5147,5147,5148,Santos,1,0,453,12,Coritiba,4,0,447,15,27,900,5,0,5,8/8/2015,13
5148,5148,5149,Athletico-PR,0,0,516,6,Sport,0,0,491,11,17,1007,0,0,0,9/8/2015,13
5149,5149,5150,Vasco,2,0,440,17,Joinville,4,0,301,21,38,741,6,0,6,9/8/2015,13
5150,5150,5151,Sao Paulo,4,0,503,13,Corinthians,1,1,354,16,29,857,5,1,6,9/8/2015,13
5151,5151,5152,Cruzeiro,4,0,415,21,Palmeiras,3,0,446,18,39,861,7,0,7,9/8/2015,13
5152,5152,5153,Ponte Preta,2,0,337,17,Flamengo,4,0,457,16,33,794,6,0,6,9/8/2015,13
5153,5153,5154,Goias,2,0,347,8,Atletico-MG,2,0,568,11,19,915,4,0,4,9/8/2015,13
5154,5154,5155,Gremio,2,0,553,16,Internacional,4,0,417,12,28,970,6,0,6,9/8/2015,13
5155,5155,5156,Chapecoense,1,0,331,20,Figueirense,1,0,321,13,33,652,2,0,2,9/8/2015,13
5156,5156,5157,Coritiba,3,0,402,14,Palmeiras,1,0,475,11,25,877,4,0,4,12/8/2015,13
5157,5157,5158,Flamengo,2,0,390,10,Athletico-PR,3,1,458,16,26,848,5,1,6,12/8/2015,13
5158,5158,5159,Santos,3,0,370,12,Vasco,4,1,343,22,34,713,7,1,8,12/8/2015,13
5159,5159,5160,Goias,1,0,507,6,Chapecoense,3,0,450,16,22,957,4,0,4,12/8/2015,13
5160,5160,5161,Figueirense,3,0,376,18,Sao Paulo,4,1,356,18,36,732,7,1,8,12/8/2015,13
5161,5161,5162,Internacional,6,0,465,20,Fluminense,3,2,315,14,34,780,9,2,11,12/8/2015,13
5162,5162,5163,Corinthians,2,0,491,11,Sport,1,0,391,8,19,882,3,0,3,12/8/2015,13
5163,5163,5164,Ponte Preta,1,0,539,13,Avai,1,0,318,6,19,857,2,0,2,13/8/2015,13
5164,5164,5165,Joinville,1,0,298,10,Cruzeiro,2,0,627,10,20,925,3,0,3,13/8/2015,13
5165,5165,5166,Atletico-MG,2,0,563,10,Gremio,3,0,413,12,22,976,5,0,5,13/8/2015,13
5166,5166,5167,Vasco,3,0,389,12,Coritiba,1,0,323,19,31,712,4,0,4,15/8/2015,13
5167,5167,5168,Athletico-PR,1,1,502,10,Santos,1,0,307,13,23,809,2,1,3,15/8/2015,13
5168,5168,5169,Sao Paulo,1,0,636,4,Goias,0,0,339,4,8,975,1,0,1,15/8/2015,13
5169,5169,5170,Palmeiras,2,0,300,18,Flamengo,2,0,466,15,33,766,4,0,4,16/8/2015,13
5170,5170,5171,Avai,0,0,282,15,Corinthians,1,0,546,8,23,828,1,0,1,16/8/2015,13
5171,5171,5172,Fluminense,1,0,442,14,Figueirense,1,1,330,18,32,772,2,1,3,16/8/2015,13
5172,5172,5173,Cruzeiro,2,0,476,14,Internacional,2,0,391,22,36,867,4,0,4,16/8/2015,13
5173,5173,5174,Sport,0,0,481,7,Ponte Preta,0,0,542,16,23,1023,0,0,0,16/8/2015,13
5174,5174,5175,Gremio,1,0,619,10,Joinville,0,0,282,18,28,901,1,0,1,16/8/2015,13
5175,5175,5176,Chapecoense,4,0,313,12,Atletico-MG,3,1,538,8,20,851,7,1,8,16/8/2015,13
5176,5176,5177,Goias,3,0,406,16,Vasco,2,2,407,13,29,813,5,2,7,22/8/2015,13
5177,5177,5178,Santos,1,0,538,14,Avai,3,0,364,12,26,902,4,0,4,22/8/2015,13
5178,5178,5179,Figueirense,1,0,284,19,Sport,3,0,429,13,32,713,4,0,4,22/8/2015,13
5179,5179,5180,Coritiba,3,0,374,19,Chapecoense,3,0,447,17,36,821,6,0,6,23/8/2015,13
5180,5180,5181,Ponte Preta,1,0,587,12,Gremio,1,0,437,13,25,1024,2,0,2,23/8/2015,13
5181,5181,5182,Joinville,3,0,320,26,Fluminense,2,0,379,15,41,699,5,0,5,23/8/2015,13
5182,5182,5183,Internacional,1,0,430,10,Athletico-PR,3,0,491,12,22,921,4,0,4,23/8/2015,13
5183,5183,5184,Corinthians,2,0,387,12,Cruzeiro,1,0,590,7,19,977,3,0,3,23/8/2015,13
5184,5184,5185,Flamengo,4,0,277,25,Sao Paulo,2,0,364,15,40,641,6,0,6,23/8/2015,13
5185,5185,5186,Atletico-MG,1,0,472,13,Palmeiras,3,0,386,12,25,858,4,0,4,23/8/2015,13
5186,5186,5187,Vasco,2,0,490,11,Figueirense,4,0,313,19,30,803,6,0,6,29/8/2015,13
5187,5187,5188,Sao Paulo,4,0,496,16,Ponte Preta,0,0,551,11,27,1047,4,0,4,29/8/2015,13
5188,5188,5189,Gremio,5,0,385,13,Coritiba,5,0,399,15,28,784,10,0,10,30/8/2015,13
5189,5189,5190,Avai,2,0,290,14,Internacional,2,0,516,12,26,806,4,0,4,30/8/2015,13
5190,5190,5191,Palmeiras,0,0,465,9,Joinville,3,0,360,18,27,825,3,0,3,30/8/2015,13
5191,5191,5192,Fluminense,3,0,372,23,Atletico-MG,4,0,484,16,39,856,7,0,7,30/8/2015,13
5192,5192,5193,Sport,1,1,351,6,Flamengo,5,0,575,19,25,926,6,1,7,30/8/2015,13
5193,5193,5194,Chapecoense,2,0,388,14,Corinthians,3,0,429,11,25,817,5,0,5,30/8/2015,13
5194,5194,5195,Cruzeiro,2,1,505,17,Santos,2,0,469,12,29,974,4,1,5,30/8/2015,13
5195,5195,5196,Athletico-PR,1,0,509,12,Goias,3,0,284,13,25,793,4,0,4,30/8/2015,13
5196,5196,5197,Joinville,4,0,359,23,Sao Paulo,5,0,407,14,37,766,9,0,9,2/9/2015,13
5197,5197,5198,Ponte Preta,2,1,383,19,Cruzeiro,5,0,440,22,41,823,7,1,8,2/9/2015,13
5198,5198,5199,Internacional,3,0,345,22,Vasco,1,0,549,10,32,894,4,0,4,2/9/2015,13
5199,5199,5200,Flamengo,1,0,588,14,Avai,4,0,345,18,32,933,5,0,5,2/9/2015,13
5200,5200,5201,Atletico-MG,4,1,344,18,Athletico-PR,4,0,368,16,34,712,8,1,9,2/9/2015,13
5201,5201,5202,Coritiba,2,0,414,16,Sport,2,0,452,14,30,866,4,0,4,2/9/2015,13
5202,5202,5203,Corinthians,0,0,520,12,Fluminense,3,0,345,11,23,865,3,0,3,2/9/2015,13
5203,5203,5204,Goias,3,0,350,11,Palmeiras,3,0,510,14,25,860,6,0,6,2/9/2015,13
5204,5204,5205,Santos,0,0,430,16,Chapecoense,1,0,420,12,28,850,1,0,1,3/9/2015,13
5205,5205,5206,Figueirense,4,0,572,14,Gremio,4,0,330,9,23,902,8,0,8,3/9/2015,13
5206,5206,5207,Sao Paulo,0,0,464,10,Internacional,0,0,420,10,20,884,0,0,0,5/9/2015,13
5207,5207,5208,Vasco,2,1,416,19,Atletico-MG,2,0,463,16,35,879,4,1,5,5/9/2015,13
5208,5208,5209,Athletico-PR,4,1,539,15,Joinville,1,3,169,17,32,708,5,4,9,5/9/2015,13
5209,5209,5210,Cruzeiro,0,0,476,15,Figueirense,4,0,420,15,30,896,4,0,4,6/9/2015,13
5210,5210,5211,Chapecoense,1,0,507,9,Ponte Preta,2,0,294,17,26,801,3,0,3,6/9/2015,13
5211,5211,5212,Gremio,3,0,690,15,Goias,3,1,248,12,27,938,6,1,7,6/9/2015,13
5212,5212,5213,Palmeiras,6,0,312,20,Corinthians,3,0,351,14,34,663,9,0,9,6/9/2015,13
5213,5213,5214,Avai,2,0,363,19,Coritiba,4,0,365,22,41,728,6,0,6,6/9/2015,13
5214,5214,5215,Fluminense,6,0,437,13,Flamengo,5,1,402,24,37,839,11,1,12,6/9/2015,13
5215,5215,5216,Sport,1,0,517,9,Santos,0,0,448,9,18,965,1,0,1,6/9/2015,13
5216,5216,5217,Ponte Preta,2,1,406,20,Vasco,1,0,438,23,43,844,3,1,4,9/9/2015,13
5217,5217,5218,Atletico-MG,3,0,587,17,Avai,3,0,369,16,33,956,6,0,6,9/9/2015,13
5218,5218,5219,Internacional,5,1,367,21,Palmeiras,2,1,426,23,44,793,7,2,9,9/9/2015,13
5219,5219,5220,Figueirense,2,0,403,7,Athletico-PR,2,0,407,9,16,810,4,0,4,9/9/2015,13
5220,5220,5221,Coritiba,1,0,426,11,Fluminense,4,0,376,24,35,802,5,0,5,9/9/2015,13
5221,5221,5222,Santos,1,0,431,11,Sao Paulo,1,0,462,9,20,893,2,0,2,9/9/2015,13
5222,5222,5223,Corinthians,0,0,604,7,Gremio,3,0,473,6,13,1077,3,0,3,9/9/2015,13
5223,5223,5224,Goias,3,0,382,8,Sport,1,0,591,6,14,973,4,0,4,10/9/2015,13
5224,5224,5225,Joinville,4,0,361,13,Chapecoense,2,0,305,10,23,666,6,0,6,10/9/2015,13
5225,5225,5226,Flamengo,3,0,360,18,Cruzeiro,3,0,412,10,28,772,6,0,6,10/9/2015,13
5226,5226,5227,Coritiba,4,0,514,13,Internacional,7,0,322,26,39,836,11,0,11,12/9/2015,13
5227,5227,5228,Palmeiras,4,0,424,19,Figueirense,3,1,382,18,37,806,7,1,8,12/9/2015,13
5228,5228,5229,Ponte Preta,5,0,333,22,Santos,2,0,531,15,37,864,7,0,7,13/9/2015,13
5229,5229,5230,Corinthians,0,0,595,10,Joinville,1,0,267,17,27,862,1,0,1,13/9/2015,13
5230,5230,5231,Cruzeiro,2,1,278,17,Atletico-MG,5,0,499,16,33,777,7,1,8,13/9/2015,13
5231,5231,5232,Gremio,3,0,473,11,Sao Paulo,3,0,460,13,24,933,6,0,6,13/9/2015,13
5232,5232,5233,Chapecoense,2,0,429,13,Flamengo,1,0,440,12,25,869,3,0,3,13/9/2015,13
5233,5233,5234,Vasco,2,0,351,18,Athletico-PR,2,0,423,20,38,774,4,0,4,13/9/2015,13
5234,5234,5235,Avai,2,0,581,18,Goias,2,0,326,19,37,907,4,0,4,13/9/2015,13
5235,5235,5236,Sport,2,0,440,19,Fluminense,3,0,336,17,36,776,5,0,5,13/9/2015,13
5236,5236,5237,Joinville,4,0,262,19,Sport,3,0,555,11,30,817,7,0,7,16/9/2015,13
5237,5237,5238,Fluminense,1,0,392,14,Palmeiras,3,0,372,19,33,764,4,0,4,16/9/2015,13
5238,5238,5239,Goias,2,0,449,12,Ponte Preta,5,0,489,11,23,938,7,0,7,16/9/2015,13
5239,5239,5240,Figueirense,2,0,362,16,Avai,4,0,217,23,39,579,6,0,6,16/9/2015,13
5240,5240,5241,Athletico-PR,1,0,423,13,Gremio,2,0,488,5,18,911,3,0,3,16/9/2015,13
5241,5241,5242,Santos,1,0,477,7,Atletico-MG,1,0,592,11,18,1069,2,0,2,16/9/2015,13
5242,5242,5243,Internacional,2,0,348,15,Corinthians,1,0,425,12,27,773,3,0,3,16/9/2015,13
5243,5243,5244,Cruzeiro,4,0,437,15,Vasco,2,1,398,4,19,835,6,1,7,16/9/2015,13
5244,5244,5245,Sao Paulo,2,0,474,12,Chapecoense,2,0,354,14,26,828,4,0,4,17/9/2015,13
5245,5245,5246,Flamengo,2,0,627,12,Coritiba,3,0,245,21,33,872,5,0,5,17/9/2015,13
5246,5246,5247,Palmeiras,2,0,284,22,Gremio,4,0,432,17,39,716,6,0,6,19/9/2015,13
5247,5247,5248,Internacional,1,0,415,22,Figueirense,5,0,368,22,44,783,6,0,6,19/9/2015,13
5248,5248,5249,Ponte Preta,3,0,348,14,Fluminense,4,0,498,14,28,846,7,0,7,19/9/2015,13
5249,5249,5250,Goias,0,0,379,6,Joinville,1,0,437,12,18,816,1,0,1,20/9/2015,13
5250,5250,5251,Corinthians,2,0,464,8,Santos,5,2,357,10,18,821,7,2,9,20/9/2015,13
5251,5251,5252,Vasco,2,0,372,13,Sport,2,0,477,10,23,849,4,0,4,20/9/2015,13
5252,5252,5253,Atletico-MG,2,0,379,16,Flamengo,2,0,438,16,32,817,4,0,4,20/9/2015,13
5253,5253,5254,Avai,3,0,294,17,Sao Paulo,4,0,490,19,36,784,7,0,7,20/9/2015,13
5254,5254,5255,Chapecoense,2,0,416,15,Cruzeiro,0,1,364,12,27,780,2,1,3,20/9/2015,13
5255,5255,5256,Coritiba,7,1,260,19,Athletico-PR,3,0,407,23,42,667,10,1,11,20/9/2015,13
5256,5256,5257,Fluminense,4,0,437,27,Goias,3,0,405,15,42,842,7,0,7,26/9/2015,13
5257,5257,5258,Gremio,1,0,538,13,Avai,3,0,426,12,25,964,4,0,4,26/9/2015,13
5258,5258,5259,Athletico-PR,2,0,488,16,Ponte Preta,4,0,278,18,34,766,6,0,6,27/9/2015,13
5259,5259,5260,Santos,1,0,490,8,Internacional,4,0,324,17,25,814,5,0,5,27/9/2015,13
5260,5260,5261,Flamengo,5,0,307,26,Vasco,6,0,334,21,47,641,11,0,11,27/9/2015,13
5261,5261,5262,Joinville,2,0,369,19,Atletico-MG,2,0,498,8,27,867,4,0,4,27/9/2015,13
5262,5262,5263,Figueirense,3,0,385,21,Corinthians,3,0,367,14,35,752,6,0,6,27/9/2015,13
5263,5263,5264,Sao Paulo,1,0,402,13,Palmeiras,2,0,315,17,30,717,3,0,3,27/9/2015,13
5264,5264,5265,Sport,3,0,374,17,Chapecoense,0,0,414,8,25,788,3,0,3,27/9/2015,13
5265,5265,5266,Cruzeiro,0,1,458,13,Coritiba,1,1,446,13,26,904,1,2,3,27/9/2015,13
5266,5266,5267,Internacional,2,0,376,16,Sport,2,1,382,11,27,758,4,1,5,3/10/2015,13
5267,5267,5268,Coritiba,1,0,412,6,Atletico-MG,2,0,443,11,17,855,3,0,3,3/10/2015,13
5268,5268,5269,Sao Paulo,1,0,464,12,Athletico-PR,3,0,342,16,28,806,4,0,4,3/10/2015,13
5269,5269,5270,Avai,4,1,289,18,Vasco,6,2,444,18,36,733,10,3,13,4/10/2015,13
5270,5270,5271,Flamengo,2,0,478,17,Joinville,3,0,217,27,44,695,5,0,5,4/10/2015,13
5271,5271,5272,Santos,3,0,442,24,Fluminense,2,0,386,12,36,828,5,0,5,4/10/2015,13
5272,5272,5273,Cruzeiro,3,0,436,9,Gremio,3,0,526,15,24,962,6,0,6,4/10/2015,13
5273,5273,5274,Goias,1,0,423,15,Figueirense,5,1,267,11,26,690,6,1,7,4/10/2015,13
5274,5274,5275,Ponte Preta,1,1,320,17,Corinthians,4,0,445,15,32,765,5,1,6,4/10/2015,13
5275,5275,5276,Chapecoense,0,0,314,17,Palmeiras,5,0,336,17,34,650,5,0,5,4/10/2015,13
5276,5276,5277,Atletico-MG,2,0,488,14,Internacional,3,0,352,11,25,840,5,0,5,14/10/2015,13
5277,5277,5278,Sport,2,0,517,8,Avai,5,0,375,16,24,892,7,0,7,14/10/2015,13
5278,5278,5279,Joinville,6,0,293,23,Coritiba,1,0,407,16,39,700,7,0,7,14/10/2015,13
5279,5279,5280,Figueirense,1,0,228,14,Flamengo,1,0,479,10,24,707,2,0,2,14/10/2015,13
5280,5280,5281,Palmeiras,2,0,404,18,Ponte Preta,3,0,306,17,35,710,5,0,5,14/10/2015,13
5281,5281,5282,Fluminense,0,0,340,16,Sao Paulo,4,0,462,21,37,802,4,0,4,14/10/2015,13
5282,5282,5283,Athletico-PR,5,0,384,20,Cruzeiro,2,0,365,7,27,749,7,0,7,14/10/2015,13
5283,5283,5284,Vasco,4,0,388,16,Chapecoense,5,0,306,19,35,694,9,0,9,15/10/2015,13
5284,5284,5285,Corinthians,1,0,620,9,Goias,5,0,367,10,19,987,6,0,6,15/10/2015,13
5285,5285,5286,Gremio,3,0,462,14,Santos,3,1,474,4,18,936,6,1,7,15/10/2015,13
5286,5286,5287,Avai,3,0,379,14,Palmeiras,4,0,330,29,43,709,7,0,7,17/10/2015,13
5287,5287,5288,Joinville,1,1,280,24,Figueirense,3,0,348,16,40,628,4,1,5,17/10/2015,13
5288,5288,5289,Ponte Preta,3,0,369,30,Coritiba,3,0,428,27,57,797,6,0,6,18/10/2015,13
5289,5289,5290,Cruzeiro,2,0,426,13,Fluminense,1,0,430,14,27,856,3,0,3,18/10/2015,13
5290,5290,5291,Athletico-PR,2,0,470,11,Corinthians,1,0,389,12,23,859,3,0,3,18/10/2015,13
5291,5291,5292,Flamengo,0,0,459,19,Internacional,2,0,286,24,43,745,2,0,2,18/10/2015,13
5292,5292,5293,Sao Paulo,1,1,401,11,Vasco,1,0,427,16,27,828,2,1,3,18/10/2015,13
5293,5293,5294,Gremio,3,0,489,17,Chapecoense,2,1,369,13,30,858,5,1,6,18/10/2015,13
5294,5294,5295,Santos,0,0,559,9,Goias,1,0,374,8,17,933,1,0,1,18/10/2015,13
5295,5295,5296,Sport,0,0,429,13,Atletico-MG,0,1,545,8,21,974,0,1,1,18/10/2015,13
5296,5296,5297,Fluminense,1,0,478,4,Athletico-PR,3,0,427,21,25,905,4,0,4,24/10/2015,13
5297,5297,5298,Internacional,1,0,461,11,Joinville,2,0,279,18,29,740,3,0,3,24/10/2015,13
5298,5298,5299,Figueirense,5,0,281,24,Santos,2,0,485,20,44,766,7,0,7,24/10/2015,13
5299,5299,5300,Palmeiras,2,0,452,15,Sport,1,0,433,9,24,885,3,0,3,24/10/2015,13
5300,5300,5301,Corinthians,3,0,509,19,Flamengo,1,1,397,20,39,906,4,1,5,25/10/2015,13
5301,5301,5302,Coritiba,4,1,344,17,Sao Paulo,3,0,525,21,38,869,7,1,8,25/10/2015,13
5302,5302,5303,Chapecoense,1,0,397,17,Avai,2,0,367,16,33,764,3,0,3,25/10/2015,13
5303,5303,5304,Vasco,1,0,454,12,Gremio,2,0,416,16,28,870,3,0,3,25/10/2015,13
5304,5304,5305,Goias,4,0,363,14,Cruzeiro,4,0,485,11,25,848,8,0,8,25/10/2015,13
5305,5305,5306,Atletico-MG,2,0,552,15,Ponte Preta,1,0,409,12,27,961,3,0,3,25/10/2015,13
5306,5306,5307,Sao Paulo,1,0,541,10,Sport,2,0,415,15,25,956,3,0,3,31/10/2015,13
5307,5307,5308,Avai,3,0,315,16,Cruzeiro,3,0,325,16,32,640,6,0,6,31/10/2015,13
5308,5308,5309,Ponte Preta,3,0,354,20,Joinville,5,0,330,17,37,684,8,0,8,31/10/2015,13
5309,5309,5310,Coritiba,2,0,424,13,Figueirense,5,0,247,29,42,671,7,0,7,31/10/2015,13
5310,5310,5311,Chapecoense,3,0,402,13,Athletico-PR,4,1,341,12,25,743,7,1,8,1/11/2015,13
5311,5311,5312,Santos,3,0,281,15,Palmeiras,3,1,325,18,33,606,6,1,7,1/11/2015,13
5312,5312,5313,Gremio,0,0,506,12,Flamengo,0,1,474,12,24,980,0,1,1,1/11/2015,13
5313,5313,5314,Atletico-MG,1,0,497,11,Corinthians,0,0,363,15,26,860,1,0,1,1/11/2015,13
5314,5314,5315,Vasco,2,0,444,18,Fluminense,4,1,472,22,40,916,6,1,7,1/11/2015,13
5315,5315,5316,Goias,3,0,267,16,Internacional,3,0,520,12,28,787,6,0,6,1/11/2015,13
5316,5316,5317,Internacional,2,0,439,20,Ponte Preta,4,0,360,20,40,799,6,0,6,7/11/2015,13
5317,5317,5318,Corinthians,0,0,698,5,Coritiba,3,0,331,17,22,1029,3,0,3,7/11/2015,13
5318,5318,5319,Athletico-PR,1,0,467,21,Avai,2,0,322,10,31,789,3,0,3,7/11/2015,13
5319,5319,5320,Fluminense,3,0,522,12,Chapecoense,3,0,351,14,26,873,6,0,6,7/11/2015,13
5320,5320,5321,Palmeiras,1,0,422,29,Vasco,4,0,333,13,42,755,5,0,5,8/11/2015,13
5321,5321,5322,Flamengo,1,0,581,16,Goias,0,0,323,14,30,904,1,0,1,8/11/2015,13
5322,5322,5323,Cruzeiro,1,0,446,5,Sao Paulo,2,0,577,12,17,1023,3,0,3,8/11/2015,13
5323,5323,5324,Figueirense,2,0,243,14,Atletico-MG,4,0,562,13,27,805,6,0,6,8/11/2015,13
5324,5324,5325,Joinville,3,1,237,22,Santos,2,0,203,19,41,440,5,1,6,8/11/2015,13
5325,5325,5326,Sport,2,0,426,8,Gremio,3,1,460,16,24,886,5,1,6,8/11/2015,13
5326,5326,5327,Cruzeiro,2,0,369,13,Sport,4,0,410,15,28,779,6,0,6,15/11/2015,13
5327,5327,5328,Goias,1,0,484,20,Coritiba,1,0,316,18,38,800,2,0,2,18/11/2015,13
5328,5328,5329,Ponte Preta,4,0,534,18,Figueirense,4,0,262,24,42,796,8,0,8,18/11/2015,13
5329,5329,5330,Avai,4,0,265,12,Joinville,1,0,392,13,25,657,5,0,5,18/11/2015,13
5330,5330,5331,Athletico-PR,2,0,363,13,Palmeiras,4,2,395,15,28,758,6,2,8,18/11/2015,13
5331,5331,5332,Gremio,3,0,499,20,Fluminense,4,1,293,21,41,792,7,1,8,19/11/2015,13
5332,5332,5333,Chapecoense,4,0,318,16,Internacional,2,1,433,14,30,751,6,1,7,19/11/2015,13
5333,5333,5334,Sao Paulo,0,0,418,7,Atletico-MG,0,0,516,9,16,934,0,0,0,19/11/2015,13
5334,5334,5335,Santos,2,0,471,20,Flamengo,1,1,327,11,31,798,3,1,4,19/11/2015,13
5335,5335,5336,Vasco,1,1,305,12,Corinthians,3,0,442,15,27,747,4,1,5,19/11/2015,13
5336,5336,5337,Palmeiras,2,0,438,20,Cruzeiro,1,0,433,13,33,871,3,0,3,21/11/2015,13
5337,5337,5338,Joinville,4,1,338,21,Vasco,4,0,306,10,31,644,8,1,9,22/11/2015,13
5338,5338,5339,Atletico-MG,3,0,629,16,Goias,3,0,242,12,28,871,6,0,6,22/11/2015,13
5339,5339,5340,Internacional,4,0,322,21,Gremio,2,0,419,13,34,741,6,0,6,22/11/2015,13
5340,5340,5341,Figueirense,1,0,400,13,Chapecoense,3,0,397,15,28,797,4,0,4,22/11/2015,13
5341,5341,5342,Corinthians,2,0,459,10,Sao Paulo,2,0,441,10,20,900,4,0,4,22/11/2015,13
5342,5342,5343,Flamengo,3,0,501,19,Ponte Preta,3,0,360,23,42,861,6,0,6,22/11/2015,13
5343,5343,5344,Fluminense,2,0,515,11,Avai,3,0,400,6,17,915,5,0,5,22/11/2015,13
5344,5344,5345,Coritiba,3,0,282,13,Santos,3,1,480,21,34,762,6,1,7,22/11/2015,13
5345,5345,5346,Sport,3,0,461,10,Athletico-PR,2,0,411,20,30,872,5,0,5,22/11/2015,13
5346,5346,5347,Sao Paulo,1,0,526,16,Figueirense,4,0,289,26,42,815,5,0,5,28/11/2015,13
5347,5347,5348,Fluminense,3,1,369,13,Internacional,4,0,486,20,33,855,7,1,8,28/11/2015,13
5348,5348,5349,Avai,1,0,333,19,Ponte Preta,1,1,371,27,46,704,2,1,3,28/11/2015,13
5349,5349,5350,Sport,6,0,399,14,Corinthians,3,0,484,17,31,883,9,0,9,29/11/2015,13
5350,5350,5351,Cruzeiro,2,0,504,12,Joinville,3,0,387,13,25,891,5,0,5,29/11/2015,13
5351,5351,5352,Gremio,3,0,397,10,Atletico-MG,5,0,522,11,21,919,8,0,8,29/11/2015,13
5352,5352,5353,Chapecoense,5,0,438,17,Goias,3,0,234,17,34,672,8,0,8,29/11/2015,13
5353,5353,5354,Vasco,3,0,307,14,Santos,2,0,349,12,26,656,5,0,5,29/11/2015,13
5354,5354,5355,Palmeiras,3,0,495,22,Coritiba,3,0,225,27,49,720,6,0,6,29/11/2015,13
5355,5355,5356,Athletico-PR,1,0,372,16,Flamengo,3,0,546,14,30,918,4,0,4,29/11/2015,13
5356,5356,5357,Internacional,2,0,381,11,Cruzeiro,1,0,399,13,24,780,3,0,3,6/12/2015,13
5357,5357,5358,Flamengo,0,0,559,16,Palmeiras,1,0,304,20,36,863,1,0,1,6/12/2015,13
5358,5358,5359,Figueirense,4,0,262,16,Fluminense,4,0,421,18,34,683,8,0,8,6/12/2015,13
5359,5359,5360,Santos,0,0,440,10,Athletico-PR,1,0,442,10,20,882,1,0,1,6/12/2015,13
5360,5360,5361,Ponte Preta,4,0,358,21,Sport,2,0,402,12,33,760,6,0,6,6/12/2015,13
5361,5361,5362,Goias,4,0,309,12,Sao Paulo,1,0,540,21,33,849,5,0,5,6/12/2015,13
5362,5362,5363,Corinthians,2,0,761,11,Avai,2,0,216,14,25,977,4,0,4,6/12/2015,13
5363,5363,5364,Atletico-MG,0,0,553,7,Chapecoense,0,0,364,11,18,917,0,0,0,6/12/2015,13
5364,5364,5365,Joinville,3,0,341,12,Gremio,1,0,314,13,25,655,4,0,4,6/12/2015,13
5365,5365,5366,Coritiba,1,0,295,20,Vasco,0,1,327,15,35,622,1,1,2,6/12/2015,13
5366,5366,5367,Palmeiras,1,0,577,14,Athletico-PR,3,1,316,17,31,893,4,1,5,14/5/2016,14
5367,5367,5368,Flamengo,2,0,553,18,Sport,1,1,437,15,33,990,3,1,4,14/5/2016,14
5368,5368,5369,Atletico-MG,2,0,361,18,Santos,2,0,517,12,30,878,4,0,4,14/5/2016,14
5369,5369,5370,Coritiba,1,0,444,19,Cruzeiro,2,2,442,23,42,886,3,2,5,14/5/2016,14
5370,5370,5371,Santa Cruz,3,0,227,11,Vitoria,0,0,380,17,28,607,3,0,3,15/5/2016,14
5371,5371,5372,Botafogo-RJ,1,0,590,7,Sao Paulo,5,0,310,10,17,900,6,0,6,15/5/2016,14
5372,5372,5373,Figueirense,2,0,376,8,Ponte Preta,5,0,332,21,29,708,7,0,7,15/5/2016,14
5373,5373,5374,Corinthians,1,0,579,12,Gremio,4,0,391,20,32,970,5,0,5,15/5/2016,14
5374,5374,5375,America-MG,0,0,317,8,Fluminense,0,0,490,9,17,807,0,0,0,15/5/2016,14
5375,5375,5376,Internacional,3,0,494,14,Chapecoense,3,1,227,20,34,721,6,1,7,15/5/2016,14
5376,5376,5377,Ponte Preta,3,0,268,21,Palmeiras,4,0,497,16,37,765,7,0,7,21/5/2016,14
5377,5377,5378,Fluminense,3,0,462,20,Santa Cruz,5,0,341,23,43,803,8,0,8,21/5/2016,14
5378,5378,5379,Cruzeiro,3,0,533,11,Figueirense,1,0,229,14,25,762,4,0,4,21/5/2016,14
5379,5379,5380,Santos,5,0,622,12,Coritiba,2,0,451,15,27,1073,7,0,7,22/5/2016,14
5380,5380,5381,Athletico-PR,3,0,391,18,Atletico-MG,1,0,523,7,25,914,4,0,4,22/5/2016,14
5381,5381,5382,Vitoria,4,1,270,20,Corinthians,4,0,529,24,44,799,8,1,9,22/5/2016,14
5382,5382,5383,Chapecoense,0,0,495,12,America-MG,4,0,313,26,38,808,4,0,4,22/5/2016,14
5383,5383,5384,Sao Paulo,4,0,406,11,Internacional,6,1,362,16,27,768,10,1,11,22/5/2016,14
5384,5384,5385,Gremio,3,0,434,17,Flamengo,2,0,535,8,25,969,5,0,5,22/5/2016,14
5385,5385,5386,Sport,3,0,537,14,Botafogo-RJ,2,0,443,10,24,980,5,0,5,22/5/2016,14
5386,5386,5387,Figueirense,2,0,403,21,Santos,3,1,484,12,33,887,5,1,6,25/5/2016,14
5387,5387,5388,Botafogo-RJ,2,0,333,8,Athletico-PR,2,0,645,12,20,978,4,0,4,25/5/2016,14
5388,5388,5389,Flamengo,4,1,536,10,Chapecoense,1,0,318,24,34,854,5,1,6,25/5/2016,14
5389,5389,5390,America-MG,4,0,420,22,Vitoria,1,1,373,18,40,793,5,1,6,25/5/2016,14
5390,5390,5391,Santa Cruz,2,0,282,16,Cruzeiro,3,0,537,15,31,819,5,0,5,25/5/2016,14
5391,5391,5392,Palmeiras,1,0,390,20,Fluminense,0,0,360,12,32,750,1,0,1,25/5/2016,14
5392,5392,5393,Coritiba,2,0,419,18,Sao Paulo,2,0,407,12,30,826,4,0,4,25/5/2016,14
5393,5393,5394,Corinthians,3,0,562,23,Ponte Preta,3,0,411,15,38,973,6,0,6,26/5/2016,14
5394,5394,5395,Internacional,3,0,430,14,Sport,1,0,426,13,27,856,4,0,4,26/5/2016,14
5395,5395,5396,Atletico-MG,1,0,530,8,Gremio,5,0,449,14,22,979,6,0,6,26/5/2016,14
5396,5396,5397,Cruzeiro,1,0,544,7,America-MG,1,0,293,9,16,837,2,0,2,28/5/2016,14
5397,5397,5398,Athletico-PR,2,0,426,17,Figueirense,1,0,447,17,34,873,3,0,3,28/5/2016,14
5398,5398,5399,Chapecoense,1,0,527,16,Santa Cruz,4,0,298,19,35,825,5,0,5,28/5/2016,14
5399,5399,5400,Ponte Preta,2,0,518,19,Flamengo,1,1,346,13,32,864,3,1,4,29/5/2016,14
5400,5400,5401,Sport,2,0,581,7,Corinthians,1,0,479,12,19,1060,3,0,3,29/5/2016,14
5401,5401,5402,Fluminense,1,0,377,16,Botafogo-RJ,1,0,459,17,33,836,2,0,2,29/5/2016,14
5402,5402,5403,Vitoria,4,0,342,21,Atletico-MG,6,0,447,18,39,789,10,0,10,29/5/2016,14
5403,5403,5404,Sao Paulo,2,0,335,18,Palmeiras,5,0,403,21,39,738,7,0,7,29/5/2016,14
5404,5404,5405,Gremio,0,0,572,19,Coritiba,3,0,471,18,37,1043,3,0,3,29/5/2016,14
5405,5405,5406,Santos,1,0,457,9,Internacional,1,0,454,14,23,911,2,0,2,29/5/2016,14
5406,5406,5407,Internacional,5,0,418,30,Athletico-PR,2,0,449,15,45,867,7,0,7,1/6/2016,14
5407,5407,5408,Corinthians,0,0,648,14,Santos,2,0,331,14,28,979,2,0,2,1/6/2016,14
5408,5408,5409,Santa Cruz,5,1,385,25,Sport,2,0,368,15,40,753,7,1,8,1/6/2016,14
5409,5409,5410,Coritiba,4,0,387,17,Chapecoense,5,0,376,23,40,763,9,0,9,1/6/2016,14
5410,5410,5411,Atletico-MG,2,0,593,16,Fluminense,5,0,373,19,35,966,7,0,7,1/6/2016,14
5411,5411,5412,Figueirense,2,0,257,16,Sao Paulo,1,0,456,19,35,713,3,0,3,1/6/2016,14
5412,5412,5413,Botafogo-RJ,1,0,419,11,Cruzeiro,3,0,399,23,34,818,4,0,4,1/6/2016,14
5413,5413,5414,America-MG,1,0,529,7,Ponte Preta,3,0,433,15,22,962,4,0,4,2/6/2016,14
5414,5414,5415,Palmeiras,5,0,330,24,Gremio,4,0,415,19,43,745,9,0,9,2/6/2016,14
5415,5415,5416,Flamengo,2,0,391,14,Vitoria,3,0,384,18,32,775,5,0,5,2/6/2016,14
5416,5416,5417,Athletico-PR,0,0,561,12,Santa Cruz,2,0,363,18,30,924,2,0,2,4/6/2016,14
5417,5417,5418,Chapecoense,3,0,439,12,Fluminense,0,0,520,11,23,959,3,0,3,4/6/2016,14
5418,5418,5419,Corinthians,2,0,718,13,Coritiba,5,0,238,12,25,956,7,0,7,4/6/2016,14
5419,5419,5420,America-MG,2,0,354,20,Figueirense,3,0,374,14,34,728,5,0,5,5/6/2016,14
5420,5420,5421,Santos,1,0,499,12,Botafogo-RJ,1,0,441,12,24,940,2,0,2,5/6/2016,14
5421,5421,5422,Vitoria,1,0,270,16,Internacional,6,0,386,19,35,656,7,0,7,5/6/2016,14
5422,5422,5423,Sport,1,0,502,10,Atletico-MG,3,0,477,17,27,979,4,0,4,5/6/2016,14
5423,5423,5424,Flamengo,1,1,310,11,Palmeiras,2,0,479,12,23,789,3,1,4,5/6/2016,14
5424,5424,5425,Gremio,2,1,662,14,Ponte Preta,4,1,271,13,27,933,6,2,8,5/6/2016,14
5425,5425,5426,Cruzeiro,2,0,541,12,Sao Paulo,0,0,372,9,21,913,2,0,2,5/6/2016,14
5426,5426,5427,Internacional,2,0,464,16,America-MG,3,0,432,15,31,896,5,0,5,11/6/2016,14
5427,5427,5428,Ponte Preta,3,0,461,22,Chapecoense,4,0,312,22,44,773,7,0,7,11/6/2016,14
5428,5428,5429,Fluminense,4,0,548,9,Gremio,2,1,384,10,19,932,6,1,7,11/6/2016,14
5429,5429,5430,Sao Paulo,1,0,546,12,Athletico-PR,2,0,337,17,29,883,3,0,3,11/6/2016,14
5430,5430,5431,Coritiba,4,1,411,18,Sport,3,1,358,26,44,769,7,2,9,12/6/2016,14
5431,5431,5432,Botafogo-RJ,3,0,358,20,Vitoria,1,0,338,18,38,696,4,0,4,12/6/2016,14
5432,5432,5433,Atletico-MG,4,1,489,15,Cruzeiro,5,3,229,15,30,718,9,4,13,12/6/2016,14
5433,5433,5434,Palmeiras,4,0,368,19,Corinthians,4,0,373,18,37,741,8,0,8,12/6/2016,14
5434,5434,5435,Figueirense,2,0,282,17,Flamengo,2,0,474,17,34,756,4,0,4,12/6/2016,14
5435,5435,5436,Santa Cruz,1,0,451,19,Santos,2,0,501,11,30,952,3,0,3,12/6/2016,14
5436,5436,5437,Sao Paulo,5,0,422,22,Vitoria,2,0,357,22,44,779,7,0,7,15/6/2016,14
5437,5437,5438,Chapecoense,2,0,376,19,Gremio,2,0,452,15,34,828,4,0,4,15/6/2016,14
5438,5438,5439,Ponte Preta,0,0,498,9,Athletico-PR,2,0,449,15,24,947,2,0,2,15/6/2016,14
5439,5439,5440,Santos,1,0,617,10,Sport,3,0,398,10,20,1015,4,0,4,15/6/2016,14
5440,5440,5441,Santa Cruz,3,0,424,25,Figueirense,3,1,396,8,33,820,6,1,7,15/6/2016,14
5441,5441,5442,Botafogo-RJ,2,0,434,17,America-MG,2,0,481,20,37,915,4,0,4,15/6/2016,14
5442,5442,5443,Coritiba,4,0,291,14,Palmeiras,3,0,462,19,33,753,7,0,7,15/6/2016,14
5443,5443,5444,Cruzeiro,0,0,538,9,Flamengo,0,0,336,9,18,874,0,0,0,15/6/2016,14
5444,5444,5445,Internacional,2,0,399,23,Atletico-MG,1,0,494,12,35,893,3,0,3,16/6/2016,14
5445,5445,5446,Fluminense,2,0,410,12,Corinthians,0,1,547,7,19,957,2,1,3,16/6/2016,14
5446,5446,5447,Palmeiras,1,0,521,18,Santa Cruz,3,1,349,24,42,870,4,1,5,18/6/2016,14
5447,5447,5448,Athletico-PR,2,0,323,16,Santos,1,0,652,7,23,975,3,0,3,18/6/2016,14
5448,5448,5449,America-MG,0,0,395,17,Coritiba,3,0,415,12,29,810,3,0,3,18/6/2016,14
5449,5449,5450,Vitoria,1,0,344,20,Chapecoense,4,0,336,18,38,680,5,0,5,19/6/2016,14
5450,5450,5451,Atletico-MG,0,0,488,9,Ponte Preta,1,0,445,17,26,933,1,0,1,19/6/2016,14
5451,5451,5452,Corinthians,2,0,562,15,Botafogo-RJ,2,0,363,15,30,925,4,0,4,19/6/2016,14
5452,5452,5453,Flamengo,1,0,501,9,Sao Paulo,2,1,315,19,28,816,3,1,4,19/6/2016,14
5453,5453,5454,Figueirense,3,0,277,16,Internacional,0,0,370,15,31,647,3,0,3,19/6/2016,14
5454,5454,5455,Sport,2,0,345,12,Fluminense,0,0,617,12,24,962,2,0,2,19/6/2016,14
5455,5455,5456,Gremio,0,0,572,13,Cruzeiro,2,0,453,16,29,1025,2,0,2,19/6/2016,14
5456,5456,5457,Palmeiras,0,0,663,6,America-MG,1,0,316,8,14,979,1,0,1,21/6/2016,14
5457,5457,5458,Ponte Preta,4,0,473,11,Cruzeiro,4,0,294,14,25,767,8,0,8,22/6/2016,14
5458,5458,5459,Botafogo-RJ,0,0,513,12,Figueirense,1,0,296,14,26,809,1,0,1,22/6/2016,14
5459,5459,5460,Santa Cruz,1,0,427,13,Flamengo,0,0,483,12,25,910,1,0,1,22/6/2016,14
5460,5460,5461,Fluminense,1,0,501,9,Santos,1,0,479,11,20,980,2,0,2,22/6/2016,14
5461,5461,5462,Atletico-MG,3,0,456,24,Corinthians,1,0,479,11,35,935,4,0,4,22/6/2016,14
5462,5462,5463,Chapecoense,2,0,315,16,Athletico-PR,2,0,305,17,33,620,4,0,4,23/6/2016,14
5463,5463,5464,Gremio,3,1,557,11,Vitoria,4,0,334,17,28,891,7,1,8,23/6/2016,14
5464,5464,5465,Sao Paulo,0,0,511,9,Sport,2,0,313,19,28,824,2,0,2,23/6/2016,14
5465,5465,5466,Coritiba,1,1,355,13,Internacional,5,0,301,27,40,656,6,1,7,23/6/2016,14
5466,5466,5467,Cruzeiro,4,0,390,13,Palmeiras,2,0,384,14,27,774,6,0,6,25/6/2016,14
5467,5467,5468,Corinthians,3,0,537,14,Santa Cruz,1,0,338,16,30,875,4,0,4,25/6/2016,14
5468,5468,5469,America-MG,3,0,476,19,Atletico-MG,3,0,354,17,36,830,6,0,6,26/6/2016,14
5469,5469,5470,Flamengo,0,0,505,9,Fluminense,1,0,400,14,23,905,1,0,1,26/6/2016,14
5470,5470,5471,Vitoria,3,0,469,17,Ponte Preta,2,0,320,22,39,789,5,0,5,26/6/2016,14
5471,5471,5472,Athletico-PR,1,0,461,12,Gremio,0,1,480,16,28,941,1,1,2,26/6/2016,14
5472,5472,5473,Internacional,4,1,450,21,Botafogo-RJ,3,0,299,18,39,749,7,1,8,26/6/2016,14
5473,5473,5474,Santos,2,0,558,8,Sao Paulo,2,1,305,14,22,863,4,1,5,26/6/2016,14
5474,5474,5475,Sport,3,0,494,22,Chapecoense,2,0,382,10,32,876,5,0,5,26/6/2016,14
5475,5475,5476,Figueirense,3,0,368,19,Coritiba,4,0,370,23,42,738,7,0,7,26/6/2016,14
5476,5476,5477,Flamengo,1,0,373,11,Internacional,1,0,550,22,33,923,2,0,2,29/6/2016,14
5477,5477,5478,Vitoria,4,0,472,22,Sport,2,2,260,19,41,732,6,2,8,29/6/2016,14
5478,5478,5479,Gremio,3,0,375,10,Santos,3,0,655,14,24,1030,6,0,6,29/6/2016,14
5479,5479,5480,Coritiba,3,0,345,22,Athletico-PR,2,0,336,16,38,681,5,0,5,29/6/2016,14
5480,5480,5481,Chapecoense,4,0,339,19,Cruzeiro,6,0,401,20,39,740,10,0,10,29/6/2016,14
5481,5481,5482,Sao Paulo,4,0,383,17,Fluminense,3,0,508,15,32,891,7,0,7,29/6/2016,14
5482,5482,5483,America-MG,2,0,539,10,Corinthians,1,0,381,13,23,920,3,0,3,29/6/2016,14
5483,5483,5484,Santa Cruz,2,0,453,15,Ponte Preta,1,0,355,16,31,808,3,0,3,30/6/2016,14
5484,5484,5485,Palmeiras,1,0,513,26,Figueirense,1,0,302,24,50,815,2,0,2,30/6/2016,14
5485,5485,5486,Atletico-MG,0,0,373,15,Botafogo-RJ,0,0,438,9,24,811,0,0,0,30/6/2016,14
5486,5486,5487,Fluminense,1,0,467,14,Coritiba,2,0,373,19,33,840,3,0,3,2/7/2016,14
5487,5487,5488,Athletico-PR,2,0,484,9,America-MG,2,0,386,12,21,870,4,0,4,2/7/2016,14
5488,5488,5489,Cruzeiro,3,0,366,12,Vitoria,2,1,238,18,30,604,5,1,6,3/7/2016,14
5489,5489,5490,Internacional,4,0,371,11,Gremio,5,0,335,11,22,706,9,0,9,3/7/2016,14
5490,5490,5491,Santos,1,0,639,13,Chapecoense,1,0,359,12,25,998,2,0,2,3/7/2016,14
5491,5491,5492,Ponte Preta,3,0,480,20,Sao Paulo,2,1,277,16,36,757,5,1,6,3/7/2016,14
5492,5492,5493,Corinthians,2,0,450,15,Flamengo,3,0,475,10,25,925,5,0,5,3/7/2016,14
5493,5493,5494,Botafogo-RJ,1,0,401,11,Santa Cruz,3,0,477,13,24,878,4,0,4,3/7/2016,14
5494,5494,5495,Figueirense,2,1,407,18,Atletico-MG,4,1,361,21,39,768,6,2,8,3/7/2016,14
5495,5495,5496,Sport,4,0,428,18,Palmeiras,5,0,297,21,39,725,9,0,9,4/7/2016,14
5496,5496,5497,Chapecoense,0,1,333,17,Corinthians,1,0,522,13,30,855,1,1,2,9/7/2016,14
5497,5497,5498,Coritiba,1,0,414,21,Botafogo-RJ,3,0,408,14,35,822,4,0,4,9/7/2016,14
5498,5498,5499,Ponte Preta,2,0,268,17,Sport,2,0,436,12,29,704,4,0,4,9/7/2016,14
5499,5499,5500,Gremio,1,0,543,11,Figueirense,1,0,345,14,25,888,2,0,2,10/7/2016,14
5500,5500,5501,Flamengo,1,0,360,10,Atletico-MG,4,0,428,23,33,788,5,0,5,10/7/2016,14
5501,5501,5502,Santa Cruz,0,0,339,21,Internacional,2,0,360,19,40,699,2,0,2,10/7/2016,14
5502,5502,5503,Sao Paulo,1,0,488,7,America-MG,4,0,403,13,20,891,5,0,5,10/7/2016,14
5503,5503,5504,Vitoria,3,0,311,16,Fluminense,4,0,273,22,38,584,7,0,7,10/7/2016,14
5504,5504,5505,Cruzeiro,1,0,543,9,Athletico-PR,4,0,369,17,26,912,5,0,5,11/7/2016,14
5505,5505,5506,Palmeiras,3,0,287,17,Santos,2,0,458,17,34,745,5,0,5,12/7/2016,14
5506,5506,5507,Botafogo-RJ,2,0,391,12,Flamengo,4,0,442,22,34,833,6,0,6,16/7/2016,14
5507,5507,5508,Santos,3,0,484,14,Ponte Preta,2,0,328,11,25,812,5,0,5,16/7/2016,14
5508,5508,5509,America-MG,2,0,650,9,Santa Cruz,2,0,337,10,19,987,4,0,4,17/7/2016,14
5509,5509,5510,Internacional,4,0,502,17,Palmeiras,2,0,381,13,30,883,6,0,6,17/7/2016,14
5510,5510,5511,Figueirense,1,0,348,16,Chapecoense,4,0,420,18,34,768,5,0,5,17/7/2016,14
5511,5511,5512,Fluminense,0,0,276,17,Cruzeiro,6,0,480,17,34,756,6,0,6,17/7/2016,14
5512,5512,5513,Athletico-PR,3,0,405,16,Vitoria,3,0,373,10,26,778,6,0,6,17/7/2016,14
5513,5513,5514,Corinthians,3,0,459,11,Sao Paulo,3,0,355,26,37,814,6,0,6,17/7/2016,14
5514,5514,5515,Sport,0,0,405,15,Gremio,3,0,481,16,31,886,3,0,3,17/7/2016,14
5515,5515,5516,Atletico-MG,2,0,380,16,Coritiba,2,0,361,18,34,741,4,0,4,18/7/2016,14
5516,5516,5517,Corinthians,2,0,545,15,Figueirense,6,0,262,21,36,807,8,0,8,23/7/2016,14
5517,5517,5518,Santa Cruz,2,0,456,17,Coritiba,1,0,339,19,36,795,3,0,3,23/7/2016,14
5518,5518,5519,Palmeiras,1,0,426,11,Atletico-MG,2,0,341,19,30,767,3,0,3,24/7/2016,14
5519,5519,5520,Ponte Preta,3,0,339,20,Internacional,2,1,347,13,33,686,5,1,6,24/7/2016,14
5520,5520,5521,Gremio,0,0,515,16,Sao Paulo,2,1,485,12,28,1000,2,1,3,24/7/2016,14
5521,5521,5522,Athletico-PR,3,0,354,13,Fluminense,5,0,466,20,33,820,8,0,8,24/7/2016,14
5522,5522,5523,Cruzeiro,1,0,442,15,Sport,4,0,304,18,33,746,5,0,5,24/7/2016,14
5523,5523,5524,Chapecoense,1,0,354,14,Botafogo-RJ,2,0,579,16,30,933,3,0,3,24/7/2016,14
5524,5524,5525,Vitoria,3,0,434,15,Santos,2,0,358,11,26,792,5,0,5,24/7/2016,14
5525,5525,5526,Flamengo,1,0,535,11,America-MG,0,0,335,13,24,870,1,0,1,25/7/2016,14
5526,5526,5527,Figueirense,3,1,246,19,Vitoria,3,1,446,26,45,692,6,2,8,30/7/2016,14
5527,5527,5528,Sport,2,0,421,23,Athletico-PR,1,0,444,9,32,865,3,0,3,30/7/2016,14
5528,5528,5529,Atletico-MG,1,0,590,13,Santa Cruz,3,0,430,12,25,1020,4,0,4,30/7/2016,14
5529,5529,5530,Sao Paulo,4,0,569,13,Chapecoense,1,0,291,11,24,860,5,0,5,31/7/2016,14
5530,5530,5531,Fluminense,4,0,416,21,Ponte Preta,6,0,352,21,42,768,10,0,10,31/7/2016,14
5531,5531,5532,Coritiba,1,0,338,9,Flamengo,2,0,369,13,22,707,3,0,3,31/7/2016,14
5532,5532,5533,Internacional,2,0,446,19,Corinthians,2,0,381,19,38,827,4,0,4,31/7/2016,14
5533,5533,5534,Santos,1,0,517,12,Cruzeiro,1,0,502,10,22,1019,2,0,2,31/7/2016,14
5534,5534,5535,Botafogo-RJ,4,0,361,20,Palmeiras,3,0,400,23,43,761,7,0,7,31/7/2016,14
5535,5535,5536,America-MG,2,0,399,15,Gremio,2,1,476,8,23,875,4,1,5,31/7/2016,14
5536,5536,5537,Vitoria,2,0,361,9,Coritiba,1,0,296,19,28,657,3,0,3,3/8/2016,14
5537,5537,5538,Sport,1,0,548,8,America-MG,3,0,224,22,30,772,4,0,4,3/8/2016,14
5538,5538,5539,Santos,2,0,379,10,Flamengo,2,0,533,9,19,912,4,0,4,3/8/2016,14
5539,5539,5540,Athletico-PR,3,0,436,11,Corinthians,0,0,536,12,23,972,3,0,3,3/8/2016,14
5540,5540,5541,Ponte Preta,2,0,322,16,Botafogo-RJ,2,0,546,12,28,868,4,0,4,4/8/2016,14
5541,5541,5542,Gremio,1,0,584,18,Santa Cruz,3,0,368,18,36,952,4,0,4,4/8/2016,14
5542,5542,5543,Sao Paulo,2,0,544,9,Atletico-MG,2,0,384,17,26,928,4,0,4,4/8/2016,14
5543,5543,5544,Cruzeiro,1,0,347,10,Internacional,1,0,474,14,24,821,2,0,2,4/8/2016,14
5544,5544,5545,Chapecoense,1,0,261,18,Palmeiras,0,0,495,15,33,756,1,0,1,4/8/2016,14
5545,5545,5547,Flamengo,2,0,410,11,Athletico-PR,4,0,395,11,22,805,6,0,6,6/8/2016,14
5546,5546,5548,America-MG,2,0,381,11,Santos,1,1,521,7,18,902,3,1,4,7/8/2016,14
5547,5547,5549,Coritiba,4,0,342,20,Ponte Preta,3,0,328,18,38,670,7,0,7,7/8/2016,14
5548,5548,5550,Palmeiras,2,0,491,13,Vitoria,4,0,338,20,33,829,6,0,6,7/8/2016,14
5549,5549,5551,Santa Cruz,1,0,386,15,Sao Paulo,3,0,419,24,39,805,4,0,4,7/8/2016,14
5550,5550,5552,Internacional,4,0,413,22,Fluminense,4,0,371,14,36,784,8,0,8,7/8/2016,14
5551,5551,5553,Figueirense,5,0,297,18,Sport,3,0,439,16,34,736,8,0,8,7/8/2016,14
5552,5552,5554,Atletico-MG,0,0,507,15,Chapecoense,1,0,379,12,27,886,1,0,1,8/8/2016,14
5553,5553,5555,Corinthians,4,0,485,15,Cruzeiro,3,0,430,8,23,915,7,0,7,8/8/2016,14
5554,5554,5557,Sport,2,0,315,24,Flamengo,3,0,522,15,39,837,5,0,5,13/8/2016,14
5555,5555,5558,Ponte Preta,2,0,272,21,Figueirense,2,0,395,25,46,667,4,0,4,13/8/2016,14
5556,5556,5559,Fluminense,2,0,482,12,America-MG,5,0,331,28,40,813,7,0,7,14/8/2016,14
5557,5557,5560,Gremio,4,0,349,15,Corinthians,1,0,509,14,29,858,5,0,5,14/8/2016,14
5558,5558,5561,Cruzeiro,2,0,503,15,Coritiba,4,0,256,20,35,759,6,0,6,14/8/2016,14
5559,5559,5562,Santos,4,0,314,24,Atletico-MG,4,0,530,9,33,844,8,0,8,14/8/2016,14
5560,5560,5563,Vitoria,1,0,398,15,Santa Cruz,2,0,343,20,35,741,3,0,3,14/8/2016,14
5561,5561,5564,Sao Paulo,2,0,491,11,Botafogo-RJ,2,0,295,14,25,786,4,0,4,14/8/2016,14
5562,5562,5565,Athletico-PR,3,0,485,12,Palmeiras,3,0,350,15,27,835,6,0,6,14/8/2016,14
5563,5563,5566,Chapecoense,1,0,360,15,Internacional,2,0,266,18,33,626,3,0,3,15/8/2016,14
5564,5564,5567,America-MG,1,0,412,13,Chapecoense,1,0,396,10,23,808,2,0,2,19/8/2016,14
5565,5565,5568,Botafogo-RJ,1,0,378,19,Sport,2,0,483,12,31,861,3,0,3,20/8/2016,14
5566,5566,5569,Flamengo,2,0,433,14,Gremio,1,0,434,16,30,867,3,0,3,21/8/2016,14
5567,5567,5570,Atletico-MG,0,0,509,15,Athletico-PR,2,0,332,15,30,841,2,0,2,21/8/2016,14
5568,5568,5571,Internacional,1,0,454,9,Sao Paulo,2,0,346,22,31,800,3,0,3,21/8/2016,14
5569,5569,5572,Santa Cruz,0,0,484,16,Fluminense,2,0,341,16,32,825,2,0,2,21/8/2016,14
5570,5570,5573,Palmeiras,3,0,455,12,Ponte Preta,6,0,238,22,34,693,9,0,9,21/8/2016,14
5571,5571,5574,Coritiba,1,0,403,13,Santos,3,0,410,16,29,813,4,0,4,21/8/2016,14
5572,5572,5575,Figueirense,3,1,389,20,Cruzeiro,5,0,416,24,44,805,8,1,9,21/8/2016,14
5573,5573,5576,Corinthians,2,0,484,15,Vitoria,4,0,385,20,35,869,6,0,6,22/8/2016,14
5574,5574,5577,Ponte Preta,2,0,471,15,Corinthians,1,1,458,8,23,929,3,1,4,27/8/2016,14
5575,5575,5578,Cruzeiro,3,0,374,17,Santa Cruz,3,0,428,13,30,802,6,0,6,28/8/2016,14
5576,5576,5579,Santos,3,0,611,13,Figueirense,2,0,242,12,25,853,5,0,5,28/8/2016,14
5577,5577,5580,Gremio,4,0,623,18,Atletico-MG,4,0,383,17,35,1006,8,0,8,28/8/2016,14
5578,5578,5581,Fluminense,7,0,428,17,Palmeiras,5,0,304,20,37,732,12,0,12,28/8/2016,14
5579,5579,5582,Chapecoense,4,0,351,15,Flamengo,0,0,492,13,28,843,4,0,4,28/8/2016,14
5580,5580,5583,Sao Paulo,2,0,506,18,Coritiba,1,0,264,16,34,770,3,0,3,28/8/2016,14
5581,5581,5584,Sport,4,0,474,18,Internacional,5,0,288,19,37,762,9,0,9,28/8/2016,14
5582,5582,5585,Vitoria,3,0,379,20,America-MG,5,0,389,19,39,768,8,0,8,28/8/2016,14
5583,5583,5586,Athletico-PR,3,0,344,12,Botafogo-RJ,2,0,477,14,26,821,5,0,5,29/8/2016,14
5584,5584,5546,Fluminense,3,0,323,21,Figueirense,3,0,306,15,36,629,6,0,6,3/9/2016,14
5585,5585,5556,Botafogo-RJ,3,0,292,16,Gremio,4,0,507,25,41,799,7,0,7,4/9/2016,14
5586,5586,5587,Santa Cruz,2,1,417,9,Chapecoense,3,0,362,18,27,779,5,1,6,7/9/2016,14
5587,5587,5588,Figueirense,1,0,339,16,Athletico-PR,2,0,405,20,36,744,3,0,3,7/9/2016,14
5588,5588,5589,Botafogo-RJ,5,0,278,22,Fluminense,2,0,465,15,37,743,7,0,7,7/9/2016,14
5589,5589,5590,Atletico-MG,2,0,406,17,Vitoria,5,0,394,17,34,800,7,0,7,7/9/2016,14
5590,5590,5591,Palmeiras,3,0,335,20,Sao Paulo,3,0,328,19,39,663,6,0,6,7/9/2016,14
5591,5591,5592,Flamengo,1,0,446,15,Ponte Preta,3,0,262,19,34,708,4,0,4,7/9/2016,14
5592,5592,5593,Coritiba,3,0,370,15,Gremio,0,0,576,9,24,946,3,0,3,7/9/2016,14
5593,5593,5594,Corinthians,2,0,447,15,Sport,2,0,433,17,32,880,4,0,4,8/9/2016,14
5594,5594,5595,America-MG,1,0,586,19,Cruzeiro,2,0,370,13,32,956,3,0,3,8/9/2016,14
5595,5595,5596,Internacional,4,0,484,19,Santos,3,1,341,8,27,825,7,1,8,8/9/2016,14
5596,5596,5597,Vitoria,1,1,409,14,Flamengo,1,0,494,8,22,903,2,1,3,10/9/2016,14
5597,5597,5598,Chapecoense,2,0,353,20,Coritiba,3,0,395,16,36,748,5,0,5,11/9/2016,14
5598,5598,5599,Sao Paulo,2,0,456,25,Figueirense,2,0,325,17,42,781,4,0,4,11/9/2016,14
5599,5599,5600,Cruzeiro,4,0,480,16,Botafogo-RJ,2,0,312,16,32,792,6,0,6,11/9/2016,14
5600,5600,5601,Sport,2,1,459,14,Santa Cruz,1,1,276,18,32,735,3,2,5,11/9/2016,14
5601,5601,5602,Athletico-PR,0,0,360,11,Internacional,2,0,327,12,23,687,2,0,2,11/9/2016,14
5602,5602,5603,Santos,2,0,402,18,Corinthians,1,0,384,17,35,786,3,0,3,11/9/2016,14
5603,5603,5604,Ponte Preta,2,0,431,10,America-MG,1,0,305,12,22,736,3,0,3,11/9/2016,14
5604,5604,5605,Gremio,4,0,444,23,Palmeiras,3,0,303,16,39,747,7,0,7,11/9/2016,14
5605,5605,5606,Fluminense,1,0,444,14,Atletico-MG,4,0,458,16,30,902,5,0,5,12/9/2016,14
5606,5606,5607,Botafogo-RJ,2,0,523,10,Santos,1,0,403,10,20,926,3,0,3,14/9/2016,14
5607,5607,5608,Figueirense,0,0,368,17,America-MG,1,1,386,13,30,754,1,1,2,14/9/2016,14
5608,5608,5609,Ponte Preta,2,0,313,16,Gremio,1,0,488,18,34,801,3,0,3,14/9/2016,14
5609,5609,5610,Santa Cruz,3,0,492,12,Athletico-PR,4,0,399,13,25,891,7,0,7,14/9/2016,14
5610,5610,5611,Coritiba,2,1,368,15,Corinthians,1,0,526,12,27,894,3,1,4,14/9/2016,14
5611,5611,5612,Palmeiras,2,0,452,13,Flamengo,0,1,252,13,26,704,2,1,3,14/9/2016,14
5612,5612,5613,Atletico-MG,0,0,612,13,Sport,1,1,376,15,28,988,1,1,2,15/9/2016,14
5613,5613,5614,Fluminense,3,0,529,19,Chapecoense,4,0,381,18,37,910,7,0,7,15/9/2016,14
5614,5614,5615,Sao Paulo,0,0,512,14,Cruzeiro,0,1,436,8,22,948,0,1,1,15/9/2016,14
5615,5615,5616,Internacional,3,0,519,18,Vitoria,5,0,279,24,42,798,8,0,8,15/9/2016,14
5616,5616,5617,Corinthians,1,1,635,16,Palmeiras,4,0,325,16,32,960,5,1,6,17/9/2016,14
5617,5617,5618,Flamengo,2,0,565,16,Figueirense,2,1,311,17,33,876,4,1,5,18/9/2016,14
5618,5618,5619,Cruzeiro,0,1,377,12,Atletico-MG,2,0,420,23,35,797,2,1,3,18/9/2016,14
5619,5619,5620,Sport,0,0,464,20,Coritiba,1,0,253,21,41,717,1,0,1,18/9/2016,14
5620,5620,5621,Gremio,4,0,645,17,Fluminense,3,0,317,11,28,962,7,0,7,18/9/2016,14
5621,5621,5622,Chapecoense,2,0,455,16,Ponte Preta,0,0,362,12,28,817,2,0,2,18/9/2016,14
5622,5622,5623,Athletico-PR,1,0,372,12,Sao Paulo,1,0,476,12,24,848,2,0,2,18/9/2016,14
5623,5623,5624,Santos,1,0,463,13,Santa Cruz,1,0,458,11,24,921,2,0,2,18/9/2016,14
5624,5624,5625,Vitoria,2,0,439,15,Botafogo-RJ,5,0,269,24,39,708,7,0,7,18/9/2016,14
5625,5625,5626,America-MG,1,0,313,12,Internacional,2,0,405,14,26,718,3,0,3,19/9/2016,14
5626,5626,5627,Palmeiras,2,0,453,13,Coritiba,3,0,325,24,37,778,5,0,5,24/9/2016,14
5627,5627,5628,Sport,3,0,312,20,Santos,1,1,474,11,31,786,4,1,5,24/9/2016,14
5628,5628,5629,America-MG,2,0,374,16,Botafogo-RJ,3,0,493,12,28,867,5,0,5,24/9/2016,14
5629,5629,5630,Athletico-PR,2,0,614,11,Ponte Preta,5,1,290,20,31,904,7,1,8,25/9/2016,14
5630,5630,5631,Figueirense,1,0,307,19,Santa Cruz,5,0,583,12,31,890,6,0,6,25/9/2016,14
5631,5631,5632,Vitoria,4,0,311,21,Sao Paulo,3,0,406,19,40,717,7,0,7,25/9/2016,14
5632,5632,5633,Corinthians,4,0,498,19,Fluminense,3,0,381,15,34,879,7,0,7,25/9/2016,14
5633,5633,5634,Flamengo,1,0,520,13,Cruzeiro,2,0,375,12,25,895,3,0,3,25/9/2016,14
5634,5634,5635,Gremio,2,0,510,13,Chapecoense,2,0,560,12,25,1070,4,0,4,25/9/2016,14
5635,5635,5636,Atletico-MG,2,0,509,11,Internacional,2,0,388,17,28,897,4,0,4,25/9/2016,14
5636,5636,5637,Fluminense,1,0,530,11,Sport,3,0,341,30,41,871,4,0,4,1/10/2016,14
5637,5637,5638,Sao Paulo,4,0,371,18,Flamengo,3,0,459,9,27,830,7,0,7,1/10/2016,14
5638,5638,5639,Chapecoense,1,0,468,18,Vitoria,2,0,296,18,36,764,3,0,3,1/10/2016,14
5639,5639,5640,Santos,2,0,448,10,Athletico-PR,1,0,541,13,23,989,3,0,3,1/10/2016,14
5640,5640,5641,Botafogo-RJ,4,0,396,23,Corinthians,4,0,495,16,39,891,8,0,8,1/10/2016,14
5641,5641,5642,Ponte Preta,2,0,405,25,Atletico-MG,2,0,319,16,41,724,4,0,4,1/10/2016,14
5642,5642,5643,Cruzeiro,3,0,425,19,Gremio,3,0,424,20,39,849,6,0,6,1/10/2016,14
5643,5643,5644,Internacional,2,0,281,32,Figueirense,2,0,410,19,51,691,4,0,4,1/10/2016,14
5644,5644,5645,Santa Cruz,6,0,378,20,Palmeiras,3,0,426,12,32,804,9,0,9,3/10/2016,14
5645,5645,5646,Coritiba,2,0,453,17,America-MG,2,0,386,15,32,839,4,0,4,3/10/2016,14
5646,5646,5647,Athletico-PR,2,0,457,9,Chapecoense,3,0,336,14,23,793,5,0,5,5/10/2016,14
5647,5647,5648,Vitoria,3,0,453,16,Gremio,3,0,357,19,35,810,6,0,6,5/10/2016,14
5648,5648,5649,Corinthians,0,0,446,16,Atletico-MG,1,1,304,16,32,750,1,1,2,5/10/2016,14
5649,5649,5650,Santos,0,0,445,16,Fluminense,0,0,447,10,26,892,0,0,0,5/10/2016,14
5650,5650,5651,Sport,0,0,386,19,Sao Paulo,2,0,463,17,36,849,2,0,2,5/10/2016,14
5651,5651,5652,Internacional,2,0,426,15,Coritiba,4,0,364,14,29,790,6,0,6,6/10/2016,14
5652,5652,5653,Cruzeiro,2,0,504,15,Ponte Preta,2,0,410,25,40,914,4,0,4,8/10/2016,14
5653,5653,5654,Flamengo,1,0,508,11,Santa Cruz,0,1,325,12,23,833,1,1,2,9/10/2016,14
5654,5654,5655,America-MG,2,1,458,17,Palmeiras,1,0,437,10,27,895,3,1,4,9/10/2016,14
5655,5655,5656,Figueirense,2,0,421,14,Botafogo-RJ,2,0,408,13,27,829,4,0,4,9/10/2016,14
5656,5656,5657,Chapecoense,1,0,366,16,Sport,1,1,443,19,35,809,2,1,3,12/10/2016,14
5657,5657,5658,Coritiba,4,0,367,13,Figueirense,3,0,187,22,35,554,7,0,7,12/10/2016,14
5658,5658,5659,Santa Cruz,2,0,437,8,Corinthians,2,0,518,7,15,955,4,0,4,12/10/2016,14
5659,5659,5660,Botafogo-RJ,3,0,385,17,Internacional,2,0,346,15,32,731,5,0,5,12/10/2016,14
5660,5660,5661,Palmeiras,1,0,429,16,Cruzeiro,4,0,345,16,32,774,5,0,5,13/10/2016,14
5661,5661,5662,Ponte Preta,4,0,274,23,Vitoria,2,0,369,12,35,643,6,0,6,13/10/2016,14
5662,5662,5663,Atletico-MG,0,0,521,8,America-MG,0,0,354,11,19,875,0,0,0,13/10/2016,14
5663,5663,5664,Fluminense,3,0,395,14,Flamengo,3,0,286,21,35,681,6,0,6,13/10/2016,14
5664,5664,5665,Sao Paulo,2,0,421,16,Santos,3,0,436,18,34,857,5,0,5,13/10/2016,14
5665,5665,5666,Gremio,2,0,573,16,Athletico-PR,3,0,438,13,29,1011,5,0,5,13/10/2016,14
5666,5666,5667,Botafogo-RJ,2,0,332,16,Atletico-MG,4,0,484,13,29,816,6,0,6,16/10/2016,14
5667,5667,5668,Cruzeiro,1,0,550,15,Chapecoense,2,0,360,17,32,910,3,0,3,16/10/2016,14
5668,5668,5669,Athletico-PR,0,0,333,18,Coritiba,3,0,436,14,32,769,3,0,3,16/10/2016,14
5669,5669,5670,Internacional,3,0,340,22,Flamengo,1,0,435,13,35,775,4,0,4,16/10/2016,14
5670,5670,5671,Figueirense,4,0,285,18,Palmeiras,3,0,302,29,47,587,7,0,7,16/10/2016,14
5671,5671,5672,Corinthians,2,0,609,11,America-MG,1,0,391,10,21,1000,3,0,3,16/10/2016,14
5672,5672,5673,Ponte Preta,0,0,333,19,Santa Cruz,2,0,524,17,36,857,2,0,2,16/10/2016,14
5673,5673,5674,Santos,1,0,615,13,Gremio,7,0,301,20,33,916,8,0,8,16/10/2016,14
5674,5674,5675,Sport,1,0,354,9,Vitoria,3,1,294,20,29,648,4,1,5,16/10/2016,14
5675,5675,5676,Fluminense,1,0,316,8,Sao Paulo,4,0,400,18,26,716,5,0,5,17/10/2016,14
5676,5676,5677,Santa Cruz,0,0,464,12,Botafogo-RJ,2,0,331,15,27,795,2,0,2,19/10/2016,14
5677,5677,5678,Sao Paulo,0,0,427,16,Ponte Preta,1,0,288,15,31,715,1,0,1,22/10/2016,14
5678,5678,5679,Flamengo,2,0,463,13,Corinthians,3,1,278,19,32,741,5,1,6,23/10/2016,14
5679,5679,5680,Vitoria,2,0,402,20,Cruzeiro,2,1,314,16,36,716,4,1,5,23/10/2016,14
5680,5680,5681,Palmeiras,3,0,284,26,Sport,2,0,345,23,49,629,5,0,5,23/10/2016,14
5681,5681,5682,Gremio,0,1,517,12,Internacional,2,1,229,25,37,746,2,2,4,23/10/2016,14
5682,5682,5683,Coritiba,0,1,449,12,Fluminense,4,0,426,17,29,875,4,1,5,23/10/2016,14
5683,5683,5684,Atletico-MG,2,0,409,16,Figueirense,3,2,352,15,31,761,5,2,7,23/10/2016,14
5684,5684,5685,Chapecoense,2,0,469,13,Santos,3,0,368,16,29,837,5,0,5,23/10/2016,14
5685,5685,5686,America-MG,0,0,398,8,Athletico-PR,0,0,547,9,17,945,0,0,0,24/10/2016,14
5686,5686,5687,Sport,2,0,428,12,Ponte Preta,3,0,330,23,35,758,5,0,5,27/10/2016,14
5687,5687,5688,Fluminense,3,0,401,20,Vitoria,2,0,279,22,42,680,5,0,5,28/10/2016,14
5688,5688,5689,Atletico-MG,0,0,343,12,Flamengo,1,0,374,14,26,717,1,0,1,29/10/2016,14
5689,5689,5690,Athletico-PR,1,0,395,17,Cruzeiro,1,0,535,13,30,930,2,0,2,29/10/2016,14
5690,5690,5691,Corinthians,1,0,488,11,Chapecoense,2,0,387,18,29,875,3,0,3,29/10/2016,14
5691,5691,5692,Botafogo-RJ,5,0,511,13,Coritiba,3,0,280,20,33,791,8,0,8,29/10/2016,14
5692,5692,5693,Internacional,2,1,416,15,Santa Cruz,2,0,476,11,26,892,4,1,5,29/10/2016,14
5693,5693,5694,Figueirense,2,0,347,22,Gremio,2,0,374,18,40,721,4,0,4,29/10/2016,14
5694,5694,5695,Santos,4,0,374,20,Palmeiras,3,0,442,22,42,816,7,0,7,29/10/2016,14
5695,5695,5696,America-MG,0,0,236,17,Sao Paulo,1,0,517,8,25,753,1,0,1,31/10/2016,14
5696,5696,5697,Flamengo,3,0,479,14,Botafogo-RJ,3,0,276,26,40,755,6,0,6,5/11/2016,14
5697,5697,5698,Sao Paulo,3,0,369,21,Corinthians,4,0,508,19,40,877,7,0,7,5/11/2016,14
5698,5698,5699,Ponte Preta,1,0,247,20,Santos,1,0,447,19,39,694,2,0,2,6/11/2016,14
5699,5699,5700,Santa Cruz,1,0,564,10,America-MG,1,0,461,9,19,1025,2,0,2,6/11/2016,14
5700,5700,5701,Cruzeiro,2,0,452,14,Fluminense,1,0,543,7,21,995,3,0,3,6/11/2016,14
5701,5701,5702,Palmeiras,0,0,333,10,Internacional,0,0,347,19,29,680,0,0,0,6/11/2016,14
5702,5702,5703,Vitoria,2,0,353,13,Athletico-PR,2,0,337,18,31,690,4,0,4,6/11/2016,14
5703,5703,5704,Coritiba,1,0,296,12,Atletico-MG,3,0,621,11,23,917,4,0,4,6/11/2016,14
5704,5704,5705,Chapecoense,1,0,381,16,Figueirense,2,1,299,20,36,680,3,1,4,6/11/2016,14
5705,5705,5706,Gremio,4,0,542,11,Sport,3,0,453,10,21,995,7,0,7,7/11/2016,14
5706,5706,5707,Fluminense,3,0,394,14,Athletico-PR,3,0,420,16,30,814,6,0,6,15/11/2016,14
5707,5707,5708,Botafogo-RJ,3,0,454,15,Chapecoense,1,0,255,18,33,709,4,0,4,16/11/2016,14
5708,5708,5709,Coritiba,3,0,469,18,Santa Cruz,2,0,406,13,31,875,5,0,5,16/11/2016,14
5709,5709,5710,Sport,2,0,441,10,Cruzeiro,2,0,398,11,21,839,4,0,4,16/11/2016,14
5710,5710,5711,America-MG,1,0,336,13,Flamengo,0,0,495,11,24,831,1,0,1,16/11/2016,14
5711,5711,5712,Figueirense,3,0,326,26,Corinthians,2,1,355,15,41,681,5,1,6,16/11/2016,14
5712,5712,5713,Santos,3,0,387,16,Vitoria,1,0,354,14,30,741,4,0,4,17/11/2016,14
5713,5713,5714,Sao Paulo,3,0,443,15,Gremio,2,0,593,17,32,1036,5,0,5,17/11/2016,14
5714,5714,5715,Internacional,1,0,350,15,Ponte Preta,3,0,289,19,34,639,4,0,4,17/11/2016,14
5715,5715,5716,Atletico-MG,2,0,451,18,Palmeiras,4,0,227,27,45,678,6,0,6,17/11/2016,14
5716,5716,5717,Vitoria,4,0,242,20,Figueirense,2,0,294,16,36,536,6,0,6,20/11/2016,14
5717,5717,5718,Cruzeiro,3,1,410,11,Santos,3,0,395,11,22,805,6,1,7,20/11/2016,14
5718,5718,5719,Palmeiras,0,0,433,13,Botafogo-RJ,4,1,258,22,35,691,4,1,5,20/11/2016,14
5719,5719,5720,Athletico-PR,0,0,374,11,Sport,2,0,518,12,23,892,2,0,2,20/11/2016,14
5720,5720,5721,Gremio,0,0,597,8,America-MG,2,0,400,18,26,997,2,0,2,20/11/2016,14
5721,5721,5722,Ponte Preta,3,0,301,20,Fluminense,2,1,565,18,38,866,5,1,6,20/11/2016,14
5722,5722,5723,Flamengo,1,0,497,15,Coritiba,2,0,377,18,33,874,3,0,3,20/11/2016,14
5723,5723,5724,Chapecoense,1,0,330,20,Sao Paulo,1,0,496,19,39,826,2,0,2,20/11/2016,14
5724,5724,5725,Santa Cruz,2,1,359,16,Atletico-MG,0,1,553,10,26,912,2,2,4,20/11/2016,14
5725,5725,5726,Corinthians,2,0,481,22,Internacional,2,0,347,22,44,828,4,0,4,21/11/2016,14
5726,5726,5727,America-MG,1,1,422,13,Sport,3,0,405,15,28,827,4,1,5,26/11/2016,14
5727,5727,5728,Botafogo-RJ,5,0,411,19,Ponte Preta,4,1,258,17,36,669,9,1,10,26/11/2016,14
5728,5728,5729,Corinthians,3,0,470,6,Athletico-PR,2,0,367,9,15,837,5,0,5,26/11/2016,14
5729,5729,5730,Atletico-MG,1,0,503,18,Sao Paulo,6,0,289,15,33,792,7,0,7,27/11/2016,14
5730,5730,5731,Palmeiras,1,0,299,25,Chapecoense,2,0,262,24,49,561,3,0,3,27/11/2016,14
5731,5731,5732,Flamengo,1,0,317,20,Santos,0,0,508,14,34,825,1,0,1,27/11/2016,14
5732,5732,5733,Internacional,3,0,441,13,Cruzeiro,4,0,415,15,28,856,7,0,7,27/11/2016,14
5733,5733,5734,Figueirense,3,0,341,26,Fluminense,3,0,470,28,54,811,6,0,6,27/11/2016,14
5734,5734,5735,Santa Cruz,3,0,419,12,Gremio,4,0,479,16,28,898,7,0,7,27/11/2016,14
5735,5735,5736,Coritiba,5,0,450,23,Vitoria,6,0,254,19,42,704,11,0,11,28/11/2016,14
5736,5736,5737,Santos,0,0,745,6,America-MG,1,0,231,9,15,976,1,0,1,11/12/2016,14
5737,5737,5738,Fluminense,1,0,370,19,Internacional,1,0,304,23,42,674,2,0,2,11/12/2016,14
5738,5738,5739,Gremio,2,0,611,10,Botafogo-RJ,3,1,285,13,23,896,5,1,6,11/12/2016,14
5739,5739,5740,Sao Paulo,1,1,486,13,Santa Cruz,1,0,464,9,22,950,2,1,3,11/12/2016,14
5740,5740,5741,Cruzeiro,2,0,421,9,Corinthians,4,0,501,22,31,922,6,0,6,11/12/2016,14
5741,5741,5742,Sport,5,0,520,22,Figueirense,2,0,248,22,44,768,7,0,7,11/12/2016,14
5742,5742,5743,Athletico-PR,2,0,494,15,Flamengo,5,1,366,12,27,860,7,1,8,11/12/2016,14
5743,5743,5744,Vitoria,1,0,350,15,Palmeiras,6,0,589,16,31,939,7,0,7,11/12/2016,14
5744,5744,5745,Ponte Preta,0,0,412,14,Coritiba,1,0,384,15,29,796,1,0,1,11/12/2016,14
5745,5745,5746,Flamengo,2,0,345,7,Atletico-MG,3,0,501,10,17,846,5,0,5,13/5/2017,15
5746,5746,5747,Corinthians,2,0,638,10,Chapecoense,2,0,304,12,22,942,4,0,4,13/5/2017,15
5747,5747,5748,Fluminense,1,0,306,15,Santos,5,0,512,18,33,818,6,0,6,14/5/2017,15
5748,5748,5749,Cruzeiro,0,0,321,10,Sao Paulo,1,0,533,13,23,854,1,0,1,14/5/2017,15
5749,5749,5750,Bahia,0,0,290,11,Athletico-PR,0,1,473,11,22,763,0,1,1,14/5/2017,15
5750,5750,5751,Ponte Preta,0,0,456,13,Sport,2,0,458,17,30,914,2,0,2,14/5/2017,15
5751,5751,5752,Avai,0,0,321,6,Vitoria,2,0,573,15,21,894,2,0,2,14/5/2017,15
5752,5752,5753,Palmeiras,0,0,399,19,Vasco,2,0,378,16,35,777,2,0,2,14/5/2017,15
5753,5753,5754,Gremio,2,0,450,13,Botafogo-RJ,5,0,415,19,32,865,7,0,7,14/5/2017,15
5754,5754,5755,Coritiba,1,0,494,17,Atletico-GO,2,0,315,13,30,809,3,0,3,15/5/2017,15
5755,5755,5756,Santos,6,0,338,24,Coritiba,4,0,378,17,41,716,10,0,10,20/5/2017,15
5756,5756,5757,Atletico-GO,2,0,332,11,Flamengo,1,0,641,13,24,973,3,0,3,20/5/2017,15
5757,5757,5758,Chapecoense,1,0,313,16,Palmeiras,1,0,393,13,29,706,2,0,2,20/5/2017,15
5758,5758,5759,Vasco,4,0,378,13,Bahia,1,1,253,23,36,631,5,1,6,21/5/2017,15
5759,5759,5760,Athletico-PR,2,0,566,11,Gremio,3,1,372,16,27,938,5,1,6,21/5/2017,15
5760,5760,5761,Vitoria,0,0,419,13,Corinthians,1,0,473,6,19,892,1,0,1,21/5/2017,15
5761,5761,5762,Atletico-MG,0,0,420,18,Fluminense,6,0,293,23,41,713,6,0,6,21/5/2017,15
5762,5762,5763,Botafogo-RJ,1,0,446,15,Ponte Preta,0,0,648,12,27,1094,1,0,1,21/5/2017,15
5763,5763,5764,Sport,3,0,364,20,Cruzeiro,3,0,457,14,34,821,6,0,6,21/5/2017,15
5764,5764,5765,Sao Paulo,1,0,444,16,Avai,2,0,352,10,26,796,3,0,3,22/5/2017,15
5765,5765,5766,Vasco,2,0,299,11,Fluminense,3,0,421,11,22,720,5,0,5,27/5/2017,15
5766,5766,5767,Sao Paulo,3,0,323,13,Palmeiras,1,0,571,16,29,894,4,0,4,27/5/2017,15
5767,5767,5768,Vitoria,3,0,364,19,Coritiba,3,0,347,16,35,711,6,0,6,27/5/2017,15
5768,5768,5769,Atletico-MG,2,0,564,16,Ponte Preta,2,0,277,14,30,841,4,0,4,28/5/2017,15
5769,5769,5770,Athletico-PR,1,0,430,10,Flamengo,0,0,556,12,22,986,1,0,1,28/5/2017,15
5770,5770,5771,Santos,2,0,509,8,Cruzeiro,3,0,427,14,22,936,5,0,5,28/5/2017,15
5771,5771,5772,Atletico-GO,2,0,403,23,Corinthians,0,0,430,11,34,833,2,0,2,28/5/2017,15
5772,5772,5773,Sport,3,1,499,21,Gremio,1,0,250,13,34,749,4,1,5,28/5/2017,15
5773,5773,5774,Botafogo-RJ,1,0,372,20,Bahia,1,0,382,18,38,754,2,0,2,28/5/2017,15
5774,5774,5775,Chapecoense,1,1,519,16,Avai,0,1,388,11,27,907,1,2,3,29/5/2017,15
5775,5775,5776,Coritiba,3,0,383,15,Athletico-PR,2,0,392,11,26,775,5,0,5,3/6/2017,15
5776,5776,5777,Fluminense,0,0,459,18,Vitoria,5,0,363,22,40,822,5,0,5,3/6/2017,15
5777,5777,5778,Corinthians,0,0,442,11,Santos,1,1,454,9,20,896,1,1,2,3/6/2017,15
5778,5778,5779,Flamengo,2,0,423,19,Botafogo-RJ,2,0,239,19,38,662,4,0,4,4/6/2017,15
5779,5779,5780,Avai,4,0,322,26,Sport,4,0,600,25,51,922,8,0,8,4/6/2017,15
5780,5780,5781,Palmeiras,2,0,398,20,Atletico-MG,4,0,363,12,32,761,6,0,6,4/6/2017,15
5781,5781,5782,Ponte Preta,2,0,365,13,Sao Paulo,5,0,436,12,25,801,7,0,7,4/6/2017,15
5782,5782,5783,Gremio,2,0,537,15,Vasco,3,0,374,13,28,911,5,0,5,4/6/2017,15
5783,5783,5784,Cruzeiro,1,0,525,8,Chapecoense,3,0,332,16,24,857,4,0,4,4/6/2017,15
5784,5784,5785,Bahia,0,0,462,21,Atletico-GO,2,0,321,27,48,783,2,0,2,5/6/2017,15
5785,5785,5786,Fluminense,3,0,394,19,Athletico-PR,3,0,346,16,35,740,6,0,6,6/6/2017,15
5786,5786,5787,Atletico-MG,3,0,469,20,Avai,1,0,390,10,30,859,4,0,4,7/6/2017,15
5787,5787,5788,Coritiba,4,0,331,14,Palmeiras,3,0,421,17,31,752,7,0,7,7/6/2017,15
5788,5788,5789,Santos,4,0,594,13,Botafogo-RJ,2,0,367,9,22,961,6,0,6,7/6/2017,15
5789,5789,5790,Vasco,0,0,448,10,Corinthians,3,0,357,14,24,805,3,0,3,7/6/2017,15
5790,5790,5791,Sport,2,0,302,17,Flamengo,2,0,465,16,33,767,4,0,4,7/6/2017,15
5791,5791,5792,Atletico-GO,1,0,297,20,Ponte Preta,2,1,536,9,29,833,3,1,4,8/6/2017,15
5792,5792,5793,Sao Paulo,1,0,370,14,Vitoria,1,0,371,18,32,741,2,0,2,8/6/2017,15
5793,5793,5794,Chapecoense,4,0,362,22,Gremio,3,0,414,9,31,776,7,0,7,8/6/2017,15
5794,5794,5795,Bahia,4,0,534,18,Cruzeiro,2,1,362,12,30,896,6,1,7,8/6/2017,15
5795,5795,5796,Palmeiras,4,0,419,24,Fluminense,2,0,322,19,43,741,6,0,6,10/6/2017,15
5796,5796,5797,Vasco,0,0,365,15,Sport,1,0,378,19,34,743,1,0,1,10/6/2017,15
5797,5797,5798,Botafogo-RJ,4,0,409,14,Coritiba,3,0,358,28,42,767,7,0,7,11/6/2017,15
5798,5798,5799,Ponte Preta,2,0,257,8,Chapecoense,4,0,467,22,30,724,6,0,6,11/6/2017,15
5799,5799,5800,Avai,2,1,327,17,Flamengo,1,0,523,18,35,850,3,1,4,11/6/2017,15
5800,5800,5801,Vitoria,3,0,353,20,Atletico-MG,2,0,480,7,27,833,5,0,5,11/6/2017,15
5801,5801,5802,Corinthians,1,0,492,11,Sao Paulo,1,0,386,15,26,878,2,0,2,11/6/2017,15
5802,5802,5803,Cruzeiro,3,0,622,11,Atletico-GO,4,0,264,21,32,886,7,0,7,11/6/2017,15
5803,5803,5804,Athletico-PR,1,0,495,15,Santos,0,1,391,12,27,886,1,1,2,11/6/2017,15
5804,5804,5805,Gremio,0,0,643,15,Bahia,1,0,361,16,31,1004,1,0,1,12/6/2017,15
5805,5805,5806,Atletico-MG,2,0,514,11,Athletico-PR,4,1,243,10,21,757,6,1,7,14/6/2017,15
5806,5806,5807,Atletico-GO,3,0,377,21,Avai,6,0,441,24,45,818,9,0,9,14/6/2017,15
5807,5807,5808,Vitoria,1,1,456,12,Botafogo-RJ,1,0,378,10,22,834,2,1,3,14/6/2017,15
5808,5808,5809,Sport,1,0,465,21,Sao Paulo,1,0,355,14,35,820,2,0,2,14/6/2017,15
5809,5809,5810,Flamengo,2,0,476,12,Ponte Preta,2,0,380,16,28,856,4,0,4,14/6/2017,15
5810,5810,5811,Santos,1,0,406,16,Palmeiras,3,0,490,14,30,896,4,0,4,14/6/2017,15
5811,5811,5812,Chapecoense,3,0,363,24,Vasco,2,0,362,15,39,725,5,0,5,14/6/2017,15
5812,5812,5813,Corinthians,0,0,533,9,Cruzeiro,1,0,470,16,25,1003,1,0,1,14/6/2017,15
5813,5813,5814,Coritiba,1,1,323,16,Bahia,4,1,367,14,30,690,5,2,7,15/6/2017,15
5814,5814,5815,Fluminense,4,0,494,12,Gremio,3,0,505,17,29,999,7,0,7,15/6/2017,15
5815,5815,5816,Atletico-GO,1,0,601,16,Athletico-PR,5,0,332,15,31,933,6,0,6,17/6/2017,15
5816,5816,5817,Vasco,4,0,399,20,Avai,1,0,415,22,42,814,5,0,5,17/6/2017,15
5817,5817,5818,Santos,3,0,560,17,Ponte Preta,4,0,423,13,30,983,7,0,7,17/6/2017,15
5818,5818,5819,Coritiba,2,0,339,18,Corinthians,3,0,434,13,31,773,5,0,5,18/6/2017,15
5819,5819,5820,Bahia,2,0,442,14,Palmeiras,5,0,271,23,37,713,7,0,7,18/6/2017,15
5820,5820,5821,Fluminense,1,0,240,16,Flamengo,6,0,369,25,41,609,7,0,7,18/6/2017,15
5821,5821,5822,Chapecoense,0,0,421,11,Botafogo-RJ,2,0,309,13,24,730,2,0,2,18/6/2017,15
5822,5822,5823,Sao Paulo,2,0,445,12,Atletico-MG,2,0,312,24,36,757,4,0,4,18/6/2017,15
5823,5823,5824,Sport,0,0,483,10,Vitoria,0,0,375,19,29,858,0,0,0,18/6/2017,15
5824,5824,5825,Cruzeiro,5,0,541,12,Gremio,2,0,442,14,26,983,7,0,7,19/6/2017,15
5825,5825,5826,Vitoria,2,0,453,15,Santos,1,0,319,10,25,772,3,0,3,21/6/2017,15
5826,5826,5827,Palmeiras,2,0,536,10,Atletico-GO,2,0,259,17,27,795,4,0,4,21/6/2017,15
5827,5827,5828,Botafogo-RJ,5,0,360,20,Vasco,1,0,440,11,31,800,6,0,6,21/6/2017,15
5828,5828,5829,Avai,1,0,423,19,Fluminense,1,0,445,20,39,868,2,0,2,21/6/2017,15
5829,5829,5830,Athletico-PR,3,0,299,17,Sao Paulo,3,0,553,15,32,852,6,0,6,21/6/2017,15
5830,5830,5831,Atletico-MG,2,0,431,23,Sport,1,0,390,26,49,821,3,0,3,21/6/2017,15
5831,5831,5832,Corinthians,2,1,434,15,Bahia,2,1,444,12,27,878,4,2,6,22/6/2017,15
5832,5832,5833,Ponte Preta,2,0,405,21,Cruzeiro,2,0,392,23,44,797,4,0,4,22/6/2017,15
5833,5833,5834,Gremio,2,0,439,18,Coritiba,0,0,396,11,29,835,2,0,2,22/6/2017,15
5834,5834,5835,Flamengo,3,0,359,21,Chapecoense,1,0,329,13,34,688,4,0,4,22/6/2017,15
5835,5835,5836,Santos,0,0,531,13,Sport,1,0,416,17,30,947,1,0,1,24/6/2017,15
5836,5836,5837,Vasco,2,0,434,21,Atletico-GO,0,0,398,19,40,832,2,0,2,25/6/2017,15
5837,5837,5838,Gremio,4,0,564,16,Corinthians,5,0,448,16,32,1012,9,0,9,25/6/2017,15
5838,5838,5839,Sao Paulo,1,0,365,12,Fluminense,1,0,342,25,37,707,2,0,2,25/6/2017,15
5839,5839,5840,Athletico-PR,0,0,473,10,Vitoria,3,0,517,11,21,990,3,0,3,25/6/2017,15
5840,5840,5841,Cruzeiro,0,0,413,15,Coritiba,2,0,333,26,41,746,2,0,2,25/6/2017,15
5841,5841,5842,Ponte Preta,6,2,440,21,Palmeiras,3,1,365,28,49,805,9,3,12,25/6/2017,15
5842,5842,5843,Bahia,1,1,375,6,Flamengo,3,0,518,23,29,893,4,1,5,25/6/2017,15
5843,5843,5844,Chapecoense,5,0,462,24,Atletico-MG,5,0,237,19,43,699,10,0,10,25/6/2017,15
5844,5844,5845,Botafogo-RJ,1,0,588,11,Avai,2,0,231,10,21,819,3,0,3,26/6/2017,15
5845,5845,5846,Palmeiras,3,0,480,23,Gremio,1,0,328,14,37,808,4,0,4,1/7/2017,15
5846,5846,5847,Atletico-GO,2,1,263,14,Santos,1,0,553,10,24,816,3,1,4,1/7/2017,15
5847,5847,5848,Sport,1,0,466,12,Athletico-PR,3,0,351,18,30,817,4,0,4,2/7/2017,15
5848,5848,5849,Vitoria,5,0,439,17,Bahia,3,0,359,16,33,798,8,0,8,2/7/2017,15
5849,5849,5850,Atletico-MG,4,0,357,23,Cruzeiro,4,0,394,18,41,751,8,0,8,2/7/2017,15
5850,5850,5851,Flamengo,1,0,412,17,Sao Paulo,1,0,464,14,31,876,2,0,2,2/7/2017,15
5851,5851,5852,Corinthians,3,0,645,14,Botafogo-RJ,2,0,342,14,28,987,5,0,5,2/7/2017,15
5852,5852,5853,Avai,2,0,407,14,Ponte Preta,2,0,525,25,39,932,4,0,4,2/7/2017,15
5853,5853,5854,Coritiba,3,0,395,17,Vasco,5,0,253,20,37,648,8,0,8,2/7/2017,15
5854,5854,5855,Fluminense,3,0,453,14,Chapecoense,4,1,202,22,36,655,7,1,8,3/7/2017,15
5855,5855,5856,Atletico-GO,1,0,353,12,Vitoria,4,0,366,23,35,719,5,0,5,8/7/2017,15
5856,5856,5857,Vasco,4,0,282,23,Flamengo,1,0,415,15,38,697,5,0,5,8/7/2017,15
5857,5857,5858,Corinthians,2,0,498,17,Ponte Preta,2,0,518,8,25,1016,4,0,4,8/7/2017,15
5858,5858,5859,Chapecoense,1,0,359,18,Athletico-PR,3,0,504,13,31,863,4,0,4,9/7/2017,15
5859,5859,5860,Bahia,4,0,620,16,Fluminense,2,0,242,18,34,862,6,0,6,9/7/2017,15
5860,5860,5861,Gremio,1,0,685,9,Avai,4,1,257,17,26,942,5,1,6,9/7/2017,15
5861,5861,5862,Cruzeiro,1,0,306,12,Palmeiras,4,0,484,15,27,790,5,0,5,9/7/2017,15
5862,5862,5863,Santos,4,0,442,18,Sao Paulo,3,0,414,5,23,856,7,0,7,9/7/2017,15
5863,5863,5864,Botafogo-RJ,1,0,503,14,Atletico-MG,3,0,391,27,41,894,4,0,4,9/7/2017,15
5864,5864,5865,Coritiba,2,1,399,16,Sport,2,0,291,18,34,690,4,1,5,10/7/2017,15
5865,5865,5866,Ponte Preta,1,0,569,12,Bahia,3,0,307,14,26,876,4,0,4,12/7/2017,15
5866,5866,5867,Atletico-MG,1,0,485,9,Santos,2,0,298,13,22,783,3,0,3,12/7/2017,15
5867,5867,5868,Fluminense,3,0,509,13,Botafogo-RJ,4,0,360,20,33,869,7,0,7,12/7/2017,15
5868,5868,5869,Palmeiras,3,0,490,16,Corinthians,4,0,332,14,30,822,7,0,7,12/7/2017,15
5869,5869,5870,Athletico-PR,3,0,621,16,Cruzeiro,1,0,403,9,25,1024,4,0,4,12/7/2017,15
5870,5870,5871,Vitoria,4,0,514,16,Vasco,3,0,251,14,30,765,7,0,7,12/7/2017,15
5871,5871,5872,Sao Paulo,0,0,600,18,Atletico-GO,3,0,211,21,39,811,3,0,3,13/7/2017,15
5872,5872,5873,Sport,2,0,385,9,Chapecoense,8,0,346,26,35,731,10,0,10,13/7/2017,15
5873,5873,5874,Flamengo,2,0,587,12,Gremio,2,0,388,20,32,975,4,0,4,13/7/2017,15
5874,5874,5875,Avai,2,0,455,14,Coritiba,2,0,276,18,32,731,4,0,4,13/7/2017,15
5875,5875,5876,Corinthians,0,0,621,5,Athletico-PR,0,0,372,11,16,993,0,0,0,15/7/2017,15
5876,5876,5877,Palmeiras,2,0,461,21,Vitoria,3,0,363,19,40,824,5,0,5,16/7/2017,15
5877,5877,5878,Vasco,4,0,354,16,Santos,2,1,471,25,41,825,6,1,7,16/7/2017,15
5878,5878,5879,Atletico-GO,2,0,334,21,Atletico-MG,3,0,449,24,45,783,5,0,5,16/7/2017,15
5879,5879,5880,Chapecoense,4,0,216,22,Sao Paulo,2,0,455,14,36,671,6,0,6,16/7/2017,15
5880,5880,5881,Cruzeiro,3,0,332,16,Flamengo,1,0,588,14,30,920,4,0,4,16/7/2017,15
5881,5881,5882,Gremio,1,0,536,20,Ponte Preta,2,0,334,18,38,870,3,0,3,16/7/2017,15
5882,5882,5883,Bahia,2,0,533,18,Avai,0,0,264,12,30,797,2,0,2,16/7/2017,15
5883,5883,5884,Coritiba,4,0,329,19,Fluminense,4,0,292,18,37,621,8,0,8,16/7/2017,15
5884,5884,5885,Botafogo-RJ,4,0,407,14,Sport,3,0,526,16,30,933,7,0,7,17/7/2017,15
5885,5885,5886,Vitoria,3,0,464,18,Gremio,3,0,486,7,25,950,6,0,6,19/7/2017,15
5886,5886,5887,Santos,5,0,542,13,Chapecoense,2,0,368,17,30,910,7,0,7,19/7/2017,15
5887,5887,5888,Avai,2,0,257,18,Corinthians,3,0,704,10,28,961,5,0,5,19/7/2017,15
5888,5888,5889,Ponte Preta,1,0,364,12,Coritiba,0,0,439,12,24,803,1,0,1,19/7/2017,15
5889,5889,5890,Atletico-MG,4,0,588,19,Bahia,6,0,264,18,37,852,10,0,10,19/7/2017,15
5890,5890,5891,Sao Paulo,3,0,329,26,Vasco,3,0,409,20,46,738,6,0,6,19/7/2017,15
5891,5891,5892,Flamengo,2,0,451,16,Palmeiras,9,0,286,23,39,737,11,0,11,19/7/2017,15
5892,5892,5893,Fluminense,3,0,409,21,Cruzeiro,3,0,438,18,39,847,6,0,6,20/7/2017,15
5893,5893,5894,Sport,2,0,317,22,Atletico-GO,1,0,295,34,56,612,3,0,3,20/7/2017,15
5894,5894,5895,Athletico-PR,3,0,531,16,Botafogo-RJ,4,1,353,21,37,884,7,1,8,20/7/2017,15
5895,5895,5896,Vitoria,2,0,493,13,Chapecoense,5,0,239,19,32,732,7,0,7,22/7/2017,15
5896,5896,5897,Flamengo,1,0,418,20,Coritiba,6,0,423,24,44,841,7,0,7,22/7/2017,15
5897,5897,5898,Santos,1,0,460,10,Bahia,1,0,440,19,29,900,2,0,2,23/7/2017,15
5898,5898,5899,Avai,2,0,246,20,Cruzeiro,0,0,638,10,30,884,2,0,2,23/7/2017,15
5899,5899,5900,Sport,3,0,464,21,Palmeiras,4,0,290,31,52,754,7,0,7,23/7/2017,15
5900,5900,5901,Fluminense,2,0,510,15,Corinthians,2,0,412,13,28,922,4,0,4,23/7/2017,15
5901,5901,5902,Athletico-PR,2,0,614,25,Ponte Preta,2,0,265,19,44,879,4,0,4,23/7/2017,15
5902,5902,5903,Atletico-GO,1,0,411,12,Botafogo-RJ,4,0,407,20,32,818,5,0,5,23/7/2017,15
5903,5903,5904,Atletico-MG,5,0,461,24,Vasco,3,0,341,16,40,802,8,0,8,23/7/2017,15
5904,5904,5905,Sao Paulo,1,0,507,17,Gremio,3,0,408,14,31,915,4,0,4,24/7/2017,15
5905,5905,5906,Botafogo-RJ,0,0,314,9,Sao Paulo,1,0,578,11,20,892,1,0,1,29/7/2017,15
5906,5906,5907,Palmeiras,1,0,661,19,Avai,2,1,262,18,37,923,3,1,4,29/7/2017,15
5907,5907,5908,Chapecoense,1,0,366,21,Atletico-GO,1,0,367,19,40,733,2,0,2,30/7/2017,15
5908,5908,5909,Coritiba,4,0,336,18,Atletico-MG,4,0,327,25,43,663,8,0,8,30/7/2017,15
5909,5909,5910,Bahia,2,0,492,18,Sport,6,0,383,24,42,875,8,0,8,30/7/2017,15
5910,5910,5911,Corinthians,0,0,388,9,Flamengo,1,0,549,16,25,937,1,0,1,30/7/2017,15
5911,5911,5912,Gremio,3,1,601,14,Santos,5,0,434,17,31,1035,8,1,9,30/7/2017,15
5912,5912,5913,Cruzeiro,4,0,514,15,Vitoria,4,0,306,23,38,820,8,0,8,30/7/2017,15
5913,5913,5914,Vasco,3,0,450,13,Athletico-PR,3,0,365,20,33,815,6,0,6,31/7/2017,15
5914,5914,5916,Sport,5,0,503,14,Fluminense,4,1,232,18,32,735,9,1,10,2/8/2017,15
5915,5915,5917,Chapecoense,5,0,328,26,Bahia,3,0,344,17,43,672,8,0,8,2/8/2017,15
5916,5916,5918,Atletico-MG,3,0,543,19,Corinthians,1,0,415,12,31,958,4,0,4,2/8/2017,15
5917,5917,5919,Vitoria,3,0,355,20,Ponte Preta,1,0,504,7,27,859,4,0,4,2/8/2017,15
5918,5918,5920,Santos,2,1,402,18,Flamengo,2,1,480,15,33,882,4,2,6,2/8/2017,15
5919,5919,5921,Atletico-GO,4,0,451,20,Gremio,2,0,472,21,41,923,6,0,6,2/8/2017,15
5920,5920,5922,Botafogo-RJ,5,0,407,22,Palmeiras,2,0,342,14,36,749,7,0,7,2/8/2017,15
5921,5921,5923,Athletico-PR,1,0,603,9,Avai,2,0,355,18,27,958,3,0,3,3/8/2017,15
5922,5922,5924,Sao Paulo,4,0,531,18,Coritiba,5,0,271,15,33,802,9,0,9,3/8/2017,15
5923,5923,5925,Vasco,4,0,460,12,Cruzeiro,1,0,487,18,30,947,5,0,5,3/8/2017,15
5924,5924,5926,Corinthians,1,0,454,2,Sport,2,0,569,10,12,1023,3,0,3,5/8/2017,15
5925,5925,5927,Fluminense,1,0,453,13,Atletico-GO,3,0,419,12,25,872,4,0,4,5/8/2017,15
5926,5926,5928,Flamengo,4,0,497,15,Vitoria,2,0,286,21,36,783,6,0,6,6/8/2017,15
5927,5927,5929,Cruzeiro,3,0,521,16,Botafogo-RJ,3,0,335,15,31,856,6,0,6,6/8/2017,15
5928,5928,5930,Gremio,3,0,668,18,Atletico-MG,1,0,389,13,31,1057,4,0,4,6/8/2017,15
5929,5929,5931,Coritiba,0,0,408,13,Chapecoense,0,0,419,21,34,827,0,0,0,6/8/2017,15
5930,5930,5932,Palmeiras,1,0,635,10,Athletico-PR,3,0,338,22,32,973,4,0,4,6/8/2017,15
5931,5931,5933,Bahia,4,0,271,20,Sao Paulo,2,0,567,12,32,838,6,0,6,6/8/2017,15
5932,5932,5934,Avai,3,0,324,22,Santos,1,0,544,16,38,868,4,0,4,6/8/2017,15
5933,5933,5935,Ponte Preta,1,0,377,17,Vasco,4,0,399,16,33,776,5,0,5,6/8/2017,15
5934,5934,5915,Ponte Preta,1,0,329,14,Fluminense,1,0,414,12,26,743,2,0,2,9/8/2017,15
5935,5935,5936,Atletico-GO,2,0,331,27,Coritiba,3,0,339,20,47,670,5,0,5,12/8/2017,15
5936,5936,5937,Vitoria,1,0,424,14,Avai,3,0,298,11,25,722,4,0,4,12/8/2017,15
5937,5937,5938,Sao Paulo,4,1,333,19,Cruzeiro,3,2,432,18,37,765,7,3,10,13/8/2017,15
5938,5938,5939,Sport,1,0,681,14,Ponte Preta,1,0,296,10,24,977,2,0,2,13/8/2017,15
5939,5939,5940,Atletico-MG,4,0,465,22,Flamengo,1,1,417,17,39,882,5,1,6,13/8/2017,15
5940,5940,5941,Vasco,1,0,354,17,Palmeiras,2,0,530,13,30,884,3,0,3,13/8/2017,15
5941,5941,5942,Athletico-PR,2,0,455,13,Bahia,4,0,344,15,28,799,6,0,6,13/8/2017,15
5942,5942,5943,Botafogo-RJ,3,0,326,18,Gremio,1,0,541,15,33,867,4,0,4,13/8/2017,15
5943,5943,5944,Santos,2,0,522,7,Fluminense,2,0,480,10,17,1002,4,0,4,14/8/2017,15
5944,5944,5946,Corinthians,1,0,737,9,Vitoria,2,0,290,21,30,1027,3,0,3,19/8/2017,15
5945,5945,5947,Flamengo,2,0,515,12,Atletico-GO,3,0,347,13,25,862,5,0,5,19/8/2017,15
5946,5946,5948,Gremio,2,0,507,11,Athletico-PR,2,0,458,26,37,965,4,0,4,20/8/2017,15
5947,5947,5949,Avai,1,0,309,17,Sao Paulo,3,0,522,16,33,831,4,0,4,20/8/2017,15
5948,5948,5950,Bahia,0,0,402,18,Vasco,4,0,473,18,36,875,4,0,4,20/8/2017,15
5949,5949,5951,Cruzeiro,1,0,432,11,Sport,0,0,526,12,23,958,1,0,1,20/8/2017,15
5950,5950,5952,Ponte Preta,4,0,393,18,Botafogo-RJ,4,0,397,18,36,790,8,0,8,20/8/2017,15
5951,5951,5953,Coritiba,3,0,325,13,Santos,1,0,428,7,20,753,4,0,4,20/8/2017,15
5952,5952,5954,Palmeiras,1,0,572,11,Chapecoense,4,0,247,24,35,819,5,0,5,20/8/2017,15
5953,5953,5955,Fluminense,0,0,0,0,Atletico-MG,0,0,0,0,0,0,0,0,0,21/8/2017,15
5954,5954,5945,Chapecoense,1,0,292,13,Corinthians,4,0,567,7,20,859,5,0,5,23/8/2017,15
5955,5955,5956,Fluminense,2,0,490,14,Vasco,4,0,386,12,26,876,6,0,6,26/8/2017,15
5956,5956,5957,Corinthians,1,0,591,15,Atletico-GO,5,0,290,17,32,881,6,0,6,26/8/2017,15
5957,5957,5958,Ponte Preta,4,0,353,20,Atletico-MG,4,0,506,19,39,859,8,0,8,27/8/2017,15
5958,5958,5959,Palmeiras,1,0,484,12,Sao Paulo,2,0,364,8,20,848,3,0,3,27/8/2017,15
5959,5959,5960,Bahia,2,0,316,14,Botafogo-RJ,0,0,520,9,23,836,2,0,2,27/8/2017,15
5960,5960,5961,Flamengo,0,0,519,6,Athletico-PR,2,0,476,11,17,995,2,0,2,27/8/2017,15
5961,5961,5962,Cruzeiro,0,0,466,13,Santos,2,0,402,18,31,868,2,0,2,27/8/2017,15
5962,5962,5963,Avai,4,0,322,18,Chapecoense,5,0,446,22,40,768,9,0,9,27/8/2017,15
5963,5963,5964,Coritiba,2,2,482,18,Vitoria,2,1,245,22,40,727,4,3,7,28/8/2017,15
5964,5964,5965,Gremio,1,0,541,8,Sport,5,0,501,21,29,1042,6,0,6,2/9/2017,15
5965,5965,5966,Atletico-MG,3,0,455,14,Palmeiras,3,2,299,18,32,754,6,2,8,9/9/2017,15
5966,5966,5967,Vasco,3,0,368,18,Gremio,0,0,628,11,29,996,3,0,3,9/9/2017,15
5967,5967,5968,Sao Paulo,2,1,411,12,Ponte Preta,1,0,453,9,21,864,3,1,4,9/9/2017,15
5968,5968,5969,Athletico-PR,1,0,504,16,Coritiba,3,1,284,15,31,788,4,1,5,10/9/2017,15
5969,5969,5970,Santos,3,0,364,9,Corinthians,5,0,463,17,26,827,8,0,8,10/9/2017,15
5970,5970,5971,Sport,4,0,630,13,Avai,5,0,243,17,30,873,9,0,9,10/9/2017,15
5971,5971,5972,Vitoria,1,0,417,9,Fluminense,3,1,365,11,20,782,4,1,5,10/9/2017,15
5972,5972,5973,Chapecoense,2,0,421,15,Cruzeiro,1,0,363,17,32,784,3,0,3,10/9/2017,15
5973,5973,5974,Botafogo-RJ,0,0,332,10,Flamengo,0,0,434,16,26,766,0,0,0,10/9/2017,15
5974,5974,5975,Atletico-GO,1,0,355,16,Bahia,2,0,462,11,27,817,3,0,3,11/9/2017,15
5975,5975,5976,Botafogo-RJ,2,0,459,14,Santos,2,0,446,12,26,905,4,0,4,16/9/2017,15
5976,5976,5977,Ponte Preta,2,0,477,22,Atletico-GO,2,0,405,20,42,882,4,0,4,16/9/2017,15
5977,5977,5978,Avai,2,0,284,17,Atletico-MG,2,1,611,16,33,895,4,1,5,17/9/2017,15
5978,5978,5979,Gremio,1,0,686,6,Chapecoense,5,0,195,19,25,881,6,0,6,17/9/2017,15
5979,5979,5980,Corinthians,1,0,558,15,Vasco,2,0,425,9,24,983,3,0,3,17/9/2017,15
5980,5980,5981,Athletico-PR,3,0,475,15,Fluminense,3,0,423,13,28,898,6,0,6,17/9/2017,15
5981,5981,5982,Vitoria,3,0,345,21,Sao Paulo,2,0,457,16,37,802,5,0,5,17/9/2017,15
5982,5982,5983,Flamengo,0,0,531,13,Sport,3,1,396,18,31,927,3,1,4,17/9/2017,15
5983,5983,5984,Cruzeiro,5,1,376,12,Bahia,1,0,371,19,31,747,6,1,7,17/9/2017,15
5984,5984,5985,Palmeiras,3,0,350,18,Coritiba,3,0,375,17,35,725,6,0,6,18/9/2017,15
5985,5985,5986,Flamengo,2,0,515,14,Avai,0,0,232,16,30,747,2,0,2,23/9/2017,15
5986,5986,5987,Santos,1,0,484,7,Athletico-PR,1,0,595,14,21,1079,2,0,2,23/9/2017,15
5987,5987,5988,Sao Paulo,2,0,474,13,Corinthians,4,0,511,12,25,985,6,0,6,24/9/2017,15
5988,5988,5989,Chapecoense,4,0,340,16,Ponte Preta,3,0,459,19,35,799,7,0,7,24/9/2017,15
5989,5989,5990,Coritiba,2,0,328,20,Botafogo-RJ,3,0,360,19,39,688,5,0,5,24/9/2017,15
5990,5990,5991,Atletico-GO,4,0,455,16,Cruzeiro,2,0,392,18,34,847,6,0,6,24/9/2017,15
5991,5991,5992,Fluminense,2,0,409,26,Palmeiras,2,0,403,9,35,812,4,0,4,24/9/2017,15
5992,5992,5993,Atletico-MG,1,0,575,10,Vitoria,2,0,296,21,31,871,3,0,3,24/9/2017,15
5993,5993,5994,Bahia,4,0,349,18,Gremio,5,0,493,17,35,842,9,0,9,24/9/2017,15
5994,5994,5995,Sport,1,1,378,13,Vasco,4,0,399,16,29,777,5,1,6,25/9/2017,15
5995,5995,5996,Vasco,3,0,566,15,Chapecoense,0,0,300,22,37,866,3,0,3,30/9/2017,15
5996,5996,5997,Bahia,4,0,438,13,Coritiba,5,0,389,18,31,827,9,0,9,30/9/2017,15
5997,5997,5998,Palmeiras,3,0,361,18,Santos,5,0,236,22,40,597,8,0,8,30/9/2017,15
5998,5998,5999,Cruzeiro,3,0,425,15,Corinthians,4,0,574,14,29,999,7,0,7,1/10/2017,15
5999,5999,6000,Botafogo-RJ,2,1,429,11,Vitoria,2,0,384,21,32,813,4,1,5,1/10/2017,15
6000,6000,6001,Sao Paulo,0,0,451,12,Sport,2,0,496,15,27,947,2,0,2,1/10/2017,15
6001,6001,6002,Gremio,1,0,588,12,Fluminense,2,0,356,18,30,944,3,0,3,1/10/2017,15
6002,6002,6003,Avai,2,0,417,14,Atletico-GO,2,0,419,24,38,836,4,0,4,1/10/2017,15
6003,6003,6004,Athletico-PR,1,0,569,17,Atletico-MG,4,0,337,16,33,906,5,0,5,1/10/2017,15
6004,6004,6005,Ponte Preta,5,1,241,23,Flamengo,3,0,518,17,40,759,8,1,9,2/10/2017,15
6005,6005,6006,Cruzeiro,5,0,615,8,Ponte Preta,0,1,305,12,20,920,5,1,6,7/10/2017,15
6006,6006,6016,Athletico-PR,3,0,605,15,Atletico-GO,2,0,365,17,32,970,5,0,5,11/10/2017,15
6007,6007,6017,Botafogo-RJ,1,0,577,12,Chapecoense,3,0,328,20,32,905,4,0,4,11/10/2017,15
6008,6008,6018,Corinthians,1,0,539,8,Coritiba,3,0,389,16,24,928,4,0,4,11/10/2017,15
6009,6009,6019,Gremio,0,0,589,15,Cruzeiro,0,0,479,13,28,1068,0,0,0,11/10/2017,15
6010,6010,6020,Avai,5,1,491,23,Vasco,2,1,329,28,51,820,7,2,9,11/10/2017,15
6011,6011,6021,Atletico-MG,1,0,391,16,Sao Paulo,3,0,448,12,28,839,4,0,4,11/10/2017,15
6012,6012,6022,Vitoria,1,1,428,18,Sport,3,0,350,13,31,778,4,1,5,12/10/2017,15
6013,6013,6023,Flamengo,2,0,413,17,Fluminense,4,0,274,16,33,687,6,0,6,12/10/2017,15
6014,6014,6024,Ponte Preta,2,1,301,20,Santos,2,0,449,11,31,750,4,1,5,12/10/2017,15
6015,6015,6025,Palmeiras,1,0,334,23,Bahia,2,0,390,24,47,724,3,0,3,12/10/2017,15
6016,6016,6007,Vasco,5,0,325,16,Botafogo-RJ,3,0,513,13,29,838,8,0,8,14/10/2017,15
6017,6017,6008,Sao Paulo,1,0,583,6,Athletico-PR,2,1,461,12,18,1044,3,1,4,14/10/2017,15
6018,6018,6009,Chapecoense,2,0,296,23,Flamengo,2,0,423,17,40,719,4,0,4,15/10/2017,15
6019,6019,6010,Atletico-GO,1,1,436,18,Palmeiras,1,0,615,13,31,1051,2,1,3,15/10/2017,15
6020,6020,6011,Fluminense,2,0,486,18,Avai,2,0,463,12,30,949,4,0,4,15/10/2017,15
6021,6021,6012,Sport,2,0,381,19,Atletico-MG,2,0,431,14,33,812,4,0,4,15/10/2017,15
6022,6022,6013,Coritiba,4,0,437,14,Gremio,3,0,352,16,30,789,7,0,7,15/10/2017,15
6023,6023,6014,Bahia,0,0,451,11,Corinthians,2,0,515,16,27,966,2,0,2,15/10/2017,15
6024,6024,6015,Santos,2,0,463,12,Vitoria,4,0,381,15,27,844,6,0,6,16/10/2017,15
6025,6025,6026,Atletico-GO,2,1,429,23,Vasco,2,0,483,10,33,912,4,1,5,18/10/2017,15
6026,6026,6027,Coritiba,1,0,337,7,Cruzeiro,1,0,623,9,16,960,2,0,2,18/10/2017,15
6027,6027,6028,Atletico-MG,1,1,427,16,Chapecoense,3,0,420,15,31,847,4,1,5,18/10/2017,15
6028,6028,6029,Avai,2,0,338,20,Botafogo-RJ,4,0,503,22,42,841,6,0,6,18/10/2017,15
6029,6029,6030,Fluminense,2,0,339,23,Sao Paulo,0,0,596,12,35,935,2,0,2,18/10/2017,15
6030,6030,6031,Corinthians,1,0,557,13,Gremio,1,0,453,14,27,1010,2,0,2,18/10/2017,15
6031,6031,6032,Vitoria,0,0,515,11,Athletico-PR,3,0,328,12,23,843,3,0,3,19/10/2017,15
6032,6032,6033,Palmeiras,0,0,513,14,Ponte Preta,4,0,283,18,32,796,4,0,4,19/10/2017,15
6033,6033,6034,Flamengo,5,0,497,23,Bahia,4,0,291,11,34,788,9,0,9,19/10/2017,15
6034,6034,6035,Sport,1,0,408,17,Santos,5,0,389,23,40,797,6,0,6,19/10/2017,15
6035,6035,6036,Vasco,1,1,362,10,Coritiba,2,0,416,15,25,778,3,1,4,21/10/2017,15
6036,6036,6037,Santos,1,0,542,15,Atletico-GO,1,0,423,14,29,965,2,0,2,22/10/2017,15
6037,6037,6038,Bahia,2,0,411,12,Vitoria,3,0,370,17,29,781,5,0,5,22/10/2017,15
6038,6038,6039,Gremio,2,0,472,17,Palmeiras,1,0,482,19,36,954,3,0,3,22/10/2017,15
6039,6039,6040,Sao Paulo,1,0,366,14,Flamengo,1,0,514,12,26,880,2,0,2,22/10/2017,15
6040,6040,6041,Athletico-PR,0,0,488,15,Sport,2,0,376,13,28,864,2,0,2,22/10/2017,15
6041,6041,6042,Cruzeiro,2,0,467,23,Atletico-MG,4,0,337,14,37,804,6,0,6,22/10/2017,15
6042,6042,6043,Chapecoense,1,0,291,22,Fluminense,1,0,608,12,34,899,2,0,2,22/10/2017,15
6043,6043,6044,Ponte Preta,5,0,513,19,Avai,2,0,251,19,38,764,7,0,7,22/10/2017,15
6044,6044,6045,Botafogo-RJ,3,0,375,19,Corinthians,2,0,629,14,33,1004,5,0,5,23/10/2017,15
6045,6045,6046,Sao Paulo,1,0,385,12,Santos,6,0,460,31,43,845,7,0,7,28/10/2017,15
6046,6046,6047,Flamengo,1,0,457,16,Vasco,1,0,348,12,28,805,2,0,2,28/10/2017,15
6047,6047,6048,Athletico-PR,1,0,630,6,Chapecoense,4,0,388,20,26,1018,5,0,5,28/10/2017,15
6048,6048,6049,Ponte Preta,4,0,263,19,Corinthians,1,0,567,12,31,830,5,0,5,29/10/2017,15
6049,6049,6050,Fluminense,1,0,579,19,Bahia,3,1,274,17,36,853,4,1,5,29/10/2017,15
6050,6050,6051,Atletico-MG,1,0,469,21,Botafogo-RJ,2,0,317,16,37,786,3,0,3,29/10/2017,15
6051,6051,6052,Vitoria,1,0,487,19,Atletico-GO,3,0,348,18,37,835,4,0,4,29/10/2017,15
6052,6052,6053,Sport,3,0,371,21,Coritiba,6,0,281,21,42,652,9,0,9,29/10/2017,15
6053,6053,6054,Avai,1,0,472,13,Gremio,2,0,444,19,32,916,3,0,3,29/10/2017,15
6054,6054,6055,Palmeiras,0,0,615,9,Cruzeiro,2,0,375,9,18,990,2,0,2,30/10/2017,15
6055,6055,6056,Santos,1,0,437,12,Atletico-MG,3,0,448,18,30,885,4,0,4,4/11/2017,15
6056,6056,6057,Botafogo-RJ,3,0,351,16,Fluminense,4,0,493,16,32,844,7,0,7,4/11/2017,15
6057,6057,6058,Atletico-GO,2,0,409,17,Sao Paulo,0,0,637,9,26,1046,2,0,2,4/11/2017,15
6058,6058,6059,Coritiba,1,0,405,15,Avai,2,0,430,6,21,835,3,0,3,4/11/2017,15
6059,6059,6060,Corinthians,6,0,250,21,Palmeiras,5,1,386,11,32,636,11,1,12,5/11/2017,15
6060,6060,6061,Cruzeiro,1,0,488,9,Athletico-PR,2,0,536,13,22,1024,3,0,3,5/11/2017,15
6061,6061,6062,Gremio,0,0,660,12,Flamengo,0,0,466,14,26,1126,0,0,0,5/11/2017,15
6062,6062,6063,Bahia,1,0,394,16,Ponte Preta,2,0,368,18,34,762,3,0,3,5/11/2017,15
6063,6063,6064,Vasco,3,0,343,17,Vitoria,4,0,495,23,40,838,7,0,7,5/11/2017,15
6064,6064,6065,Chapecoense,3,0,308,21,Sport,3,1,425,16,37,733,6,1,7,5/11/2017,15
6065,6065,6066,Ponte Preta,4,1,357,19,Gremio,3,0,526,14,33,883,7,1,8,8/11/2017,15
6066,6066,6067,Avai,2,0,353,18,Bahia,2,0,438,25,43,791,4,0,4,8/11/2017,15
6067,6067,6068,Sport,2,0,575,13,Botafogo-RJ,4,0,346,20,33,921,6,0,6,8/11/2017,15
6068,6068,6069,Athletico-PR,2,0,549,11,Corinthians,1,0,347,11,22,896,3,0,3,8/11/2017,15
6069,6069,6070,Santos,2,0,466,14,Vasco,5,0,345,14,28,811,7,0,7,8/11/2017,15
6070,6070,6071,Flamengo,2,0,475,17,Cruzeiro,3,0,468,10,27,943,5,0,5,8/11/2017,15
6071,6071,6072,Vitoria,3,1,227,20,Palmeiras,1,0,642,10,30,869,4,1,5,8/11/2017,15
6072,6072,6073,Sao Paulo,1,0,604,8,Chapecoense,2,0,287,14,22,891,3,0,3,9/11/2017,15
6073,6073,6074,Atletico-MG,6,0,517,19,Atletico-GO,5,0,446,13,32,963,11,0,11,9/11/2017,15
6074,6074,6075,Fluminense,3,0,435,11,Coritiba,4,0,273,20,31,708,7,0,7,9/11/2017,15
6075,6075,6076,Botafogo-RJ,0,0,627,13,Athletico-PR,1,0,488,14,27,1115,1,0,1,11/11/2017,15
6076,6076,6077,Corinthians,3,0,651,15,Avai,3,0,333,12,27,984,6,0,6,11/11/2017,15
6077,6077,6078,Vasco,2,0,380,15,Sao Paulo,2,1,386,15,30,766,4,1,5,12/11/2017,15
6078,6078,6079,Palmeiras,0,0,387,12,Flamengo,1,0,456,18,30,843,1,0,1,12/11/2017,15
6079,6079,6080,Atletico-GO,0,0,379,20,Sport,3,0,525,15,35,904,3,0,3,12/11/2017,15
6080,6080,6081,Gremio,0,0,624,14,Vitoria,1,1,255,16,30,879,1,1,2,12/11/2017,15
6081,6081,6082,Bahia,1,0,446,12,Atletico-MG,4,0,359,13,25,805,5,0,5,12/11/2017,15
6082,6082,6083,Cruzeiro,4,0,556,13,Fluminense,2,1,445,8,21,1001,6,1,7,12/11/2017,15
6083,6083,6084,Coritiba,2,0,420,17,Ponte Preta,2,0,282,15,32,702,4,0,4,12/11/2017,15
6084,6084,6085,Chapecoense,0,0,374,10,Santos,3,0,481,16,26,855,3,0,3,13/11/2017,15
6085,6085,6086,Ponte Preta,1,0,337,12,Athletico-PR,3,0,507,10,22,844,4,0,4,15/11/2017,15
6086,6086,6087,Cruzeiro,4,0,626,10,Avai,2,0,394,9,19,1020,6,0,6,15/11/2017,15
6087,6087,6088,Gremio,1,0,431,16,Sao Paulo,3,0,679,12,28,1110,4,0,4,15/11/2017,15
6088,6088,6089,Vasco,1,0,472,12,Atletico-MG,0,0,396,17,29,868,1,0,1,15/11/2017,15
6089,6089,6090,Corinthians,1,0,503,12,Fluminense,6,0,299,26,38,802,7,0,7,15/11/2017,15
6090,6090,6091,Botafogo-RJ,1,0,537,12,Atletico-GO,3,0,308,17,29,845,4,0,4,16/11/2017,15
6091,6091,6092,Chapecoense,1,0,349,17,Vitoria,4,0,340,18,35,689,5,0,5,16/11/2017,15
6092,6092,6093,Palmeiras,0,0,487,7,Sport,2,0,360,15,22,847,2,0,2,16/11/2017,15
6093,6093,6094,Coritiba,3,0,235,20,Flamengo,5,0,499,12,32,734,8,0,8,16/11/2017,15
6094,6094,6095,Bahia,3,0,338,17,Santos,2,0,491,16,33,829,5,0,5,16/11/2017,15
6095,6095,6096,Sport,4,0,360,21,Bahia,3,0,434,16,37,794,7,0,7,19/11/2017,15
6096,6096,6097,Flamengo,4,0,428,20,Corinthians,4,0,438,16,36,866,8,0,8,19/11/2017,15
6097,6097,6098,Vitoria,3,0,303,20,Cruzeiro,2,0,575,7,27,878,5,0,5,19/11/2017,15
6098,6098,6099,Atletico-GO,4,0,509,12,Chapecoense,4,0,343,23,35,852,8,0,8,19/11/2017,15
6099,6099,6100,Sao Paulo,2,0,588,13,Botafogo-RJ,3,0,327,17,30,915,5,0,5,19/11/2017,15
6100,6100,6101,Athletico-PR,1,0,366,8,Vasco,2,0,523,8,16,889,3,0,3,19/11/2017,15
6101,6101,6102,Atletico-MG,2,0,398,10,Coritiba,5,0,413,15,25,811,7,0,7,19/11/2017,15
6102,6102,6103,Santos,2,0,414,22,Gremio,2,0,566,14,36,980,4,0,4,19/11/2017,15
6103,6103,6104,Fluminense,2,0,529,16,Ponte Preta,1,1,245,15,31,774,3,1,4,20/11/2017,15
6104,6104,6105,Avai,2,0,284,9,Palmeiras,2,0,694,10,19,978,4,0,4,20/11/2017,15
6105,6105,6106,Fluminense,4,0,470,9,Sport,2,0,407,19,28,877,6,0,6,25/11/2017,15
6106,6106,6107,Avai,3,0,274,19,Athletico-PR,1,0,459,15,34,733,4,0,4,26/11/2017,15
6107,6107,6108,Corinthians,4,0,508,15,Atletico-MG,1,0,376,10,25,884,5,0,5,26/11/2017,15
6108,6108,6109,Ponte Preta,3,1,204,11,Vitoria,6,0,444,19,30,648,9,1,10,26/11/2017,15
6109,6109,6110,Coritiba,4,0,281,16,Sao Paulo,1,0,485,12,28,766,5,0,5,26/11/2017,15
6110,6110,6111,Cruzeiro,3,0,572,16,Vasco,2,0,295,20,36,867,5,0,5,26/11/2017,15
6111,6111,6112,Gremio,2,0,524,14,Atletico-GO,3,0,506,16,30,1030,5,0,5,26/11/2017,15
6112,6112,6113,Flamengo,3,0,512,14,Santos,4,0,398,17,31,910,7,0,7,26/11/2017,15
6113,6113,6114,Bahia,4,1,431,16,Chapecoense,3,0,283,21,37,714,7,1,8,26/11/2017,15
6114,6114,6115,Palmeiras,3,0,533,19,Botafogo-RJ,4,0,315,17,36,848,7,0,7,27/11/2017,15
6115,6115,6116,Atletico-MG,7,1,492,17,Gremio,1,0,298,20,37,790,8,1,9,3/12/2017,15
6116,6116,6117,Botafogo-RJ,1,0,348,13,Cruzeiro,5,1,439,28,41,787,6,1,7,3/12/2017,15
6117,6117,6118,Santos,2,0,576,17,Avai,1,0,426,11,28,1002,3,0,3,3/12/2017,15
6118,6118,6119,Sport,3,0,429,19,Corinthians,2,0,504,18,37,933,5,0,5,3/12/2017,15
6119,6119,6120,Vitoria,2,2,366,17,Flamengo,3,0,472,13,30,838,5,2,7,3/12/2017,15
6120,6120,6121,Atletico-GO,1,0,284,16,Fluminense,4,0,462,18,34,746,5,0,5,3/12/2017,15
6121,6121,6122,Sao Paulo,4,1,450,20,Bahia,4,1,299,29,49,749,8,2,10,3/12/2017,15
6122,6122,6123,Chapecoense,3,0,313,18,Coritiba,2,0,350,11,29,663,5,0,5,3/12/2017,15
6123,6123,6124,Vasco,5,0,333,18,Ponte Preta,5,0,326,16,34,659,10,0,10,3/12/2017,15
6124,6124,6125,Athletico-PR,3,0,332,16,Palmeiras,5,0,613,14,30,945,8,0,8,3/12/2017,15
6125,6125,6126,Cruzeiro,3,0,425,20,Gremio,1,1,649,15,35,1074,4,1,5,14/4/2018,16
6126,6126,6127,Vitoria,3,0,545,24,Flamengo,2,1,286,10,34,831,5,1,6,14/4/2018,16
6127,6127,6128,Santos,0,0,532,7,Ceara,1,0,472,5,12,1004,1,0,1,14/4/2018,16
6128,6128,6129,America-MG,1,0,363,11,Sport,3,0,580,12,23,943,4,0,4,15/4/2018,16
6129,6129,6130,Vasco,4,0,596,11,Atletico-MG,3,0,321,18,29,917,7,0,7,15/4/2018,16
6130,6130,6131,Internacional,2,0,412,16,Bahia,0,0,491,18,34,903,2,0,2,15/4/2018,16
6131,6131,6132,Corinthians,0,0,515,14,Fluminense,0,0,293,15,29,808,0,0,0,15/4/2018,16
6132,6132,6133,Athletico-PR,1,0,646,10,Chapecoense,3,0,271,16,26,917,4,0,4,15/4/2018,16
6133,6133,6134,Sao Paulo,4,0,480,20,Parana,2,0,446,15,35,926,6,0,6,16/4/2018,16
6134,6134,6135,Botafogo-RJ,1,0,409,7,Palmeiras,4,0,498,23,30,907,5,0,5,16/4/2018,16
6135,6135,6136,Bahia,4,0,395,29,Santos,3,0,352,21,50,747,7,0,7,21/4/2018,16
6136,6136,6137,Flamengo,1,0,345,15,America-MG,1,0,345,17,32,690,2,0,2,21/4/2018,16
6137,6137,6138,Parana,1,0,413,16,Corinthians,1,0,467,16,32,880,2,0,2,22/4/2018,16
6138,6138,6139,Ceara,1,0,497,12,Sao Paulo,1,0,476,7,19,973,2,0,2,22/4/2018,16
6139,6139,6140,Atletico-MG,2,0,497,22,Vitoria,4,0,321,19,41,818,6,0,6,22/4/2018,16
6140,6140,6141,Fluminense,3,1,273,13,Cruzeiro,2,0,576,19,32,849,5,1,6,22/4/2018,16
6141,6141,6142,Chapecoense,1,0,306,13,Vasco,2,0,559,8,21,865,3,0,3,22/4/2018,16
6142,6142,6143,Palmeiras,2,0,390,14,Internacional,2,0,483,15,29,873,4,0,4,22/4/2018,16
6143,6143,6144,Gremio,3,0,587,9,Athletico-PR,2,1,602,15,24,1189,5,1,6,22/4/2018,16
6144,6144,6145,Sport,1,0,391,14,Botafogo-RJ,3,0,375,15,29,766,4,0,4,23/4/2018,16
6145,6145,6146,Botafogo-RJ,1,0,464,14,Gremio,1,0,388,12,26,852,2,0,2,28/4/2018,16
6146,6146,6147,Bahia,2,0,334,22,Athletico-PR,2,0,640,12,34,974,4,0,4,29/4/2018,16
6147,6147,6148,Ceara,1,0,401,18,Flamengo,2,0,431,12,30,832,3,0,3,29/4/2018,16
6148,6148,6149,Palmeiras,4,0,589,17,Chapecoense,6,0,237,17,34,826,10,0,10,29/4/2018,16
6149,6149,6150,Parana,1,0,575,14,Sport,1,0,261,15,29,836,2,0,2,29/4/2018,16
6150,6150,6151,Atletico-MG,4,0,556,25,Corinthians,3,0,413,15,40,969,7,0,7,29/4/2018,16
6151,6151,6152,Fluminense,3,0,370,17,Sao Paulo,2,0,316,16,33,686,5,0,5,29/4/2018,16
6152,6152,6153,Internacional,4,0,462,15,Cruzeiro,3,0,350,14,29,812,7,0,7,29/4/2018,16
6153,6153,6154,America-MG,1,1,305,14,Vitoria,2,0,445,12,26,750,3,1,4,30/4/2018,16
6154,6154,6156,Vasco,4,0,557,14,America-MG,4,0,282,24,38,839,8,0,8,5/5/2018,16
6155,6155,6157,Sao Paulo,4,0,317,17,Atletico-MG,4,0,535,14,31,852,8,0,8,5/5/2018,16
6156,6156,6158,Corinthians,2,0,585,12,Ceara,4,0,380,20,32,965,6,0,6,6/5/2018,16
6157,6157,6159,Flamengo,5,0,470,12,Internacional,4,1,345,15,27,815,9,1,10,6/5/2018,16
6158,6158,6160,Cruzeiro,1,0,417,19,Botafogo-RJ,4,0,395,12,31,812,5,0,5,6/5/2018,16
6159,6159,6161,Athletico-PR,1,0,619,10,Palmeiras,2,0,389,15,25,1008,3,0,3,6/5/2018,16
6160,6160,6162,Vitoria,2,0,274,18,Fluminense,1,0,517,7,25,791,3,0,3,6/5/2018,16
6161,6161,6163,Gremio,1,0,657,15,Santos,3,0,370,22,37,1027,4,0,4,6/5/2018,16
6162,6162,6164,Sport,1,0,343,18,Bahia,1,1,393,21,39,736,2,1,3,6/5/2018,16
6163,6163,6165,Chapecoense,1,0,373,10,Parana,2,1,338,16,26,711,3,1,4,7/5/2018,16
6164,6164,6166,Gremio,3,0,721,13,Internacional,4,0,212,24,37,933,7,0,7,12/5/2018,16
6165,6165,6167,Cruzeiro,2,0,481,18,Sport,3,0,389,16,34,870,5,0,5,13/5/2018,16
6166,6166,6168,Athletico-PR,2,0,607,15,Atletico-MG,2,0,358,16,31,965,4,0,4,13/5/2018,16
6167,6167,6169,Vasco,2,0,472,16,Vitoria,3,0,289,19,35,761,5,0,5,13/5/2018,16
6168,6168,6170,Corinthians,2,0,409,15,Palmeiras,3,0,366,21,36,775,5,0,5,13/5/2018,16
6169,6169,6171,Bahia,5,0,378,20,Sao Paulo,3,0,392,14,34,770,8,0,8,13/5/2018,16
6170,6170,6172,Chapecoense,2,0,327,18,Flamengo,3,0,437,17,35,764,5,0,5,13/5/2018,16
6171,6171,6173,Santos,1,0,545,12,Parana,2,0,419,14,26,964,3,0,3,13/5/2018,16
6172,6172,6174,Botafogo-RJ,2,0,328,12,Fluminense,2,0,465,12,24,793,4,0,4,14/5/2018,16
6173,6173,6175,Ceara,1,0,516,16,America-MG,3,0,287,18,34,803,4,0,4,14/5/2018,16
6174,6174,6176,Atletico-MG,3,0,588,13,Cruzeiro,1,1,260,15,28,848,4,1,5,19/5/2018,16
6175,6175,6177,Flamengo,2,2,462,16,Vasco,3,2,298,24,40,760,5,4,9,19/5/2018,16
6176,6176,6178,Palmeiras,3,0,438,17,Bahia,2,0,393,13,30,831,5,0,5,19/5/2018,16
6177,6177,6179,Vitoria,4,0,351,11,Ceara,0,0,508,17,28,859,4,0,4,20/5/2018,16
6178,6178,6180,Sao Paulo,3,1,341,13,Santos,2,0,557,6,19,898,5,1,6,20/5/2018,16
6179,6179,6181,America-MG,2,0,422,20,Botafogo-RJ,4,0,553,11,31,975,6,0,6,20/5/2018,16
6180,6180,6182,Parana,2,0,246,16,Gremio,1,0,719,18,34,965,3,0,3,20/5/2018,16
6181,6181,6183,Sport,2,0,436,18,Corinthians,3,0,562,17,35,998,5,0,5,20/5/2018,16
6182,6182,6184,Fluminense,1,0,294,13,Athletico-PR,2,0,612,18,31,906,3,0,3,20/5/2018,16
6183,6183,6185,Internacional,1,0,450,14,Chapecoense,2,0,462,15,29,912,3,0,3,21/5/2018,16
6184,6184,6186,Fluminense,1,0,387,21,Chapecoense,1,0,445,14,35,832,2,0,2,26/5/2018,16
6185,6185,6187,Palmeiras,3,0,501,17,Sport,2,1,324,10,27,825,5,1,6,26/5/2018,16
6186,6186,6188,Atletico-MG,1,0,599,15,Flamengo,4,0,306,13,28,905,5,0,5,26/5/2018,16
6187,6187,6189,Parana,3,0,296,8,Athletico-PR,1,0,673,14,22,969,4,0,4,27/5/2018,16
6188,6188,6190,Internacional,3,0,500,13,Corinthians,1,0,437,10,23,937,4,0,4,27/5/2018,16
6189,6189,6191,Bahia,1,0,460,20,Vasco,5,1,442,16,36,902,6,1,7,27/5/2018,16
6190,6190,6192,Santos,1,0,496,12,Cruzeiro,4,0,407,12,24,903,5,0,5,27/5/2018,16
6191,6191,6193,Botafogo-RJ,1,0,497,10,Vitoria,4,0,359,18,28,856,5,0,5,27/5/2018,16
6192,6192,6194,Ceara,4,0,411,15,Gremio,2,0,638,13,28,1049,6,0,6,27/5/2018,16
6193,6193,6195,America-MG,4,0,427,22,Sao Paulo,3,0,337,19,41,764,7,0,7,27/5/2018,16
6194,6194,6196,Vasco,3,1,399,24,Parana,3,1,392,18,42,791,6,2,8,30/5/2018,16
6195,6195,6197,Vitoria,3,0,333,14,Internacional,2,0,415,12,26,748,5,0,5,30/5/2018,16
6196,6196,6198,Sport,4,0,355,14,Atletico-MG,2,0,540,10,24,895,6,0,6,30/5/2018,16
6197,6197,6199,Chapecoense,2,0,342,17,Ceara,3,0,414,13,30,756,5,0,5,30/5/2018,16
6198,6198,6200,Sao Paulo,2,0,326,19,Botafogo-RJ,3,0,467,16,35,793,5,0,5,30/5/2018,16
6199,6199,6201,Gremio,1,0,632,19,Fluminense,5,0,278,13,32,910,6,0,6,30/5/2018,16
6200,6200,6202,Cruzeiro,3,0,439,26,Palmeiras,6,0,439,18,44,878,9,0,9,30/5/2018,16
6201,6201,6203,Flamengo,0,0,588,10,Bahia,2,0,440,7,17,1028,2,0,2,31/5/2018,16
6202,6202,6204,Corinthians,2,0,619,14,America-MG,2,2,409,13,27,1028,4,2,6,31/5/2018,16
6203,6203,6205,Athletico-PR,1,0,446,14,Santos,1,0,610,6,20,1056,2,0,2,31/5/2018,16
6204,6204,6206,Internacional,3,0,457,14,Sport,3,0,396,14,28,853,6,0,6,2/6/2018,16
6205,6205,6207,Atletico-MG,2,0,568,15,Chapecoense,3,1,225,19,34,793,5,1,6,2/6/2018,16
6206,6206,6208,Vasco,2,0,668,12,Botafogo-RJ,4,0,238,16,28,906,6,0,6,2/6/2018,16
6207,6207,6209,Palmeiras,4,0,303,22,Sao Paulo,4,0,326,23,45,629,8,0,8,2/6/2018,16
6208,6208,6210,Flamengo,3,0,462,14,Corinthians,1,0,417,18,32,879,4,0,4,3/6/2018,16
6209,6209,6211,Bahia,2,0,467,18,Gremio,5,0,372,16,34,839,7,0,7,3/6/2018,16
6210,6210,6212,America-MG,1,0,391,9,Athletico-PR,2,0,548,15,24,939,3,0,3,3/6/2018,16
6211,6211,6213,Santos,0,0,447,12,Vitoria,4,0,329,16,28,776,4,0,4,3/6/2018,16
6212,6212,6214,Ceara,2,0,405,13,Cruzeiro,4,0,563,15,28,968,6,0,6,3/6/2018,16
6213,6213,6215,Parana,6,0,323,14,Fluminense,3,0,487,16,30,810,9,0,9,4/6/2018,16
6214,6214,6216,Sao Paulo,4,0,397,30,Internacional,2,0,449,8,38,846,6,0,6,5/6/2018,16
6215,6215,6217,Vitoria,3,0,369,20,Chapecoense,2,0,403,15,35,772,5,0,5,6/6/2018,16
6216,6216,6218,Botafogo-RJ,0,0,463,17,Ceara,3,0,365,17,34,828,3,0,3,6/6/2018,16
6217,6217,6219,Corinthians,3,0,425,12,Santos,2,0,421,15,27,846,5,0,5,6/6/2018,16
6218,6218,6220,Sport,2,0,291,13,Athletico-PR,4,0,573,20,33,864,6,0,6,6/6/2018,16
6219,6219,6221,Gremio,2,0,449,13,Palmeiras,5,0,414,30,43,863,7,0,7,6/6/2018,16
6220,6220,6222,Cruzeiro,1,0,533,8,Vasco,1,0,297,14,22,830,2,0,2,6/6/2018,16
6221,6221,6223,Parana,4,0,412,17,Bahia,2,0,457,18,35,869,6,0,6,7/6/2018,16
6222,6222,6224,Fluminense,5,0,409,16,Flamengo,2,0,383,7,23,792,7,0,7,7/6/2018,16
6223,6223,6225,America-MG,2,0,434,13,Atletico-MG,2,0,504,7,20,938,4,0,4,7/6/2018,16
6224,6224,6226,Athletico-PR,3,0,509,15,Sao Paulo,3,0,318,18,33,827,6,0,6,9/6/2018,16
6225,6225,6227,Chapecoense,2,0,338,22,Cruzeiro,3,0,432,17,39,770,5,0,5,9/6/2018,16
6226,6226,6228,Vasco,4,0,382,27,Sport,3,0,546,10,37,928,7,0,7,9/6/2018,16
6227,6227,6229,Corinthians,2,0,499,14,Vitoria,2,0,287,19,33,786,4,0,4,9/6/2018,16
6228,6228,6230,Atletico-MG,2,0,493,15,Fluminense,2,0,479,9,24,972,4,0,4,10/6/2018,16
6229,6229,6231,Bahia,4,0,463,24,Botafogo-RJ,2,1,340,9,33,803,6,1,7,10/6/2018,16
6230,6230,6232,Gremio,2,0,586,14,America-MG,3,0,357,13,27,943,5,0,5,10/6/2018,16
6231,6231,6233,Ceara,3,0,358,15,Palmeiras,2,0,505,12,27,863,5,0,5,10/6/2018,16
6232,6232,6234,Flamengo,2,0,601,11,Parana,0,0,357,8,19,958,2,0,2,10/6/2018,16
6233,6233,6235,Santos,3,1,535,10,Internacional,4,0,348,20,30,883,7,1,8,10/6/2018,16
6234,6234,6236,Sao Paulo,3,1,454,24,Vitoria,3,1,362,17,41,816,6,2,8,12/6/2018,16
6235,6235,6237,America-MG,5,0,413,13,Chapecoense,0,0,417,15,28,830,5,0,5,13/6/2018,16
6236,6236,6238,Fluminense,2,0,501,16,Santos,3,0,528,12,28,1029,5,0,5,13/6/2018,16
6237,6237,6239,Sport,3,0,476,14,Gremio,2,0,455,16,30,931,5,0,5,13/6/2018,16
6238,6238,6240,Parana,8,0,365,23,Cruzeiro,2,0,471,23,46,836,10,0,10,13/6/2018,16
6239,6239,6241,Palmeiras,4,3,340,21,Flamengo,6,3,408,18,39,748,10,6,16,13/6/2018,16
6240,6240,6242,Botafogo-RJ,0,0,332,11,Athletico-PR,2,0,554,9,20,886,2,0,2,13/6/2018,16
6241,6241,6243,Bahia,2,0,333,19,Corinthians,1,0,510,11,30,843,3,0,3,13/6/2018,16
6242,6242,6244,Internacional,2,0,472,13,Vasco,0,0,402,11,24,874,2,0,2,13/6/2018,16
6243,6243,6245,Atletico-MG,1,0,672,10,Ceara,0,0,314,10,20,986,1,0,1,13/6/2018,16
6244,6244,6246,Ceara,0,0,291,15,Sport,0,0,575,12,27,866,0,0,0,18/7/2018,16
6245,6245,6247,Vitoria,2,0,382,24,Parana,2,0,368,22,46,750,4,0,4,18/7/2018,16
6246,6246,6248,Corinthians,2,0,424,19,Botafogo-RJ,3,0,421,13,32,845,5,0,5,18/7/2018,16
6247,6247,6249,Gremio,1,0,648,10,Atletico-MG,2,0,424,19,29,1072,3,0,3,18/7/2018,16
6248,6248,6250,Flamengo,3,0,552,11,Sao Paulo,3,1,228,17,28,780,6,1,7,18/7/2018,16
6249,6249,6251,Chapecoense,1,0,399,12,Bahia,2,0,420,19,31,819,3,0,3,19/7/2018,16
6250,6250,6252,Cruzeiro,3,0,521,11,America-MG,1,0,453,8,19,974,4,0,4,19/7/2018,16
6251,6251,6253,Vasco,4,0,425,21,Fluminense,2,0,362,21,42,787,6,0,6,19/7/2018,16
6252,6252,6254,Santos,4,0,410,15,Palmeiras,6,0,429,16,31,839,10,0,10,19/7/2018,16
6253,6253,6255,Athletico-PR,3,1,436,11,Internacional,5,0,388,16,27,824,8,1,9,19/7/2018,16
6254,6254,6256,Flamengo,0,0,497,17,Botafogo-RJ,1,1,357,15,32,854,1,1,2,21/7/2018,16
6255,6255,6257,Sao Paulo,2,0,315,9,Corinthians,7,0,377,21,30,692,9,0,9,21/7/2018,16
6256,6256,6258,Vasco,4,1,269,12,Gremio,6,0,521,17,29,790,10,1,11,22/7/2018,16
6257,6257,6259,Palmeiras,2,0,405,20,Atletico-MG,2,1,506,18,38,911,4,1,5,22/7/2018,16
6258,6258,6260,Parana,3,0,337,23,America-MG,3,0,543,10,33,880,6,0,6,22/7/2018,16
6259,6259,6261,Bahia,3,0,402,18,Vitoria,4,1,330,26,44,732,7,1,8,22/7/2018,16
6260,6260,6262,Sport,1,0,430,14,Fluminense,5,0,353,17,31,783,6,0,6,22/7/2018,16
6261,6261,6263,Cruzeiro,1,0,548,7,Athletico-PR,3,1,377,14,21,925,4,1,5,22/7/2018,16
6262,6262,6264,Chapecoense,1,0,391,10,Santos,4,0,400,13,23,791,5,0,5,22/7/2018,16
6263,6263,6265,Internacional,2,0,601,12,Ceara,3,0,418,13,25,1019,5,0,5,23/7/2018,16
6264,6264,6266,Fluminense,2,0,301,18,Palmeiras,2,1,491,16,34,792,4,1,5,25/7/2018,16
6265,6265,6267,Atletico-MG,1,1,557,16,Parana,1,0,392,15,31,949,2,1,3,25/7/2018,16
6266,6266,6268,Corinthians,0,0,494,9,Cruzeiro,2,0,570,10,19,1064,2,0,2,25/7/2018,16
6267,6267,6269,Santos,1,0,391,17,Flamengo,1,0,503,14,31,894,2,0,2,25/7/2018,16
6268,6268,6270,Botafogo-RJ,2,0,315,20,Chapecoense,3,0,420,16,36,735,5,0,5,26/7/2018,16
6269,6269,6271,Vitoria,2,0,439,17,Sport,2,0,436,14,31,875,4,0,4,26/7/2018,16
6270,6270,6272,Gremio,4,0,566,23,Sao Paulo,5,0,302,19,42,868,9,0,9,26/7/2018,16
6271,6271,6273,America-MG,2,1,426,12,Internacional,2,1,525,9,21,951,4,2,6,26/7/2018,16
6272,6272,6276,Ceara,5,0,262,22,Fluminense,1,0,472,13,35,734,6,0,6,28/7/2018,16
6273,6273,6277,Palmeiras,2,0,450,20,Parana,2,0,419,17,37,869,4,0,4,29/7/2018,16
6274,6274,6278,Vasco,4,0,490,17,Corinthians,0,0,472,11,28,962,4,0,4,29/7/2018,16
6275,6275,6279,Flamengo,1,0,547,12,Sport,1,0,420,11,23,967,2,0,2,29/7/2018,16
6276,6276,6280,Athletico-PR,3,0,398,20,Vitoria,5,0,421,17,37,819,8,0,8,29/7/2018,16
6277,6277,6281,Internacional,1,0,442,13,Botafogo-RJ,2,0,388,14,27,830,3,0,3,29/7/2018,16
6278,6278,6282,Cruzeiro,2,0,509,11,Sao Paulo,1,0,387,11,22,896,3,0,3,29/7/2018,16
6279,6279,6283,Santos,2,0,614,8,America-MG,2,0,234,13,21,848,4,0,4,29/7/2018,16
6280,6280,6284,Chapecoense,1,0,443,12,Gremio,3,0,340,15,27,783,4,0,4,29/7/2018,16
6281,6281,6285,Bahia,4,0,510,15,Atletico-MG,2,0,405,18,33,915,6,0,6,30/7/2018,16
6282,6282,6286,Botafogo-RJ,1,0,381,12,Santos,5,0,460,19,31,841,6,0,6,4/8/2018,16
6283,6283,6287,Gremio,3,0,311,21,Flamengo,4,0,607,17,38,918,7,0,7,4/8/2018,16
6284,6284,6288,Corinthians,2,0,537,8,Athletico-PR,2,0,387,13,21,924,4,0,4,4/8/2018,16
6285,6285,6289,Vitoria,3,0,388,19,Cruzeiro,5,0,407,20,39,795,8,0,8,5/8/2018,16
6286,6286,6290,Parana,4,0,557,15,Ceara,2,0,284,21,36,841,6,0,6,5/8/2018,16
6287,6287,6291,America-MG,1,0,516,16,Palmeiras,2,0,489,18,34,1005,3,0,3,5/8/2018,16
6288,6288,6292,Sao Paulo,2,0,327,27,Vasco,2,0,493,9,36,820,4,0,4,5/8/2018,16
6289,6289,6293,Fluminense,4,0,348,12,Bahia,2,0,392,18,30,740,6,0,6,5/8/2018,16
6290,6290,6294,Sport,1,0,555,14,Chapecoense,1,0,341,20,34,896,2,0,2,5/8/2018,16
6291,6291,6295,Atletico-MG,1,0,562,13,Internacional,1,0,329,13,26,891,2,0,2,6/8/2018,16
6292,6292,6296,Ceara,3,0,373,11,Santos,2,0,385,13,24,758,5,0,5,8/8/2018,16
6293,6293,6306,Ceara,3,0,377,15,Athletico-PR,3,0,443,14,29,820,6,0,6,11/8/2018,16
6294,6294,6307,Bahia,1,0,438,11,America-MG,4,0,482,13,24,920,5,0,5,11/8/2018,16
6295,6295,6308,Parana,3,1,423,11,Botafogo-RJ,4,1,393,9,20,816,7,2,9,12/8/2018,16
6296,6296,6309,Atletico-MG,2,0,375,17,Santos,0,0,407,8,25,782,2,0,2,12/8/2018,16
6297,6297,6310,Sport,1,0,398,7,Sao Paulo,3,0,491,15,22,889,4,0,4,12/8/2018,16
6298,6298,6311,Flamengo,3,0,420,28,Cruzeiro,3,0,402,17,45,822,6,0,6,12/8/2018,16
6299,6299,6312,Chapecoense,1,1,310,18,Corinthians,2,0,460,20,38,770,3,1,4,12/8/2018,16
6300,6300,6313,Gremio,1,0,559,20,Vitoria,3,0,481,17,37,1040,4,0,4,12/8/2018,16
6301,6301,6314,Palmeiras,1,0,453,17,Vasco,2,0,357,16,33,810,3,0,3,12/8/2018,16
6302,6302,6315,Fluminense,3,0,545,8,Internacional,3,0,376,17,25,921,6,0,6,13/8/2018,16
6303,6303,6316,Santos,3,0,463,20,Sport,2,1,409,21,41,872,5,1,6,18/8/2018,16
6304,6304,6317,Corinthians,1,0,649,8,Gremio,1,0,466,8,16,1115,2,0,2,18/8/2018,16
6305,6305,6318,Athletico-PR,3,0,263,15,Flamengo,1,0,553,10,25,816,4,0,4,19/8/2018,16
6306,6306,6319,Internacional,3,0,547,16,Parana,5,0,190,16,32,737,8,0,8,19/8/2018,16
6307,6307,6320,Vitoria,2,0,471,25,Palmeiras,1,0,416,18,43,887,3,0,3,19/8/2018,16
6308,6308,6321,Botafogo-RJ,2,0,411,13,Atletico-MG,4,0,494,12,25,905,6,0,6,19/8/2018,16
6309,6309,6322,Cruzeiro,2,0,535,14,Bahia,2,0,457,13,27,992,4,0,4,19/8/2018,16
6310,6310,6323,America-MG,2,1,517,13,Fluminense,0,0,459,8,21,976,2,1,3,19/8/2018,16
6311,6311,6324,Sao Paulo,2,0,358,17,Chapecoense,1,0,561,20,37,919,3,0,3,19/8/2018,16
6312,6312,6325,Vasco,1,0,464,16,Ceara,0,1,335,21,37,799,1,1,2,20/8/2018,16
6313,6313,6297,Bahia,1,0,517,15,Internacional,2,0,343,18,33,860,3,0,3,22/8/2018,16
6314,6314,6298,Parana,3,0,349,14,Sao Paulo,1,0,413,12,26,762,4,0,4,22/8/2018,16
6315,6315,6299,Palmeiras,2,0,506,14,Botafogo-RJ,4,1,230,17,31,736,6,1,7,22/8/2018,16
6316,6316,6300,Sport,2,0,459,9,America-MG,2,0,422,21,30,881,4,0,4,22/8/2018,16
6317,6317,6301,Fluminense,1,0,452,12,Corinthians,2,1,550,8,20,1002,3,1,4,22/8/2018,16
6318,6318,6302,Gremio,2,0,752,13,Cruzeiro,4,0,378,16,29,1130,6,0,6,22/8/2018,16
6319,6319,6303,Flamengo,2,0,555,18,Vitoria,2,0,313,19,37,868,4,0,4,23/8/2018,16
6320,6320,6304,Atletico-MG,2,0,718,16,Vasco,4,0,256,15,31,974,6,0,6,23/8/2018,16
6321,6321,6326,Santos,1,0,357,25,Bahia,2,0,385,17,42,742,3,0,3,25/8/2018,16
6322,6322,6327,Corinthians,3,0,458,18,Parana,3,1,281,20,38,739,6,1,7,25/8/2018,16
6323,6323,6328,Athletico-PR,2,0,493,18,Gremio,2,0,398,17,35,891,4,0,4,25/8/2018,16
6324,6324,6329,Cruzeiro,4,0,422,17,Fluminense,3,0,488,14,31,910,7,0,7,25/8/2018,16
6325,6325,6330,Botafogo-RJ,2,0,314,21,Sport,2,0,420,13,34,734,4,0,4,25/8/2018,16
6326,6326,6331,Sao Paulo,3,0,448,13,Ceara,6,1,325,21,34,773,9,1,10,26/8/2018,16
6327,6327,6332,America-MG,3,0,469,12,Flamengo,2,1,443,9,21,912,5,1,6,26/8/2018,16
6328,6328,6333,Internacional,2,0,495,14,Palmeiras,3,0,387,24,38,882,5,0,5,26/8/2018,16
6329,6329,6334,Vitoria,2,0,329,17,Atletico-MG,3,0,582,12,29,911,5,0,5,26/8/2018,16
6330,6330,6335,Vasco,3,0,428,18,Chapecoense,2,0,445,20,38,873,5,0,5,26/8/2018,16
6331,6331,6274,Ceara,3,0,484,16,Bahia,4,0,236,25,41,720,7,0,7,29/8/2018,16
6332,6332,6275,Athletico-PR,1,0,475,15,Vasco,2,0,399,14,29,874,3,0,3,29/8/2018,16
6333,6333,6336,Vitoria,5,0,533,21,America-MG,1,1,394,10,31,927,6,1,7,1/9/2018,16
6334,6334,6337,Gremio,2,0,476,12,Botafogo-RJ,3,0,352,19,31,828,5,0,5,1/9/2018,16
6335,6335,6338,Vasco,1,0,571,12,Santos,1,0,412,11,23,983,2,0,2,1/9/2018,16
6336,6336,6339,Corinthians,1,0,522,16,Atletico-MG,3,0,416,21,37,938,4,0,4,1/9/2018,16
6337,6337,6340,Flamengo,2,0,515,16,Ceara,2,0,285,14,30,800,4,0,4,2/9/2018,16
6338,6338,6341,Athletico-PR,2,0,534,14,Bahia,2,0,357,9,23,891,4,0,4,2/9/2018,16
6339,6339,6342,Sport,3,0,369,19,Parana,2,0,371,12,31,740,5,0,5,2/9/2018,16
6340,6340,6343,Sao Paulo,2,1,297,14,Fluminense,2,0,540,16,30,837,4,1,5,2/9/2018,16
6341,6341,6344,Cruzeiro,3,0,457,16,Internacional,2,0,445,14,30,902,5,0,5,2/9/2018,16
6342,6342,6345,Chapecoense,4,0,360,14,Palmeiras,4,0,297,23,37,657,8,0,8,2/9/2018,16
6343,6343,6346,Bahia,1,0,409,19,Sport,1,0,436,19,38,845,2,0,2,5/9/2018,16
6344,6344,6347,Botafogo-RJ,3,0,352,13,Cruzeiro,3,0,509,17,30,861,6,0,6,5/9/2018,16
6345,6345,6348,Ceara,6,0,263,19,Corinthians,2,0,611,19,38,874,8,0,8,5/9/2018,16
6346,6346,6349,Palmeiras,2,0,371,16,Athletico-PR,3,0,424,18,34,795,5,0,5,5/9/2018,16
6347,6347,6350,Parana,2,0,277,24,Chapecoense,2,0,498,19,43,775,4,0,4,5/9/2018,16
6348,6348,6351,Atletico-MG,3,0,346,17,Sao Paulo,1,0,394,18,35,740,4,0,4,5/9/2018,16
6349,6349,6352,Internacional,4,0,371,13,Flamengo,1,0,602,13,26,973,5,0,5,5/9/2018,16
6350,6350,6353,Santos,2,0,578,14,Gremio,1,0,568,8,22,1146,3,0,3,6/9/2018,16
6351,6351,6354,Fluminense,1,0,527,11,Vitoria,1,0,312,8,19,839,2,0,2,6/9/2018,16
6352,6352,6355,America-MG,1,0,450,19,Vasco,1,0,555,12,31,1005,2,0,2,6/9/2018,16
6353,6353,6356,Sport,3,0,423,22,Cruzeiro,1,0,369,19,41,792,4,0,4,8/9/2018,16
6354,6354,6357,Sao Paulo,3,0,392,16,Bahia,2,0,353,19,35,745,5,0,5,8/9/2018,16
6355,6355,6358,Flamengo,2,0,492,17,Chapecoense,2,0,304,13,30,796,4,0,4,8/9/2018,16
6356,6356,6359,America-MG,1,0,615,16,Ceara,1,0,423,10,26,1038,2,0,2,9/9/2018,16
6357,6357,6360,Palmeiras,2,0,397,14,Corinthians,3,0,348,16,30,745,5,0,5,9/9/2018,16
6358,6358,6361,Fluminense,3,0,315,21,Botafogo-RJ,4,0,457,14,35,772,7,0,7,9/9/2018,16
6359,6359,6362,Internacional,5,0,347,17,Gremio,5,0,471,15,32,818,10,0,10,9/9/2018,16
6360,6360,6363,Parana,4,0,296,15,Santos,3,0,530,18,33,826,7,0,7,9/9/2018,16
6361,6361,6364,Vitoria,4,1,432,19,Vasco,1,1,395,19,38,827,5,2,7,9/9/2018,16
6362,6362,6365,Atletico-MG,4,0,434,13,Athletico-PR,5,1,385,14,27,819,9,1,10,10/9/2018,16
6363,6363,6305,Chapecoense,1,0,321,19,Athletico-PR,3,0,349,18,37,670,4,0,4,13/9/2018,16
6364,6364,6366,Ceara,2,0,404,23,Vitoria,4,0,551,21,44,955,6,0,6,15/9/2018,16
6365,6365,6367,Gremio,1,0,553,11,Parana,1,0,334,13,24,887,2,0,2,15/9/2018,16
6366,6366,6368,Vasco,3,0,302,19,Flamengo,2,1,488,13,32,790,5,1,6,15/9/2018,16
6367,6367,6369,Botafogo-RJ,1,1,419,13,America-MG,1,1,464,18,31,883,2,2,4,16/9/2018,16
6368,6368,6370,Cruzeiro,3,0,362,19,Atletico-MG,1,0,551,16,35,913,4,0,4,16/9/2018,16
6369,6369,6371,Bahia,1,0,384,14,Palmeiras,2,0,555,11,25,939,3,0,3,16/9/2018,16
6370,6370,6372,Athletico-PR,3,0,456,15,Fluminense,2,0,474,14,29,930,5,0,5,16/9/2018,16
6371,6371,6373,Santos,7,0,425,15,Sao Paulo,4,0,354,15,30,779,11,0,11,16/9/2018,16
6372,6372,6374,Corinthians,2,0,634,16,Sport,1,0,273,19,35,907,3,0,3,16/9/2018,16
6373,6373,6375,Chapecoense,4,0,323,14,Internacional,2,1,318,15,29,641,6,1,7,17/9/2018,16
6374,6374,6376,Sao Paulo,1,0,452,14,America-MG,1,0,476,12,26,928,2,0,2,22/9/2018,16
6375,6375,6377,Gremio,3,0,550,12,Ceara,1,0,380,9,21,930,4,0,4,23/9/2018,16
6376,6376,6378,Athletico-PR,0,0,502,15,Parana,4,0,374,11,26,876,4,0,4,23/9/2018,16
6377,6377,6379,Flamengo,2,0,438,26,Atletico-MG,2,0,421,15,41,859,4,0,4,23/9/2018,16
6378,6378,6380,Corinthians,0,0,580,13,Internacional,2,0,469,11,24,1049,2,0,2,23/9/2018,16
6379,6379,6381,Sport,2,0,396,16,Palmeiras,2,0,367,16,32,763,4,0,4,23/9/2018,16
6380,6380,6382,Vitoria,1,0,519,15,Botafogo-RJ,4,0,352,17,32,871,5,0,5,23/9/2018,16
6381,6381,6383,Cruzeiro,2,0,428,17,Santos,2,0,508,12,29,936,4,0,4,23/9/2018,16
6382,6382,6384,Chapecoense,2,1,394,19,Fluminense,3,0,316,19,38,710,5,1,6,24/9/2018,16
6383,6383,6385,Vasco,5,0,480,12,Bahia,2,1,292,15,27,772,7,1,8,24/9/2018,16
6384,6384,6155,Santos,1,0,444,11,Vasco,2,1,397,17,28,841,3,1,4,27/9/2018,16
6385,6385,6386,Fluminense,1,0,532,10,Gremio,2,0,540,13,23,1072,3,0,3,29/9/2018,16
6386,6386,6387,America-MG,0,0,453,8,Corinthians,1,0,707,4,12,1160,1,0,1,29/9/2018,16
6387,6387,6388,Bahia,2,0,257,16,Flamengo,1,0,562,17,33,819,3,0,3,29/9/2018,16
6388,6388,6389,Palmeiras,5,0,334,15,Cruzeiro,6,0,433,19,34,767,11,0,11,30/9/2018,16
6389,6389,6390,Atletico-MG,1,0,563,18,Sport,3,1,326,16,34,889,4,1,5,30/9/2018,16
6390,6390,6391,Santos,2,0,512,8,Athletico-PR,6,0,317,17,25,829,8,0,8,30/9/2018,16
6391,6391,6392,Botafogo-RJ,1,0,276,20,Sao Paulo,2,0,423,18,38,699,3,0,3,30/9/2018,16
6392,6392,6393,Internacional,3,0,483,19,Vitoria,6,1,314,18,37,797,9,1,10,30/9/2018,16
6393,6393,6394,Ceara,4,0,335,15,Chapecoense,5,0,421,20,35,756,9,0,9,30/9/2018,16
6394,6394,6395,Parana,1,0,317,15,Vasco,0,1,480,11,26,797,1,1,2,1/10/2018,16
6395,6395,6396,Sport,4,0,382,10,Internacional,1,0,534,10,20,916,5,0,5,5/10/2018,16
6396,6396,6397,Corinthians,2,0,504,9,Flamengo,1,0,432,18,27,936,3,0,3,5/10/2018,16
6397,6397,6398,Vitoria,3,1,447,17,Santos,2,0,327,24,41,774,5,1,6,5/10/2018,16
6398,6398,6399,Athletico-PR,3,0,678,10,America-MG,3,0,397,13,23,1075,6,0,6,6/10/2018,16
6399,6399,6400,Chapecoense,3,0,279,20,Atletico-MG,3,0,497,15,35,776,6,0,6,6/10/2018,16
6400,6400,6401,Sao Paulo,2,0,458,21,Palmeiras,3,0,312,17,38,770,5,0,5,6/10/2018,16
6401,6401,6402,Gremio,2,0,603,13,Bahia,3,1,203,25,38,806,5,1,6,6/10/2018,16
6402,6402,6403,Fluminense,1,0,618,8,Parana,2,0,269,18,26,887,3,0,3,8/10/2018,16
6403,6403,6404,Botafogo-RJ,3,0,444,13,Vasco,2,0,428,13,26,872,5,0,5,9/10/2018,16
6404,6404,6406,Flamengo,2,0,404,16,Fluminense,3,0,389,15,31,793,5,0,5,13/10/2018,16
6405,6405,6407,Santos,3,0,359,19,Corinthians,3,0,466,19,38,825,6,0,6,13/10/2018,16
6406,6406,6408,Bahia,3,0,542,5,Parana,3,0,276,10,15,818,6,0,6,13/10/2018,16
6407,6407,6409,Chapecoense,3,0,409,14,Vitoria,2,0,314,20,34,723,5,0,5,14/10/2018,16
6408,6408,6410,Vasco,6,0,511,14,Cruzeiro,2,1,410,17,31,921,8,1,9,14/10/2018,16
6409,6409,6411,Internacional,0,0,386,16,Sao Paulo,3,1,289,23,39,675,3,1,4,14/10/2018,16
6410,6410,6412,Palmeiras,4,0,326,16,Gremio,2,0,648,16,32,974,6,0,6,14/10/2018,16
6411,6411,6413,Atletico-MG,1,0,510,16,America-MG,0,0,362,15,31,872,1,0,1,14/10/2018,16
6412,6412,6414,Athletico-PR,0,0,566,13,Sport,3,0,256,12,25,822,3,0,3,14/10/2018,16
6413,6413,6415,Ceara,1,0,474,13,Botafogo-RJ,3,0,377,10,23,851,4,0,4,15/10/2018,16
6414,6414,6416,America-MG,0,0,486,17,Gremio,0,0,462,8,25,948,0,0,0,20/10/2018,16
6415,6415,6417,Botafogo-RJ,2,0,492,10,Bahia,1,0,274,21,31,766,3,0,3,20/10/2018,16
6416,6416,6418,Sao Paulo,3,0,252,20,Athletico-PR,2,0,559,15,35,811,5,0,5,20/10/2018,16
6417,6417,6419,Sport,0,0,447,16,Vasco,3,0,468,18,34,915,3,0,3,20/10/2018,16
6418,6418,6420,Vitoria,1,0,375,18,Corinthians,4,0,502,23,41,877,5,0,5,21/10/2018,16
6419,6419,6421,Fluminense,2,1,500,14,Atletico-MG,2,0,417,19,33,917,4,1,5,21/10/2018,16
6420,6420,6422,Palmeiras,5,1,300,14,Ceara,2,0,448,13,27,748,7,1,8,21/10/2018,16
6421,6421,6423,Cruzeiro,2,0,516,9,Chapecoense,1,0,424,15,24,940,3,0,3,21/10/2018,16
6422,6422,6424,Parana,1,1,317,17,Flamengo,0,0,699,13,30,1016,1,1,2,21/10/2018,16
6423,6423,6425,Internacional,1,0,387,14,Santos,3,0,418,15,29,805,4,0,4,22/10/2018,16
6424,6424,6405,Cruzeiro,1,0,552,7,Ceara,3,0,346,18,25,898,4,0,4,24/10/2018,16
6425,6425,6426,Vitoria,1,0,483,8,Sao Paulo,2,1,315,24,32,798,3,1,4,26/10/2018,16
6426,6426,6427,Vasco,3,0,372,17,Internacional,5,1,391,20,37,763,8,1,9,26/10/2018,16
6427,6427,6428,Santos,2,0,531,15,Fluminense,3,0,240,17,32,771,5,0,5,27/10/2018,16
6428,6428,6429,Gremio,2,0,617,10,Sport,2,0,293,16,26,910,4,0,4,27/10/2018,16
6429,6429,6430,Corinthians,3,0,429,11,Bahia,3,0,363,15,26,792,6,0,6,27/10/2018,16
6430,6430,6431,Chapecoense,3,0,317,12,America-MG,4,0,486,24,36,803,7,0,7,27/10/2018,16
6431,6431,6432,Flamengo,2,0,496,19,Palmeiras,5,0,210,17,36,706,7,0,7,27/10/2018,16
6432,6432,6433,Cruzeiro,0,0,600,13,Parana,2,0,400,18,31,1000,2,0,2,27/10/2018,16
6433,6433,6434,Athletico-PR,2,0,565,19,Botafogo-RJ,5,0,242,30,49,807,7,0,7,27/10/2018,16
6434,6434,6435,Ceara,2,0,288,13,Atletico-MG,4,0,494,21,34,782,6,0,6,29/10/2018,16
6435,6435,6436,Fluminense,2,1,534,14,Vasco,3,0,273,12,26,807,5,1,6,3/11/2018,16
6436,6436,6437,Atletico-MG,4,0,484,12,Gremio,1,0,398,12,24,882,5,0,5,3/11/2018,16
6437,6437,6438,Palmeiras,3,0,309,26,Santos,4,1,473,23,49,782,7,1,8,3/11/2018,16
6438,6438,6439,America-MG,3,0,506,18,Cruzeiro,1,0,439,8,26,945,4,0,4,4/11/2018,16
6439,6439,6440,Parana,3,0,316,19,Vitoria,4,1,368,19,38,684,7,1,8,4/11/2018,16
6440,6440,6441,Sao Paulo,2,0,290,17,Flamengo,1,0,470,13,30,760,3,0,3,4/11/2018,16
6441,6441,6442,Botafogo-RJ,1,0,288,25,Corinthians,2,0,439,19,44,727,3,0,3,4/11/2018,16
6442,6442,6443,Internacional,2,0,512,9,Athletico-PR,3,0,318,20,29,830,5,0,5,4/11/2018,16
6443,6443,6444,Bahia,1,0,410,15,Chapecoense,1,0,279,22,37,689,2,0,2,4/11/2018,16
6444,6444,6445,Sport,3,0,427,13,Ceara,3,0,419,16,29,846,6,0,6,5/11/2018,16
6445,6445,6446,America-MG,2,1,508,10,Parana,1,1,277,10,20,785,3,2,5,10/11/2018,16
6446,6446,6447,Corinthians,0,1,346,10,Sao Paulo,3,0,397,18,28,743,3,1,4,10/11/2018,16
6447,6447,6448,Botafogo-RJ,4,0,258,30,Flamengo,6,0,501,16,46,759,10,0,10,10/11/2018,16
6448,6448,6449,Athletico-PR,4,0,445,17,Cruzeiro,7,0,550,14,31,995,11,0,11,10/11/2018,16
6449,6449,6450,Vitoria,3,0,332,18,Bahia,4,0,326,25,43,658,7,0,7,11/11/2018,16
6450,6450,6451,Ceara,2,0,330,11,Internacional,5,0,515,15,26,845,7,0,7,11/11/2018,16
6451,6451,6452,Atletico-MG,3,0,430,22,Palmeiras,2,0,346,14,36,776,5,0,5,11/11/2018,16
6452,6452,6453,Gremio,2,0,611,12,Vasco,4,0,256,17,29,867,6,0,6,11/11/2018,16
6453,6453,6454,Fluminense,0,0,542,18,Sport,2,0,345,16,34,887,2,0,2,11/11/2018,16
6454,6454,6455,Santos,2,0,447,15,Chapecoense,1,0,262,24,39,709,3,0,3,12/11/2018,16
6455,6455,6456,Vasco,1,0,396,13,Athletico-PR,0,0,461,9,22,857,1,0,1,14/11/2018,16
6456,6456,6457,Bahia,2,0,539,11,Ceara,3,0,341,15,26,880,5,0,5,14/11/2018,16
6457,6457,6458,Parana,3,2,212,19,Atletico-MG,3,0,672,14,33,884,6,2,8,14/11/2018,16
6458,6458,6459,Sport,4,0,392,21,Vitoria,4,0,312,17,38,704,8,0,8,14/11/2018,16
6459,6459,6460,Palmeiras,6,0,318,20,Fluminense,4,1,354,24,44,672,10,1,11,14/11/2018,16
6460,6460,6461,Cruzeiro,2,0,458,13,Corinthians,1,1,513,6,19,971,3,1,4,14/11/2018,16
6461,6461,6462,Chapecoense,1,0,349,12,Botafogo-RJ,2,0,364,14,26,713,3,0,3,15/11/2018,16
6462,6462,6463,Flamengo,3,0,440,22,Santos,5,0,359,18,40,799,8,0,8,15/11/2018,16
6463,6463,6464,Sao Paulo,1,0,489,14,Gremio,2,0,359,13,27,848,3,0,3,15/11/2018,16
6464,6464,6465,Internacional,1,0,409,19,America-MG,2,0,458,20,39,867,3,0,3,15/11/2018,16
6465,6465,6466,Corinthians,2,0,339,22,Vasco,2,0,442,14,36,781,4,0,4,17/11/2018,16
6466,6466,6467,Vitoria,2,1,427,15,Athletico-PR,3,0,410,23,38,837,5,1,6,17/11/2018,16
6467,6467,6468,Atletico-MG,2,1,376,16,Bahia,3,0,386,24,40,762,5,1,6,17/11/2018,16
6468,6468,6469,Parana,4,0,266,22,Palmeiras,2,0,493,8,30,759,6,0,6,18/11/2018,16
6469,6469,6470,America-MG,6,0,420,20,Santos,1,0,444,14,34,864,7,0,7,18/11/2018,16
6470,6470,6471,Sport,1,0,438,9,Flamengo,0,1,321,13,22,759,1,1,2,18/11/2018,16
6471,6471,6472,Botafogo-RJ,2,0,333,13,Internacional,3,2,472,18,31,805,5,2,7,18/11/2018,16
6472,6472,6473,Sao Paulo,2,0,441,14,Cruzeiro,2,0,427,17,31,868,4,0,4,18/11/2018,16
6473,6473,6474,Gremio,2,0,544,12,Chapecoense,2,0,285,21,33,829,4,0,4,18/11/2018,16
6474,6474,6475,Fluminense,4,0,415,16,Ceara,3,0,293,24,40,708,7,0,7,19/11/2018,16
6475,6475,6476,Internacional,1,0,485,10,Atletico-MG,2,0,422,17,27,907,3,0,3,21/11/2018,16
6476,6476,6477,Santos,2,0,437,19,Botafogo-RJ,2,0,419,16,35,856,4,0,4,21/11/2018,16
6477,6477,6478,Athletico-PR,2,0,428,18,Corinthians,4,0,444,14,32,872,6,0,6,21/11/2018,16
6478,6478,6479,Palmeiras,0,0,339,13,America-MG,6,0,370,20,33,709,6,0,6,21/11/2018,16
6479,6479,6480,Flamengo,2,0,387,17,Gremio,3,0,527,14,31,914,5,0,5,21/11/2018,16
6480,6480,6481,Cruzeiro,2,0,470,18,Vitoria,1,0,409,15,33,879,3,0,3,21/11/2018,16
6481,6481,6482,Vasco,2,0,246,19,Sao Paulo,4,0,445,22,41,691,6,0,6,22/11/2018,16
6482,6482,6483,Ceara,2,0,450,17,Parana,1,0,302,12,29,752,3,0,3,22/11/2018,16
6483,6483,6484,Bahia,2,0,478,23,Fluminense,1,0,390,9,32,868,3,0,3,22/11/2018,16
6484,6484,6485,Chapecoense,2,0,283,22,Sport,1,0,502,13,35,785,3,0,3,22/11/2018,16
6485,6485,6486,Santos,4,1,354,19,Atletico-MG,1,0,508,15,34,862,5,1,6,24/11/2018,16
6486,6486,6487,Athletico-PR,3,0,530,19,Ceara,4,0,285,18,37,815,7,0,7,25/11/2018,16
6487,6487,6488,Cruzeiro,6,0,540,10,Flamengo,3,0,429,9,19,969,9,0,9,25/11/2018,16
6488,6488,6489,Vitoria,2,0,347,15,Gremio,4,0,544,20,35,891,6,0,6,25/11/2018,16
6489,6489,6490,Vasco,4,1,394,17,Palmeiras,5,0,387,18,35,781,9,1,10,25/11/2018,16
6490,6490,6491,Internacional,3,0,477,12,Fluminense,1,1,291,17,29,768,4,1,5,25/11/2018,16
6491,6491,6492,America-MG,2,0,382,19,Bahia,1,1,407,21,40,789,3,1,4,25/11/2018,16
6492,6492,6493,Corinthians,2,0,581,13,Chapecoense,1,0,276,13,26,857,3,0,3,25/11/2018,16
6493,6493,6494,Botafogo-RJ,1,0,475,13,Parana,3,0,359,16,29,834,4,0,4,26/11/2018,16
6494,6494,6495,Sao Paulo,2,0,514,14,Sport,3,1,237,21,35,751,5,1,6,26/11/2018,16
6495,6495,6496,Flamengo,3,1,445,17,Athletico-PR,1,1,386,17,34,831,4,2,6,1/12/2018,16
6496,6496,6497,Atletico-MG,4,0,379,15,Botafogo-RJ,3,0,397,17,32,776,7,0,7,1/12/2018,16
6497,6497,6498,Ceara,2,1,485,17,Vasco,2,0,390,11,28,875,4,1,5,2/12/2018,16
6498,6498,6499,Gremio,2,0,560,11,Corinthians,4,0,507,15,26,1067,6,0,6,2/12/2018,16
6499,6499,6500,Bahia,4,0,341,18,Cruzeiro,1,0,394,15,33,735,5,0,5,2/12/2018,16
6500,6500,6501,Sport,3,0,420,21,Santos,1,0,443,21,42,863,4,0,4,2/12/2018,16
6501,6501,6502,Parana,1,1,339,14,Internacional,2,0,458,15,29,797,3,1,4,2/12/2018,16
6502,6502,6503,Fluminense,5,0,300,15,America-MG,2,0,400,19,34,700,7,0,7,2/12/2018,16
6503,6503,6504,Chapecoense,0,0,354,11,Sao Paulo,3,0,432,23,34,786,3,0,3,2/12/2018,16
6504,6504,6505,Palmeiras,2,0,457,11,Vitoria,2,0,334,6,17,791,4,0,4,2/12/2018,16
6505,6505,6506,Sao Paulo,0,0,269,23,Botafogo-RJ,4,0,702,7,30,971,4,0,4,27/4/2019,17
6506,6506,6507,Atletico-MG,0,0,549,12,Avai,1,0,362,18,30,911,1,0,1,27/4/2019,17
6507,6507,6508,Chapecoense,1,0,392,15,Internacional,1,0,511,11,26,903,2,0,2,27/4/2019,17
6508,6508,6509,Flamengo,4,0,526,13,Cruzeiro,4,1,396,17,30,922,8,1,9,27/4/2019,17
6509,6509,6510,Gremio,3,0,607,12,Santos,4,1,335,18,30,942,7,1,8,28/4/2019,17
6510,6510,6511,Bahia,1,0,351,17,Corinthians,4,0,474,5,22,825,5,0,5,28/4/2019,17
6511,6511,6512,Athletico-PR,1,0,510,15,Vasco,1,0,389,19,34,899,2,0,2,28/4/2019,17
6512,6512,6513,Ceara,0,0,497,15,CSA,0,1,416,4,19,913,0,1,1,28/4/2019,17
6513,6513,6514,Palmeiras,1,0,379,12,Fortaleza,2,0,349,16,28,728,3,0,3,28/4/2019,17
6514,6514,6515,Fluminense,4,0,598,14,Goias,1,0,235,9,23,833,5,0,5,28/4/2019,17
6515,6515,6516,Internacional,3,0,431,8,Flamengo,2,0,513,9,17,944,5,0,5,1/5/2019,17
6516,6516,6517,CSA,0,0,0,0,Palmeiras,0,0,0,0,0,0,0,0,0,1/5/2019,17
6517,6517,6518,Corinthians,2,0,424,14,Chapecoense,1,0,403,10,24,827,3,0,3,1/5/2019,17
6518,6518,6519,Cruzeiro,1,0,614,10,Ceara,0,0,426,12,22,1040,1,0,1,1/5/2019,17
6519,6519,6520,Avai,4,0,375,15,Gremio,3,0,504,17,32,879,7,0,7,1/5/2019,17
6520,6520,6521,Goias,3,0,380,15,Sao Paulo,2,1,433,12,27,813,5,1,6,1/5/2019,17
6521,6521,6522,Vasco,0,0,461,12,Atletico-MG,0,0,466,9,21,927,0,0,0,1/5/2019,17
6522,6522,6523,Fortaleza,3,0,291,12,Athletico-PR,3,0,507,19,31,798,6,0,6,1/5/2019,17
6523,6523,6524,Santos,3,0,377,25,Fluminense,2,0,517,14,39,894,5,0,5,2/5/2019,17
6524,6524,6525,Botafogo-RJ,3,0,482,11,Bahia,0,0,421,15,26,903,3,0,3,2/5/2019,17
6525,6525,6526,Vasco,2,0,342,21,Corinthians,1,0,411,8,29,753,3,0,3,4/5/2019,17
6526,6526,6527,Palmeiras,2,0,255,15,Internacional,5,0,477,18,33,732,7,0,7,4/5/2019,17
6527,6527,6528,Ceara,0,0,450,12,Atletico-MG,1,0,531,7,19,981,1,0,1,4/5/2019,17
6528,6528,6529,Chapecoense,1,0,384,16,Athletico-PR,3,0,399,17,33,783,4,0,4,5/5/2019,17
6529,6529,6530,Sao Paulo,1,0,456,16,Flamengo,7,0,259,15,31,715,8,0,8,5/5/2019,17
6530,6530,6531,Botafogo-RJ,0,0,539,10,Fortaleza,2,0,406,16,26,945,2,0,2,5/5/2019,17
6531,6531,6532,CSA,1,0,250,11,Santos,4,0,632,13,24,882,5,0,5,5/5/2019,17
6532,6532,6533,Cruzeiro,1,0,519,14,Goias,1,1,333,10,24,852,2,1,3,5/5/2019,17
6533,6533,6534,Gremio,2,0,544,8,Fluminense,1,0,490,10,18,1034,3,0,3,5/5/2019,17
6534,6534,6535,Bahia,1,0,394,27,Avai,2,0,367,15,42,761,3,0,3,5/5/2019,17
6535,6535,6536,Fluminense,3,0,504,16,Botafogo-RJ,5,0,305,12,28,809,8,0,8,11/5/2019,17
6536,6536,6537,Corinthians,2,0,474,13,Gremio,4,0,513,19,32,987,6,0,6,11/5/2019,17
6537,6537,6538,Goias,2,0,295,20,Ceara,2,0,487,12,32,782,4,0,4,11/5/2019,17
6538,6538,6539,Flamengo,2,0,464,18,Chapecoense,3,0,362,9,27,826,5,0,5,12/5/2019,17
6539,6539,6540,Santos,2,0,435,18,Vasco,3,1,346,11,29,781,5,1,6,12/5/2019,17
6540,6540,6541,Atletico-MG,0,0,0,0,Palmeiras,0,0,0,0,0,0,0,0,0,12/5/2019,17
6541,6541,6542,Internacional,0,0,505,10,Cruzeiro,0,1,442,14,24,947,0,1,1,12/5/2019,17
6542,6542,6543,Avai,1,0,544,14,CSA,2,0,376,18,32,920,3,0,3,12/5/2019,17
6543,6543,6544,Athletico-PR,2,0,539,13,Bahia,3,0,309,14,27,848,5,0,5,12/5/2019,17
6544,6544,6545,Fortaleza,2,0,478,12,Sao Paulo,2,0,430,14,26,908,4,0,4,12/5/2019,17
6545,6545,6546,Fluminense,3,0,501,20,Cruzeiro,2,0,442,12,32,943,5,0,5,18/5/2019,17
6546,6546,6547,Palmeiras,2,0,245,23,Santos,4,0,479,19,42,724,6,0,6,18/5/2019,17
6547,6547,6548,Atletico-MG,3,1,255,11,Flamengo,1,0,488,8,19,743,4,1,5,18/5/2019,17
6548,6548,6549,Sao Paulo,1,1,512,9,Bahia,3,0,371,19,28,883,4,1,5,19/5/2019,17
6549,6549,6550,Internacional,2,0,601,11,CSA,3,0,342,9,20,943,5,0,5,19/5/2019,17
6550,6550,6551,Athletico-PR,1,0,583,16,Corinthians,4,0,362,12,28,945,5,0,5,19/5/2019,17
6551,6551,6552,Goias,1,0,238,18,Botafogo-RJ,3,0,571,14,32,809,4,0,4,19/5/2019,17
6552,6552,6553,Chapecoense,1,0,419,16,Fortaleza,1,0,395,12,28,814,2,0,2,19/5/2019,17
6553,6553,6554,Vasco,1,0,368,16,Avai,2,0,348,14,30,716,3,0,3,19/5/2019,17
6554,6554,6555,Ceara,3,0,281,14,Gremio,6,0,493,16,30,774,9,0,9,19/5/2019,17
6555,6555,6556,Botafogo-RJ,10,0,444,13,Palmeiras,0,0,254,19,32,698,10,0,10,25/5/2019,17
6556,6556,6557,Gremio,1,0,570,10,Atletico-MG,4,0,437,14,24,1007,5,0,5,25/5/2019,17
6557,6557,6558,Flamengo,4,0,392,16,Athletico-PR,3,0,412,21,37,804,7,0,7,26/5/2019,17
6558,6558,6559,Santos,5,0,517,19,Internacional,5,0,316,19,38,833,10,0,10,26/5/2019,17
6559,6559,6560,Fortaleza,1,0,539,9,Vasco,2,0,337,12,21,876,3,0,3,26/5/2019,17
6560,6560,6561,Cruzeiro,1,0,559,13,Chapecoense,3,0,313,11,24,872,4,0,4,26/5/2019,17
6561,6561,6562,Bahia,2,0,303,9,Fluminense,2,1,603,10,19,906,4,1,5,26/5/2019,17
6562,6562,6563,Corinthians,3,0,296,16,Sao Paulo,4,0,438,14,30,734,7,0,7,26/5/2019,17
6563,6563,6564,CSA,3,0,334,19,Goias,1,0,412,10,29,746,4,0,4,27/5/2019,17
6564,6564,6565,Avai,4,0,417,21,Ceara,3,0,399,15,36,816,7,0,7,27/5/2019,17
6565,6565,6566,Flamengo,1,0,652,16,Fortaleza,0,0,343,6,22,995,1,0,1,1/6/2019,17
6566,6566,6567,Bahia,1,0,394,8,Gremio,2,0,537,10,18,931,3,0,3,1/6/2019,17
6567,6567,6568,Botafogo-RJ,2,0,469,15,Vasco,3,0,362,16,31,831,5,0,5,2/6/2019,17
6568,6568,6569,Ceara,2,0,301,14,Santos,1,0,470,22,36,771,3,0,3,2/6/2019,17
6569,6569,6570,Athletico-PR,1,0,457,20,Fluminense,3,1,372,17,37,829,4,1,5,2/6/2019,17
6570,6570,6571,Sao Paulo,2,1,369,15,Cruzeiro,3,0,567,12,27,936,5,1,6,2/6/2019,17
6571,6571,6572,Atletico-MG,0,0,771,2,CSA,3,0,304,11,13,1075,3,0,3,2/6/2019,17
6572,6572,6573,Chapecoense,2,0,410,14,Palmeiras,5,0,356,21,35,766,7,0,7,2/6/2019,17
6573,6573,6574,Internacional,0,0,682,11,Avai,0,0,382,12,23,1064,0,0,0,2/6/2019,17
6574,6574,6576,Vasco,0,0,288,13,Internacional,2,0,635,16,29,923,2,0,2,7/6/2019,17
6575,6575,6577,Palmeiras,2,0,304,16,Athletico-PR,4,0,406,29,45,710,6,0,6,8/6/2019,17
6576,6576,6578,Gremio,1,0,630,7,Fortaleza,4,1,343,7,14,973,5,1,6,8/6/2019,17
6577,6577,6579,Cruzeiro,1,0,448,12,Corinthians,1,0,538,13,25,986,2,0,2,8/6/2019,17
6578,6578,6580,Ceara,2,0,477,12,Bahia,2,0,296,10,22,773,4,0,4,8/6/2019,17
6579,6579,6581,Avai,5,0,302,17,Sao Paulo,2,0,513,17,34,815,7,0,7,8/6/2019,17
6580,6580,6582,CSA,2,0,328,20,Botafogo-RJ,1,0,520,10,30,848,3,0,3,9/6/2019,17
6581,6581,6583,Fluminense,2,0,607,14,Flamengo,3,0,339,17,31,946,5,0,5,9/6/2019,17
6582,6582,6584,Santos,1,0,532,12,Atletico-MG,2,0,383,14,26,915,3,0,3,9/6/2019,17
6583,6583,6585,Goias,2,0,353,14,Chapecoense,0,1,350,17,31,703,2,1,3,10/6/2019,17
6584,6584,6586,Botafogo-RJ,1,0,463,9,Gremio,2,0,515,11,20,978,3,0,3,12/6/2019,17
6585,6585,6587,Fortaleza,0,1,354,10,Cruzeiro,6,0,426,15,25,780,6,1,7,12/6/2019,17
6586,6586,6588,Internacional,1,0,506,11,Bahia,1,0,593,7,18,1099,2,0,2,12/6/2019,17
6587,6587,6589,CSA,3,0,276,13,Flamengo,1,0,515,10,23,791,4,0,4,12/6/2019,17
6588,6588,6590,Santos,4,0,461,16,Corinthians,4,0,413,13,29,874,8,0,8,12/6/2019,17
6589,6589,6591,Vasco,0,0,484,14,Ceara,2,0,426,15,29,910,2,0,2,13/6/2019,17
6590,6590,6592,Chapecoense,2,0,296,12,Fluminense,5,1,549,21,33,845,7,1,8,13/6/2019,17
6591,6591,6593,Palmeiras,1,0,421,13,Avai,1,0,379,18,31,800,2,0,2,13/6/2019,17
6592,6592,6594,Atletico-MG,2,0,721,13,Sao Paulo,4,0,318,17,30,1039,6,0,6,13/6/2019,17
6593,6593,6595,Goias,0,0,0,0,Athletico-PR,0,0,0,0,0,0,0,0,0,13/6/2019,17
6594,6594,6596,Gremio,2,0,622,18,Vasco,4,0,255,12,30,877,6,0,6,13/7/2019,17
6595,6595,6597,Fortaleza,2,0,361,15,Avai,2,0,513,12,27,874,4,0,4,13/7/2019,17
6596,6596,6598,Bahia,2,0,330,13,Santos,3,0,527,11,24,857,5,0,5,13/7/2019,17
6597,6597,6599,Sao Paulo,3,0,333,19,Palmeiras,3,0,406,18,37,739,6,0,6,13/7/2019,17
6598,6598,6600,Flamengo,1,0,561,8,Goias,2,0,202,9,17,763,3,0,3,14/7/2019,17
6599,6599,6601,Corinthians,2,0,549,2,CSA,6,0,296,18,20,845,8,0,8,14/7/2019,17
6600,6600,6602,Athletico-PR,3,0,460,15,Internacional,3,0,303,16,31,763,6,0,6,14/7/2019,17
6601,6601,6603,Cruzeiro,0,0,454,11,Botafogo-RJ,0,0,640,8,19,1094,0,0,0,14/7/2019,17
6602,6602,6604,Chapecoense,3,0,264,20,Atletico-MG,5,0,439,16,36,703,8,0,8,14/7/2019,17
6603,6603,6605,Fluminense,2,0,628,11,Ceara,2,0,265,15,26,893,4,0,4,15/7/2019,17
6604,6604,6606,Vasco,4,0,391,25,Fluminense,2,2,499,22,47,890,6,2,8,20/7/2019,17
6605,6605,6607,Bahia,1,1,517,17,Cruzeiro,1,0,384,8,25,901,2,1,3,20/7/2019,17
6606,6606,6608,Ceara,3,0,286,26,Palmeiras,2,0,374,13,39,660,5,0,5,20/7/2019,17
6607,6607,6609,CSA,0,0,0,0,Athletico-PR,0,0,0,0,0,0,0,0,0,20/7/2019,17
6608,6608,6610,Internacional,3,0,415,13,Gremio,2,0,570,14,27,985,5,0,5,20/7/2019,17
6609,6609,6611,Botafogo-RJ,1,1,441,12,Santos,2,1,445,14,26,886,3,2,5,21/7/2019,17
6610,6610,6612,Atletico-MG,1,0,409,15,Fortaleza,4,0,385,12,27,794,5,0,5,21/7/2019,17
6611,6611,6613,Corinthians,1,0,318,20,Flamengo,3,1,410,17,37,728,4,1,5,21/7/2019,17
6612,6612,6614,Avai,4,0,490,16,Goias,2,0,304,19,35,794,6,0,6,21/7/2019,17
6613,6613,6615,Sao Paulo,1,0,400,29,Chapecoense,3,0,405,19,48,805,4,0,4,22/7/2019,17
6614,6614,6616,Palmeiras,1,0,386,22,Vasco,4,0,321,22,44,707,5,0,5,27/7/2019,17
6615,6615,6617,Cruzeiro,0,0,0,0,Athletico-PR,0,0,0,0,0,0,0,0,0,27/7/2019,17
6616,6616,6618,Fluminense,1,0,660,20,Sao Paulo,3,0,264,14,34,924,4,0,4,27/7/2019,17
6617,6617,6619,Internacional,3,0,490,11,Ceara,3,0,408,12,23,898,6,0,6,27/7/2019,17
6618,6618,6620,Chapecoense,1,0,360,16,Bahia,1,0,411,15,31,771,2,0,2,28/7/2019,17
6619,6619,6621,Flamengo,5,0,488,23,Botafogo-RJ,2,0,290,16,39,778,7,0,7,28/7/2019,17
6620,6620,6622,Santos,2,0,435,9,Avai,2,0,308,13,22,743,4,0,4,28/7/2019,17
6621,6621,6623,Goias,1,0,397,14,Atletico-MG,0,0,486,9,23,883,1,0,1,28/7/2019,17
6622,6622,6624,Fortaleza,2,0,408,18,Corinthians,1,0,450,16,34,858,3,0,3,28/7/2019,17
6623,6623,6625,CSA,4,0,350,13,Gremio,2,0,526,13,26,876,6,0,6,29/7/2019,17
6624,6624,6626,Ceara,3,0,229,14,Fortaleza,0,1,427,16,30,656,3,1,4,3/8/2019,17
6625,6625,6627,Fluminense,1,0,640,8,Internacional,2,0,412,12,20,1052,3,0,3,3/8/2019,17
6626,6626,6628,Santos,3,0,500,15,Goias,4,0,311,8,23,811,7,0,7,4/8/2019,17
6627,6627,6629,Avai,2,1,507,12,Botafogo-RJ,1,0,368,11,23,875,3,1,4,4/8/2019,17
6628,6628,6630,Bahia,1,1,273,18,Flamengo,1,0,582,14,32,855,2,1,3,4/8/2019,17
6629,6629,6631,Corinthians,1,0,371,11,Palmeiras,3,0,373,24,35,744,4,0,4,4/8/2019,17
6630,6630,6632,Vasco,4,0,511,13,CSA,1,0,395,14,27,906,5,0,5,4/8/2019,17
6631,6631,6633,Atletico-MG,2,0,359,19,Cruzeiro,3,0,595,13,32,954,5,0,5,4/8/2019,17
6632,6632,6634,Gremio,4,0,583,17,Chapecoense,3,0,268,16,33,851,7,0,7,5/8/2019,17
6633,6633,6575,Corinthians,1,0,575,13,Goias,2,1,318,11,24,893,3,1,4,7/8/2019,17
6634,6634,6636,Ceara,3,0,292,20,Chapecoense,2,0,459,11,31,751,5,0,5,10/8/2019,17
6635,6635,6637,Sao Paulo,6,0,263,21,Santos,1,0,367,15,36,630,7,0,7,10/8/2019,17
6636,6636,6638,Flamengo,4,0,506,14,Gremio,2,0,380,15,29,886,6,0,6,10/8/2019,17
6637,6637,6639,Atletico-MG,4,0,373,14,Fluminense,2,1,527,13,27,900,6,1,7,10/8/2019,17
6638,6638,6640,Internacional,3,0,551,16,Corinthians,2,0,447,8,24,998,5,0,5,11/8/2019,17
6639,6639,6641,Palmeiras,6,1,287,15,Bahia,3,1,428,19,34,715,9,2,11,11/8/2019,17
6640,6640,6642,Avai,4,1,360,15,Cruzeiro,1,1,386,15,30,746,5,2,7,11/8/2019,17
6641,6641,6643,Botafogo-RJ,3,0,367,11,Athletico-PR,1,0,426,12,23,793,4,0,4,11/8/2019,17
6642,6642,6644,Goias,4,0,420,14,Vasco,3,1,350,22,36,770,7,1,8,11/8/2019,17
6643,6643,6645,CSA,3,0,470,19,Fortaleza,1,0,450,13,32,920,4,0,4,12/8/2019,17
6644,6644,6646,Corinthians,2,0,393,17,Botafogo-RJ,3,0,545,13,30,938,5,0,5,17/8/2019,17
6645,6645,6647,Fortaleza,1,1,485,14,Internacional,2,0,413,14,28,898,3,1,4,17/8/2019,17
6646,6646,6648,Vasco,0,0,347,12,Flamengo,3,0,491,18,30,838,3,0,3,17/8/2019,17
6647,6647,6649,Athletico-PR,0,0,0,0,Atletico-MG,0,0,0,0,0,0,0,0,0,17/8/2019,17
6648,6648,6650,Gremio,0,0,634,13,Palmeiras,0,0,304,14,27,938,0,0,0,17/8/2019,17
6649,6649,6651,Fluminense,1,0,686,7,CSA,2,0,344,16,23,1030,3,0,3,18/8/2019,17
6650,6650,6652,Sao Paulo,3,0,463,12,Ceara,2,0,316,16,28,779,5,0,5,18/8/2019,17
6651,6651,6653,Bahia,2,1,436,7,Goias,3,0,471,13,20,907,5,1,6,18/8/2019,17
6652,6652,6654,Cruzeiro,2,0,576,16,Santos,0,1,297,7,23,873,2,1,3,18/8/2019,17
6653,6653,6655,Chapecoense,1,0,317,25,Avai,0,0,449,15,40,766,1,0,1,18/8/2019,17
6654,6654,6635,Athletico-PR,0,0,0,0,Sao Paulo,0,0,0,0,0,0,0,0,0,21/8/2019,17
6655,6655,6656,Atletico-MG,0,0,501,17,Bahia,2,0,391,16,33,892,2,0,2,24/8/2019,17
6656,6656,6657,Gremio,0,0,0,0,Athletico-PR,0,0,0,0,0,0,0,0,0,24/8/2019,17
6657,6657,6658,Goias,2,1,203,9,Internacional,2,0,611,14,23,814,4,1,5,25/8/2019,17
6658,6658,6659,Vasco,4,0,473,19,Sao Paulo,3,1,449,16,35,922,7,1,8,25/8/2019,17
6659,6659,6660,Santos,3,0,486,14,Fortaleza,3,0,312,22,36,798,6,0,6,25/8/2019,17
6660,6660,6661,Ceara,3,0,412,11,Flamengo,0,0,404,14,25,816,3,0,3,25/8/2019,17
6661,6661,6662,Avai,0,1,399,19,Corinthians,1,1,420,15,34,819,1,2,3,25/8/2019,17
6662,6662,6663,CSA,3,0,441,17,Cruzeiro,3,0,497,14,31,938,6,0,6,25/8/2019,17
6663,6663,6664,Botafogo-RJ,2,0,450,13,Chapecoense,1,0,285,16,29,735,3,0,3,26/8/2019,17
6664,6664,6666,Sao Paulo,0,1,496,10,Gremio,1,0,426,9,19,922,1,1,2,31/8/2019,17
6665,6665,6667,Bahia,1,0,538,15,CSA,1,0,285,17,32,823,2,0,2,31/8/2019,17
6666,6666,6668,Chapecoense,2,0,399,17,Santos,4,0,386,19,36,785,6,0,6,31/8/2019,17
6667,6667,6669,Athletico-PR,1,0,534,14,Ceara,3,0,247,15,29,781,4,0,4,31/8/2019,17
6668,6668,6670,Internacional,4,0,485,10,Botafogo-RJ,4,0,496,6,16,981,8,0,8,31/8/2019,17
6669,6669,6671,Flamengo,2,0,658,15,Palmeiras,2,1,341,16,31,999,4,1,5,1/9/2019,17
6670,6670,6672,Fortaleza,3,0,389,21,Goias,1,1,365,14,35,754,4,1,5,1/9/2019,17
6671,6671,6673,Cruzeiro,3,0,501,14,Vasco,4,0,364,15,29,865,7,0,7,1/9/2019,17
6672,6672,6674,Corinthians,0,0,484,9,Atletico-MG,1,0,607,14,23,1091,1,0,1,1/9/2019,17
6673,6673,6675,Fluminense,3,0,509,14,Avai,1,0,344,15,29,853,4,0,4,2/9/2019,17
6674,6674,6676,Vasco,3,0,453,15,Bahia,1,0,354,19,34,807,4,0,4,7/9/2019,17
6675,6675,6677,Corinthians,1,0,508,9,Ceara,1,0,320,10,19,828,2,0,2,7/9/2019,17
6676,6676,6678,Avai,1,1,378,15,Flamengo,2,0,540,9,24,918,3,1,4,7/9/2019,17
6677,6677,6679,Fortaleza,1,0,413,13,Fluminense,2,0,472,15,28,885,3,0,3,7/9/2019,17
6678,6678,6680,Internacional,1,0,445,14,Sao Paulo,5,0,442,16,30,887,6,0,6,7/9/2019,17
6679,6679,6681,Goias,5,0,276,11,Palmeiras,0,1,516,21,32,792,5,1,6,7/9/2019,17
6680,6680,6682,Cruzeiro,2,0,571,11,Gremio,1,0,533,10,21,1104,3,0,3,8/9/2019,17
6681,6681,6683,Santos,3,0,437,8,Athletico-PR,6,0,289,15,23,726,9,0,9,8/9/2019,17
6682,6682,6684,Botafogo-RJ,4,0,435,14,Atletico-MG,2,1,482,14,28,917,6,1,7,8/9/2019,17
6683,6683,6685,CSA,3,0,312,22,Chapecoense,1,2,320,14,36,632,4,2,6,8/9/2019,17
6684,6684,6665,Palmeiras,0,0,406,12,Fluminense,2,0,463,11,23,869,2,0,2,10/9/2019,17
6685,6685,6686,Flamengo,2,0,379,20,Santos,5,0,349,24,44,728,7,0,7,14/9/2019,17
6686,6686,6687,Chapecoense,2,0,400,14,Vasco,5,0,334,22,36,734,7,0,7,14/9/2019,17
6687,6687,6688,Palmeiras,2,0,461,20,Cruzeiro,3,0,351,19,39,812,5,0,5,14/9/2019,17
6688,6688,6689,Ceara,1,0,347,11,Botafogo-RJ,1,0,570,5,16,917,2,0,2,14/9/2019,17
6689,6689,6690,Athletico-PR,0,0,0,0,Avai,0,0,0,0,0,0,0,0,0,15/9/2019,17
6690,6690,6691,Atletico-MG,0,0,659,6,Internacional,1,0,435,14,20,1094,1,0,1,15/9/2019,17
6691,6691,6692,Bahia,1,0,383,16,Fortaleza,1,0,336,11,27,719,2,0,2,15/9/2019,17
6692,6692,6693,Gremio,0,0,628,10,Goias,1,0,365,10,20,993,1,0,1,15/9/2019,17
6693,6693,6694,Fluminense,4,0,429,19,Corinthians,1,0,439,12,31,868,5,0,5,15/9/2019,17
6694,6694,6695,Sao Paulo,1,0,523,14,CSA,3,0,206,16,30,729,4,0,4,15/9/2019,17
6695,6695,6696,Botafogo-RJ,3,0,442,14,Sao Paulo,1,0,383,23,37,825,4,0,4,21/9/2019,17
6696,6696,6697,Cruzeiro,2,0,351,9,Flamengo,2,0,487,14,23,838,4,0,4,21/9/2019,17
6697,6697,6698,Corinthians,2,0,396,12,Bahia,4,0,419,15,27,815,6,0,6,21/9/2019,17
6698,6698,6699,Santos,1,0,468,13,Gremio,4,0,346,15,28,814,5,0,5,21/9/2019,17
6699,6699,6700,Internacional,0,0,527,12,Chapecoense,4,0,303,19,31,830,4,0,4,22/9/2019,17
6700,6700,6701,Fortaleza,4,0,346,16,Palmeiras,1,0,459,11,27,805,5,0,5,22/9/2019,17
6701,6701,6702,CSA,1,0,322,20,Ceara,2,0,399,9,29,721,3,0,3,22/9/2019,17
6702,6702,6703,Vasco,0,0,0,0,Athletico-PR,0,0,0,0,0,0,0,0,0,22/9/2019,17
6703,6703,6704,Goias,4,1,231,16,Fluminense,0,0,572,10,26,803,4,1,5,22/9/2019,17
6704,6704,6705,Avai,3,0,318,11,Atletico-MG,1,0,558,14,25,876,4,0,4,23/9/2019,17
6705,6705,6706,Ceara,2,0,402,18,Cruzeiro,3,0,461,17,35,863,5,0,5,25/9/2019,17
6706,6706,6707,Bahia,1,0,509,17,Botafogo-RJ,0,1,377,9,26,886,1,1,2,25/9/2019,17
6707,6707,6708,Flamengo,1,0,594,16,Internacional,1,2,232,6,22,826,2,2,4,25/9/2019,17
6708,6708,6709,Sao Paulo,2,0,543,21,Goias,4,0,212,24,45,755,6,0,6,25/9/2019,17
6709,6709,6710,Palmeiras,0,0,694,13,CSA,1,0,295,13,26,989,1,0,1,26/9/2019,17
6710,6710,6711,Fluminense,2,2,418,12,Santos,2,1,467,15,27,885,4,3,7,26/9/2019,17
6711,6711,6712,Gremio,1,0,585,18,Avai,1,0,538,9,27,1123,2,0,2,26/9/2019,17
6712,6712,6713,Athletico-PR,3,0,607,11,Fortaleza,0,0,321,8,19,928,3,0,3,26/9/2019,17
6713,6713,6716,Flamengo,3,0,531,20,Sao Paulo,4,0,334,27,47,865,7,0,7,28/9/2019,17
6714,6714,6717,Corinthians,3,0,455,16,Vasco,5,0,382,23,39,837,8,0,8,29/9/2019,17
6715,6715,6718,Santos,0,1,572,13,CSA,2,0,338,12,25,910,2,1,3,29/9/2019,17
6716,6716,6719,Internacional,3,0,455,28,Palmeiras,2,0,403,17,45,858,5,0,5,29/9/2019,17
6717,6717,6720,Fluminense,1,0,481,17,Gremio,4,0,531,9,26,1012,5,0,5,29/9/2019,17
6718,6718,6721,Athletico-PR,0,0,0,0,Chapecoense,0,0,0,0,0,0,0,0,0,29/9/2019,17
6719,6719,6722,Atletico-MG,0,0,515,13,Ceara,2,0,315,12,25,830,2,0,2,29/9/2019,17
6720,6720,6723,Avai,1,0,481,16,Bahia,2,0,393,16,32,874,3,0,3,30/9/2019,17
6721,6721,6724,Fortaleza,3,0,410,15,Botafogo-RJ,2,0,502,12,27,912,5,0,5,30/9/2019,17
6722,6722,6725,Goias,0,0,252,20,Cruzeiro,3,0,505,19,39,757,3,0,3,30/9/2019,17
6723,6723,6714,Atletico-MG,3,0,404,18,Vasco,2,0,338,22,40,742,5,0,5,2/10/2019,17
6724,6724,6715,Chapecoense,3,0,397,19,Corinthians,2,0,336,15,34,733,5,0,5,2/10/2019,17
6725,6725,6726,Vasco,4,0,285,15,Santos,2,1,423,17,32,708,6,1,7,5/10/2019,17
6726,6726,6727,Sao Paulo,3,0,478,15,Fortaleza,2,0,300,14,29,778,5,0,5,5/10/2019,17
6727,6727,6728,Gremio,3,0,609,12,Corinthians,2,0,338,12,24,947,5,0,5,5/10/2019,17
6728,6728,6729,Bahia,2,0,413,9,Athletico-PR,3,0,491,14,23,904,5,0,5,5/10/2019,17
6729,6729,6730,Cruzeiro,5,0,470,18,Internacional,3,0,440,14,32,910,8,0,8,5/10/2019,17
6730,6730,6731,Chapecoense,1,0,298,16,Flamengo,0,0,520,20,36,818,1,0,1,6/10/2019,17
6731,6731,6732,Ceara,1,0,411,7,Goias,0,0,314,12,19,725,1,0,1,6/10/2019,17
6732,6732,6733,Palmeiras,3,0,506,12,Atletico-MG,4,0,254,20,32,760,7,0,7,6/10/2019,17
6733,6733,6734,Botafogo-RJ,4,0,410,20,Fluminense,1,0,481,20,40,891,5,0,5,6/10/2019,17
6734,6734,6735,CSA,3,0,242,10,Avai,3,0,593,11,21,835,6,0,6,6/10/2019,17
6735,6735,6736,CSA,2,0,259,16,Internacional,2,0,593,9,25,852,4,0,4,9/10/2019,17
6736,6736,6737,Botafogo-RJ,4,0,348,29,Goias,2,0,446,18,47,794,6,0,6,9/10/2019,17
6737,6737,6738,Fortaleza,4,0,446,18,Chapecoense,2,0,397,17,35,843,6,0,6,9/10/2019,17
6738,6738,6739,Bahia,2,0,378,10,Sao Paulo,1,0,565,15,25,943,3,0,3,9/10/2019,17
6739,6739,6740,Gremio,0,0,641,11,Ceara,3,0,293,19,30,934,3,0,3,9/10/2019,17
6740,6740,6741,Cruzeiro,4,0,459,17,Fluminense,3,0,460,18,35,919,7,0,7,9/10/2019,17
6741,6741,6742,Santos,1,0,474,16,Palmeiras,2,1,364,13,29,838,3,1,4,9/10/2019,17
6742,6742,6743,Corinthians,0,0,0,0,Athletico-PR,0,0,0,0,0,0,0,0,0,10/10/2019,17
6743,6743,6744,Avai,1,0,505,18,Vasco,1,0,419,11,29,924,2,0,2,10/10/2019,17
6744,6744,6745,Flamengo,0,0,630,10,Atletico-MG,3,0,318,9,19,948,3,0,3,10/10/2019,17
6745,6745,6746,Goias,2,0,365,17,CSA,3,0,376,21,38,741,5,0,5,12/10/2019,17
6746,6746,6747,Fluminense,0,0,434,11,Bahia,1,0,447,15,26,881,1,0,1,12/10/2019,17
6747,6747,6748,Palmeiras,2,0,413,22,Botafogo-RJ,2,0,422,13,35,835,4,0,4,12/10/2019,17
6748,6748,6749,Internacional,2,0,420,16,Santos,3,0,492,18,34,912,5,0,5,13/10/2019,17
6749,6749,6750,Athletico-PR,0,0,0,0,Flamengo,0,0,0,0,0,0,0,0,0,13/10/2019,17
6750,6750,6751,Ceara,1,0,449,16,Avai,3,0,368,16,32,817,4,0,4,13/10/2019,17
6751,6751,6752,Vasco,2,0,406,14,Fortaleza,3,1,301,19,33,707,5,1,6,13/10/2019,17
6752,6752,6753,Sao Paulo,0,0,568,9,Corinthians,1,0,467,10,19,1035,1,0,1,13/10/2019,17
6753,6753,6754,Atletico-MG,4,1,394,17,Gremio,1,0,526,8,25,920,5,1,6,13/10/2019,17
6754,6754,6755,Chapecoense,1,0,484,12,Cruzeiro,1,0,331,13,25,815,2,0,2,13/10/2019,17
6755,6755,6756,CSA,3,0,358,18,Atletico-MG,2,1,498,13,31,856,5,1,6,16/10/2019,17
6756,6756,6757,Gremio,3,0,554,13,Bahia,2,0,337,15,28,891,5,0,5,16/10/2019,17
6757,6757,6758,Fortaleza,1,0,203,8,Flamengo,3,0,462,16,24,665,4,0,4,16/10/2019,17
6758,6758,6759,Cruzeiro,2,0,363,18,Sao Paulo,2,0,558,16,34,921,4,0,4,16/10/2019,17
6759,6759,6760,Palmeiras,1,0,547,15,Chapecoense,3,1,222,14,29,769,4,1,5,16/10/2019,17
6760,6760,6761,Goias,2,2,305,10,Corinthians,4,0,411,16,26,716,6,2,8,16/10/2019,17
6761,6761,6762,Vasco,1,0,275,15,Botafogo-RJ,0,0,485,11,26,760,1,0,1,16/10/2019,17
6762,6762,6763,Avai,1,1,273,7,Internacional,3,0,675,16,23,948,4,1,5,17/10/2019,17
6763,6763,6764,Santos,3,0,493,15,Ceara,4,0,228,11,26,721,7,0,7,17/10/2019,17
6764,6764,6765,Fluminense,0,0,0,0,Athletico-PR,0,0,0,0,0,0,0,0,0,17/10/2019,17
6765,6765,6766,Fortaleza,4,0,341,13,Gremio,1,1,504,17,30,845,5,1,6,19/10/2019,17
6766,6766,6767,Corinthians,3,0,463,15,Cruzeiro,1,0,394,18,33,857,4,0,4,19/10/2019,17
6767,6767,6768,Internacional,3,0,605,14,Vasco,1,0,250,12,26,855,4,0,4,20/10/2019,17
6768,6768,6769,Sao Paulo,4,0,682,23,Avai,1,1,206,11,34,888,5,1,6,20/10/2019,17
6769,6769,6770,Atletico-MG,3,0,224,24,Santos,4,0,504,14,38,728,7,0,7,20/10/2019,17
6770,6770,6771,Flamengo,3,0,364,23,Fluminense,5,0,408,13,36,772,8,0,8,20/10/2019,17
6771,6771,6772,Chapecoense,2,0,311,23,Goias,5,0,314,14,37,625,7,0,7,20/10/2019,17
6772,6772,6773,Athletico-PR,1,0,432,23,Palmeiras,2,0,407,11,34,839,3,0,3,20/10/2019,17
6773,6773,6774,Bahia,2,0,384,14,Ceara,3,0,405,11,25,789,5,0,5,21/10/2019,17
6774,6774,6775,Botafogo-RJ,2,0,389,18,CSA,1,1,511,16,34,900,3,1,4,21/10/2019,17
6775,6775,6776,Corinthians,3,0,285,20,Santos,1,0,502,12,32,787,4,0,4,26/10/2019,17
6776,6776,6777,Ceara,3,0,544,11,Vasco,3,0,321,14,25,865,6,0,6,26/10/2019,17
6777,6777,6778,Bahia,1,0,470,16,Internacional,5,0,388,11,27,858,6,0,6,26/10/2019,17
6778,6778,6779,Fluminense,1,0,563,11,Chapecoense,4,0,258,14,25,821,5,0,5,26/10/2019,17
6779,6779,6780,Cruzeiro,0,0,0,0,Fortaleza,0,0,0,0,0,0,0,0,0,26/10/2019,17
6780,6780,6781,Athletico-PR,0,0,0,0,Goias,0,0,0,0,0,0,0,0,0,27/10/2019,17
6781,6781,6782,Gremio,3,0,497,13,Botafogo-RJ,2,0,441,9,22,938,5,0,5,27/10/2019,17
6782,6782,6783,Sao Paulo,0,0,543,9,Atletico-MG,0,0,353,11,20,896,0,0,0,27/10/2019,17
6783,6783,6784,Avai,3,0,266,18,Palmeiras,2,0,463,17,35,729,5,0,5,27/10/2019,17
6784,6784,6785,Flamengo,1,0,605,20,CSA,2,0,351,13,33,956,3,0,3,27/10/2019,17
6785,6785,6786,Palmeiras,0,0,267,12,Sao Paulo,0,0,581,14,26,848,0,0,0,30/10/2019,17
6786,6786,6787,Avai,4,1,431,20,Fortaleza,1,0,448,10,30,879,5,1,6,30/10/2019,17
6787,6787,6788,Atletico-MG,3,0,475,15,Chapecoense,3,0,207,10,25,682,6,0,6,30/10/2019,17
6788,6788,6789,Ceara,1,0,275,12,Fluminense,1,0,686,8,20,961,2,0,2,30/10/2019,17
6789,6789,6790,Vasco,2,0,363,9,Gremio,2,0,496,13,22,859,4,0,4,30/10/2019,17
6790,6790,6791,CSA,6,0,371,17,Corinthians,2,0,469,10,27,840,8,0,8,30/10/2019,17
6791,6791,6792,Santos,5,0,450,17,Bahia,3,0,290,26,43,740,8,0,8,31/10/2019,17
6792,6792,6793,Goias,5,0,227,18,Flamengo,3,1,386,15,33,613,8,1,9,31/10/2019,17
6793,6793,6794,Internacional,3,0,484,14,Athletico-PR,2,0,405,22,36,889,5,0,5,31/10/2019,17
6794,6794,6795,Botafogo-RJ,1,0,406,15,Cruzeiro,3,0,328,15,30,734,4,0,4,31/10/2019,17
6795,6795,6796,Fortaleza,3,0,433,18,Atletico-MG,2,1,290,19,37,723,5,1,6,2/11/2019,17
6796,6796,6797,Fluminense,2,0,610,7,Vasco,3,0,308,12,19,918,5,0,5,2/11/2019,17
6797,6797,6798,Palmeiras,2,0,493,14,Ceara,2,0,395,19,33,888,4,0,4,2/11/2019,17
6798,6798,6799,Chapecoense,2,0,313,19,Sao Paulo,2,0,528,11,30,841,4,0,4,2/11/2019,17
6799,6799,6800,Flamengo,0,0,636,12,Corinthians,1,0,293,10,22,929,1,0,1,3/11/2019,17
6800,6800,6801,Athletico-PR,0,0,0,0,CSA,0,0,0,0,0,0,0,0,0,3/11/2019,17
6801,6801,6802,Gremio,2,0,518,16,Internacional,2,1,359,16,32,877,4,1,5,3/11/2019,17
6802,6802,6803,Santos,1,0,480,16,Botafogo-RJ,0,0,278,8,24,758,1,0,1,3/11/2019,17
6803,6803,6804,Cruzeiro,2,1,489,16,Bahia,0,0,270,11,27,759,2,1,3,3/11/2019,17
6804,6804,6805,Goias,1,0,354,19,Avai,3,0,401,19,38,755,4,0,4,3/11/2019,17
6805,6805,6806,Corinthians,2,0,559,18,Fortaleza,3,0,388,9,27,947,5,0,5,6/11/2019,17
6806,6806,6807,Atletico-MG,0,0,380,15,Goias,2,0,350,16,31,730,2,0,2,6/11/2019,17
6807,6807,6808,Avai,4,1,359,19,Santos,2,1,412,11,30,771,6,2,8,6/11/2019,17
6808,6808,6809,Athletico-PR,0,0,0,0,Cruzeiro,0,0,0,0,0,0,0,0,0,6/11/2019,17
6809,6809,6810,Vasco,7,1,309,17,Palmeiras,4,0,374,27,44,683,11,1,12,6/11/2019,17
6810,6810,6811,Bahia,1,0,483,20,Chapecoense,3,0,247,16,36,730,4,0,4,6/11/2019,17
6811,6811,6812,Ceara,2,0,413,8,Internacional,2,0,593,11,19,1006,4,0,4,7/11/2019,17
6812,6812,6813,Sao Paulo,2,0,612,6,Fluminense,1,0,475,16,22,1087,3,0,3,7/11/2019,17
6813,6813,6814,Botafogo-RJ,4,1,207,16,Flamengo,2,0,497,14,30,704,6,1,7,7/11/2019,17
6814,6814,6815,Gremio,3,0,646,15,CSA,2,0,354,16,31,1000,5,0,5,7/11/2019,17
6815,6815,6816,Goias,4,0,344,19,Santos,2,0,444,16,35,788,6,0,6,9/11/2019,17
6816,6816,6817,Palmeiras,2,0,323,12,Corinthians,1,0,394,18,30,717,3,0,3,9/11/2019,17
6817,6817,6818,Internacional,3,0,408,16,Fluminense,2,0,621,9,25,1029,5,0,5,10/11/2019,17
6818,6818,6819,Cruzeiro,1,0,426,9,Atletico-MG,1,0,302,12,21,728,2,0,2,10/11/2019,17
6819,6819,6820,Sao Paulo,0,0,0,0,Athletico-PR,0,0,0,0,0,0,0,0,0,10/11/2019,17
6820,6820,6821,Flamengo,1,0,526,10,Bahia,0,0,278,11,21,804,1,0,1,10/11/2019,17
6821,6821,6822,Chapecoense,2,0,425,10,Gremio,2,0,477,13,23,902,4,0,4,10/11/2019,17
6822,6822,6823,Fortaleza,4,0,283,13,Ceara,4,0,483,17,30,766,8,0,8,10/11/2019,17
6823,6823,6824,CSA,1,1,472,17,Vasco,2,0,337,18,35,809,3,1,4,10/11/2019,17
6824,6824,6825,Botafogo-RJ,4,0,295,19,Avai,2,1,502,16,35,797,6,1,7,11/11/2019,17
6825,6825,6826,Flamengo,6,0,513,23,Vasco,5,0,245,25,48,758,11,0,11,13/11/2019,17
6826,6826,6836,Santos,0,0,320,14,Sao Paulo,3,0,463,25,39,783,3,0,3,16/11/2019,17
6827,6827,6837,Fluminense,2,0,504,15,Atletico-MG,3,0,423,15,30,927,5,0,5,16/11/2019,17
6828,6828,6838,Gremio,1,0,559,9,Flamengo,2,1,270,15,24,829,3,1,4,17/11/2019,17
6829,6829,6839,Bahia,2,0,404,17,Palmeiras,0,0,481,16,33,885,2,0,2,17/11/2019,17
6830,6830,6840,Chapecoense,2,0,325,13,Ceara,1,0,508,15,28,833,3,0,3,17/11/2019,17
6831,6831,6841,Athletico-PR,0,0,0,0,Botafogo-RJ,0,0,0,0,0,0,0,0,0,17/11/2019,17
6832,6832,6842,Corinthians,0,0,411,9,Internacional,2,0,421,19,28,832,2,0,2,17/11/2019,17
6833,6833,6843,Fortaleza,0,0,516,10,CSA,1,0,294,20,30,810,1,0,1,17/11/2019,17
6834,6834,6844,Vasco,2,0,360,22,Goias,2,0,384,16,38,744,4,0,4,18/11/2019,17
6835,6835,6845,Cruzeiro,3,0,573,14,Avai,2,0,223,20,34,796,5,0,5,18/11/2019,17
6836,6836,6827,Santos,2,0,456,16,Cruzeiro,2,0,356,19,35,812,4,0,4,23/11/2019,17
6837,6837,6828,Palmeiras,2,0,376,14,Gremio,3,0,609,14,28,985,5,0,5,24/11/2019,17
6838,6838,6829,Atletico-MG,0,0,0,0,Athletico-PR,0,0,0,0,0,0,0,0,0,24/11/2019,17
6839,6839,6830,Goias,2,0,367,14,Bahia,2,0,415,23,37,782,4,0,4,24/11/2019,17
6840,6840,6831,Botafogo-RJ,4,0,239,11,Corinthians,2,0,597,19,30,836,6,0,6,24/11/2019,17
6841,6841,6832,Ceara,3,0,434,12,Sao Paulo,1,0,479,16,28,913,4,0,4,24/11/2019,17
6842,6842,6833,Internacional,4,0,539,16,Fortaleza,2,0,366,12,28,905,6,0,6,24/11/2019,17
6843,6843,6834,Avai,0,1,490,11,Chapecoense,1,1,360,15,26,850,1,2,3,24/11/2019,17
6844,6844,6835,CSA,2,0,372,15,Fluminense,2,0,604,14,29,976,4,0,4,25/11/2019,17
6845,6845,6846,Internacional,2,0,562,22,Goias,4,0,259,24,46,821,6,0,6,27/11/2019,17
6846,6846,6847,Chapecoense,2,0,396,12,Botafogo-RJ,3,0,290,18,30,686,5,0,5,27/11/2019,17
6847,6847,6848,Bahia,1,0,463,12,Atletico-MG,1,0,346,20,32,809,2,0,2,27/11/2019,17
6848,6848,6849,Athletico-PR,0,0,0,0,Gremio,0,0,0,0,0,0,0,0,0,27/11/2019,17
6849,6849,6850,Flamengo,2,0,553,13,Ceara,1,1,287,10,23,840,3,1,4,27/11/2019,17
6850,6850,6851,Corinthians,0,0,503,15,Avai,1,0,277,13,28,780,1,0,1,27/11/2019,17
6851,6851,6852,Fluminense,3,0,468,15,Palmeiras,4,0,551,20,35,1019,7,0,7,28/11/2019,17
6852,6852,6853,Fortaleza,2,0,246,16,Santos,6,2,419,17,33,665,8,2,10,28/11/2019,17
6853,6853,6854,Sao Paulo,4,0,486,29,Vasco,2,0,376,16,45,862,6,0,6,28/11/2019,17
6854,6854,6855,Cruzeiro,0,0,525,9,CSA,4,0,215,16,25,740,4,0,4,28/11/2019,17
6855,6855,6856,Botafogo-RJ,2,0,374,8,Internacional,3,0,475,14,22,849,5,0,5,30/11/2019,17
6856,6856,6857,Ceara,7,0,382,17,Athletico-PR,1,1,373,16,33,755,8,1,9,30/11/2019,17
6857,6857,6858,Avai,4,0,377,26,Fluminense,5,0,488,20,46,865,9,0,9,1/12/2019,17
6858,6858,6859,Palmeiras,1,0,420,18,Flamengo,2,0,545,21,39,965,3,0,3,1/12/2019,17
6859,6859,6860,Goias,1,0,421,11,Fortaleza,4,0,334,15,26,755,5,0,5,1/12/2019,17
6860,6860,6861,CSA,3,0,414,9,Bahia,3,1,372,12,21,786,6,1,7,1/12/2019,17
6861,6861,6862,Atletico-MG,3,0,273,15,Corinthians,1,0,394,8,23,667,4,0,4,1/12/2019,17
6862,6862,6863,Santos,3,0,499,18,Chapecoense,4,0,243,19,37,742,7,0,7,1/12/2019,17
6863,6863,6864,Gremio,0,0,375,15,Sao Paulo,0,0,521,16,31,896,0,0,0,1/12/2019,17
6864,6864,6865,Vasco,3,0,295,16,Cruzeiro,3,0,400,19,35,695,6,0,6,2/12/2019,17
6865,6865,6866,Athletico-PR,2,0,366,16,Santos,3,1,364,9,25,730,5,1,6,4/12/2019,17
6866,6866,6867,Ceara,2,1,261,15,Corinthians,4,0,479,14,29,740,6,1,7,4/12/2019,17
6867,6867,6868,Atletico-MG,1,0,419,11,Botafogo-RJ,3,0,446,10,21,865,4,0,4,4/12/2019,17
6868,6868,6869,Chapecoense,1,0,468,21,CSA,1,1,369,13,34,837,2,1,3,4/12/2019,17
6869,6869,6870,Fluminense,1,1,560,16,Fortaleza,0,1,411,9,25,971,1,2,3,4/12/2019,17
6870,6870,6871,Sao Paulo,3,0,368,20,Internacional,4,0,515,19,39,883,7,0,7,4/12/2019,17
6871,6871,6872,Gremio,0,0,580,11,Cruzeiro,3,1,342,21,32,922,3,1,4,5/12/2019,17
6872,6872,6873,Palmeiras,5,0,382,21,Goias,1,0,475,13,34,857,6,0,6,5/12/2019,17
6873,6873,6874,Bahia,2,1,436,21,Vasco,2,1,510,11,32,946,4,2,6,5/12/2019,17
6874,6874,6875,Flamengo,0,0,608,18,Avai,1,0,283,13,31,891,1,0,1,5/12/2019,17
6875,6875,6876,Corinthians,1,0,538,21,Fluminense,3,0,360,14,35,898,4,0,4,8/12/2019,17
6876,6876,6877,Santos,2,0,391,12,Flamengo,3,0,386,15,27,777,5,0,5,8/12/2019,17
6877,6877,6878,Botafogo-RJ,0,0,394,12,Ceara,2,0,382,19,31,776,2,0,2,8/12/2019,17
6878,6878,6879,CSA,1,0,349,17,Sao Paulo,2,1,493,24,41,842,3,1,4,8/12/2019,17
6879,6879,6880,Internacional,4,0,470,11,Atletico-MG,1,0,272,16,27,742,5,0,5,8/12/2019,17
6880,6880,6881,Cruzeiro,0,0,505,11,Palmeiras,1,0,384,11,22,889,1,0,1,8/12/2019,17
6881,6881,6882,Goias,1,0,309,21,Gremio,1,0,392,8,29,701,2,0,2,8/12/2019,17
6882,6882,6883,Vasco,2,0,378,18,Chapecoense,3,0,363,16,34,741,5,0,5,8/12/2019,17
6883,6883,6884,Avai,0,0,0,0,Athletico-PR,0,0,0,0,0,0,0,0,0,8/12/2019,17
6884,6884,6885,Fortaleza,2,0,417,9,Bahia,1,0,308,15,24,725,3,0,3,8/12/2019,17
6885,6885,6886,Fortaleza,3,1,414,14,Athletico-PR,2,0,549,10,24,963,5,1,6,8/8/2020,18
6886,6886,6887,Coritiba,3,0,382,11,Internacional,4,0,504,21,32,886,7,0,7,8/8/2020,18
6887,6887,6888,Sport,3,0,324,15,Ceara,3,0,487,18,33,811,6,0,6,8/8/2020,18
6888,6888,6889,Santos,0,0,444,10,Bragantino,1,0,377,19,29,821,1,0,1,9/8/2020,18
6889,6889,6890,Flamengo,3,0,525,12,Atletico-MG,2,0,321,24,36,846,5,0,5,9/8/2020,18
6890,6890,6891,Gremio,2,0,496,24,Fluminense,3,0,447,16,40,943,5,0,5,9/8/2020,18
6891,6891,6896,Athletico-PR,3,0,728,16,Goias,3,0,196,18,34,924,6,0,6,12/8/2020,18
6892,6892,6897,Atletico-MG,0,0,515,19,Corinthians,1,0,426,11,30,941,1,0,1,12/8/2020,18
6893,6893,6898,Bragantino,3,0,558,13,Botafogo-RJ,1,0,472,8,21,1030,4,0,4,12/8/2020,18
6894,6894,6899,Bahia,0,0,420,16,Coritiba,5,0,486,18,34,906,5,0,5,12/8/2020,18
6895,6895,6900,Atletico-GO,1,0,284,15,Flamengo,1,1,555,19,34,839,2,1,3,12/8/2020,18
6896,6896,6901,Ceara,3,0,421,17,Gremio,1,0,571,7,24,992,4,0,4,12/8/2020,18
6897,6897,6902,Fluminense,3,0,430,20,Palmeiras,3,0,400,31,51,830,6,0,6,12/8/2020,18
6898,6898,6903,Sao Paulo,1,0,474,16,Fortaleza,2,0,443,18,34,917,3,0,3,13/8/2020,18
6899,6899,6904,Internacional,2,0,515,28,Santos,3,0,379,14,42,894,5,0,5,13/8/2020,18
6900,6900,6905,Vasco,2,0,371,29,Sport,3,1,416,17,46,787,5,1,6,13/8/2020,18
6901,6901,6906,Gremio,2,0,491,16,Corinthians,3,0,571,14,30,1062,5,0,5,15/8/2020,18
6902,6902,6907,Coritiba,4,1,286,25,Flamengo,3,0,541,16,41,827,7,1,8,15/8/2020,18
6903,6903,6908,Palmeiras,1,0,668,11,Goias,3,0,369,16,27,1037,4,0,4,15/8/2020,18
6904,6904,6909,Atletico-MG,2,0,475,14,Ceara,4,0,309,16,30,784,6,0,6,16/8/2020,18
6905,6905,6910,Bahia,1,0,381,16,Bragantino,1,0,505,16,32,886,2,0,2,16/8/2020,18
6906,6906,6911,Vasco,2,0,379,16,Sao Paulo,5,0,559,15,31,938,7,0,7,16/8/2020,18
6907,6907,6912,Fluminense,2,0,339,13,Internacional,2,0,433,24,37,772,4,0,4,16/8/2020,18
6908,6908,6913,Atletico-GO,0,1,237,13,Sport,2,0,509,15,28,746,2,1,3,16/8/2020,18
6909,6909,6914,Fortaleza,2,0,561,9,Botafogo-RJ,1,0,392,8,17,953,3,0,3,16/8/2020,18
6910,6910,6915,Santos,1,0,290,9,Athletico-PR,1,0,587,22,31,877,2,0,2,16/8/2020,18
6911,6911,6916,Flamengo,3,0,596,17,Gremio,3,0,390,20,37,986,6,0,6,19/8/2020,18
6912,6912,6917,Bragantino,5,0,438,19,Fluminense,5,0,406,14,33,844,10,0,10,19/8/2020,18
6913,6913,6918,Athletico-PR,5,0,459,23,Palmeiras,0,0,362,20,43,821,5,0,5,19/8/2020,18
6914,6914,6919,Goias,4,0,379,16,Fortaleza,2,0,410,15,31,789,6,0,6,19/8/2020,18
6915,6915,6920,Internacional,3,1,452,19,Atletico-GO,3,0,337,17,36,789,6,1,7,19/8/2020,18
6916,6916,6921,Corinthians,2,0,591,15,Coritiba,1,1,352,7,22,943,3,1,4,19/8/2020,18
6917,6917,6922,Botafogo-RJ,2,0,210,9,Atletico-MG,0,0,609,10,19,819,2,0,2,19/8/2020,18
6918,6918,6923,Sport,5,0,354,23,Santos,2,0,513,17,40,867,7,0,7,20/8/2020,18
6919,6919,6924,Ceara,3,0,484,18,Vasco,3,0,375,14,32,859,6,0,6,20/8/2020,18
6920,6920,6925,Sao Paulo,2,0,634,14,Bahia,2,0,304,16,30,938,4,0,4,20/8/2020,18
6921,6921,6926,Athletico-PR,4,0,610,21,Fluminense,3,0,326,12,33,936,7,0,7,22/8/2020,18
6922,6922,6927,Internacional,1,0,306,20,Atletico-MG,2,0,620,21,41,926,3,0,3,22/8/2020,18
6923,6923,6928,Goias,5,0,275,26,Atletico-GO,2,0,541,19,45,816,7,0,7,22/8/2020,18
6924,6924,6929,Flamengo,3,0,637,15,Botafogo-RJ,3,0,314,17,32,951,6,0,6,23/8/2020,18
6925,6925,6930,Vasco,5,0,414,23,Gremio,2,0,474,17,40,888,7,0,7,23/8/2020,18
6926,6926,6931,Palmeiras,5,0,369,21,Santos,2,1,383,15,36,752,7,1,8,23/8/2020,18
6927,6927,6932,Bragantino,2,1,319,17,Coritiba,0,0,397,18,35,716,2,1,3,23/8/2020,18
6928,6928,6933,Sport,2,0,516,21,Sao Paulo,3,0,425,25,46,941,5,0,5,23/8/2020,18
6929,6929,6934,Ceara,1,0,339,21,Bahia,2,0,538,7,28,877,3,0,3,23/8/2020,18
6930,6930,6935,Corinthians,0,0,584,14,Fortaleza,2,0,405,12,26,989,2,0,2,26/8/2020,18
6931,6931,6936,Sao Paulo,2,0,605,13,Athletico-PR,1,0,464,16,29,1069,3,0,3,26/8/2020,18
6932,6932,6946,Botafogo-RJ,3,0,471,14,Internacional,1,0,542,24,38,1013,4,0,4,29/8/2020,18
6933,6933,6947,Fluminense,4,0,452,19,Vasco,1,1,527,16,35,979,5,1,6,29/8/2020,18
6934,6934,6948,Bahia,2,0,429,15,Palmeiras,2,0,456,16,31,885,4,0,4,29/8/2020,18
6935,6935,6949,Fortaleza,2,0,571,22,Bragantino,2,1,395,10,32,966,4,1,5,29/8/2020,18
6936,6936,6950,Sao Paulo,3,0,442,16,Corinthians,0,0,388,22,38,830,3,0,3,30/8/2020,18
6937,6937,6951,Coritiba,1,0,562,14,Sport,4,0,387,19,33,949,5,0,5,30/8/2020,18
6938,6938,6952,Santos,6,0,429,14,Flamengo,7,0,399,26,40,828,13,0,13,30/8/2020,18
6939,6939,6953,Atletico-GO,1,1,361,16,Ceara,2,0,308,11,27,669,3,1,4,30/8/2020,18
6940,6940,6956,Ceara,2,0,231,22,Fortaleza,2,0,620,18,40,851,4,0,4,2/9/2020,18
6941,6941,6957,Fluminense,2,1,368,14,Atletico-GO,1,0,468,16,30,836,3,1,4,2/9/2020,18
6942,6942,6958,Goias,1,0,446,16,Corinthians,3,0,511,12,28,957,4,0,4,2/9/2020,18
6943,6943,6959,Botafogo-RJ,1,0,519,23,Coritiba,1,0,433,21,44,952,2,0,2,2/9/2020,18
6944,6944,6960,Athletico-PR,2,0,503,15,Bragantino,2,0,354,12,27,857,4,0,4,2/9/2020,18
6945,6945,6961,Bahia,1,0,459,8,Flamengo,2,0,647,17,25,1106,3,0,3,2/9/2020,18
6946,6946,6962,Palmeiras,3,0,372,21,Internacional,5,0,403,23,44,775,8,0,8,2/9/2020,18
6947,6947,6963,Santos,2,0,423,17,Vasco,3,0,267,21,38,690,5,0,5,2/9/2020,18
6948,6948,6964,Gremio,1,0,680,10,Sport,5,0,277,11,21,957,6,0,6,3/9/2020,18
6949,6949,6965,Atletico-MG,0,0,496,18,Sao Paulo,0,0,468,11,29,964,0,0,0,3/9/2020,18
6950,6950,6966,Flamengo,1,0,517,12,Fortaleza,1,0,329,21,33,846,2,0,2,5/9/2020,18
6951,6951,6967,Corinthians,3,0,545,18,Botafogo-RJ,1,0,339,10,28,884,4,0,4,5/9/2020,18
6952,6952,6968,Ceara,2,2,425,21,Santos,4,2,269,16,37,694,6,4,10,5/9/2020,18
6953,6953,6969,Bragantino,1,1,350,23,Palmeiras,3,0,581,12,35,931,4,1,5,6/9/2020,18
6954,6954,6970,Internacional,2,0,528,11,Bahia,3,0,326,12,23,854,5,0,5,6/9/2020,18
6955,6955,6971,Sao Paulo,3,0,463,21,Fluminense,0,0,451,13,34,914,3,0,3,6/9/2020,18
6956,6956,6972,Vasco,1,0,293,7,Athletico-PR,1,0,603,16,23,896,2,0,2,6/9/2020,18
6957,6957,6973,Atletico-GO,1,0,459,16,Gremio,2,1,471,13,29,930,3,1,4,6/9/2020,18
6958,6958,6974,Sport,1,0,486,18,Goias,0,0,453,17,35,939,1,0,1,6/9/2020,18
6959,6959,6975,Coritiba,1,0,440,14,Atletico-MG,3,0,476,19,33,916,4,0,4,6/9/2020,18
6960,6960,6976,Athletico-PR,1,0,509,19,Botafogo-RJ,0,0,310,10,29,819,1,0,1,9/9/2020,18
6961,6961,6977,Fortaleza,5,0,410,27,Sport,1,0,383,14,41,793,6,0,6,9/9/2020,18
6962,6962,6978,Goias,4,1,459,27,Coritiba,2,1,396,13,40,855,6,2,8,9/9/2020,18
6963,6963,6979,Sao Paulo,4,0,491,18,Bragantino,2,0,341,18,36,832,6,0,6,9/9/2020,18
6964,6964,6980,Fluminense,1,0,445,15,Flamengo,1,0,508,16,31,953,2,0,2,9/9/2020,18
6965,6965,6981,Santos,1,0,300,11,Atletico-MG,2,1,424,15,26,724,3,1,4,9/9/2020,18
6966,6966,6982,Internacional,0,0,517,15,Ceara,2,0,317,16,31,834,2,0,2,10/9/2020,18
6967,6967,6983,Corinthians,2,2,517,13,Palmeiras,2,0,437,16,29,954,4,2,6,10/9/2020,18
6968,6968,6984,Bahia,1,1,474,12,Gremio,2,1,479,9,21,953,3,2,5,10/9/2020,18
6969,6969,6985,Vasco,2,1,471,15,Atletico-GO,1,0,380,23,38,851,3,1,4,10/9/2020,18
6970,6970,6986,Athletico-PR,4,0,349,21,Coritiba,0,1,463,12,33,812,4,1,5,12/9/2020,18
6971,6971,6987,Santos,3,0,412,18,Sao Paulo,2,0,338,20,38,750,5,0,5,12/9/2020,18
6972,6972,6988,Fluminense,2,1,352,14,Corinthians,4,0,378,15,29,730,6,1,7,13/9/2020,18
6973,6973,6989,Gremio,1,1,532,11,Fortaleza,2,1,424,13,24,956,3,2,5,13/9/2020,18
6974,6974,6990,Atletico-MG,1,0,556,13,Bragantino,1,0,306,18,31,862,2,0,2,13/9/2020,18
6975,6975,6991,Bahia,2,1,429,16,Atletico-GO,2,0,380,20,36,809,4,1,5,13/9/2020,18
6976,6976,6992,Ceara,1,0,342,8,Flamengo,0,0,570,6,14,912,1,0,1,13/9/2020,18
6977,6977,6993,Goias,4,1,170,10,Internacional,3,0,572,14,24,742,7,1,8,13/9/2020,18
6978,6978,6994,Palmeiras,1,1,567,15,Sport,3,1,327,12,27,894,4,2,6,13/9/2020,18
6979,6979,6995,Botafogo-RJ,2,0,426,18,Vasco,2,0,443,8,26,869,4,0,4,13/9/2020,18
6980,6980,6937,Corinthians,3,0,277,15,Bahia,2,0,533,13,28,810,5,0,5,16/9/2020,18
6981,6981,6938,Fortaleza,1,0,318,9,Internacional,3,0,420,20,29,738,4,0,4,19/9/2020,18
6982,6982,6939,Bragantino,4,0,308,24,Ceara,3,0,417,11,35,725,7,0,7,19/9/2020,18
6983,6983,6940,Atletico-GO,2,0,359,16,Atletico-MG,0,0,468,14,30,827,2,0,2,19/9/2020,18
6984,6984,6941,Gremio,2,0,590,21,Palmeiras,3,0,336,21,42,926,5,0,5,20/9/2020,18
6985,6985,6942,Coritiba,1,0,497,14,Vasco,2,0,415,15,29,912,3,0,3,20/9/2020,18
6986,6986,6943,Botafogo-RJ,4,0,321,15,Santos,2,0,416,13,28,737,6,0,6,20/9/2020,18
6987,6987,6944,Sport,0,0,251,10,Fluminense,1,0,700,9,19,951,1,0,1,20/9/2020,18
6988,6988,6996,Sport,3,0,451,11,Corinthians,4,0,486,15,26,937,7,0,7,23/9/2020,18
6989,6989,6997,Athletico-PR,4,0,528,20,Bahia,1,0,410,11,31,938,5,0,5,26/9/2020,18
6990,6990,6998,Internacional,2,1,401,16,Sao Paulo,0,0,536,16,32,937,2,1,3,26/9/2020,18
6991,6991,6999,Atletico-MG,1,0,478,20,Gremio,1,0,408,11,31,886,2,0,2,26/9/2020,18
6992,6992,7000,Vasco,2,0,511,9,Bragantino,1,0,363,16,25,874,3,0,3,27/9/2020,18
6993,6993,7001,Palmeiras,4,0,493,14,Flamengo,2,0,335,16,30,828,6,0,6,27/9/2020,18
6994,6994,7002,Ceara,3,0,411,13,Goias,4,0,286,14,27,697,7,0,7,27/9/2020,18
6995,6995,7003,Atletico-GO,2,0,406,16,Botafogo-RJ,3,0,359,12,28,765,5,0,5,27/9/2020,18
6996,6996,7004,Santos,1,0,416,12,Fortaleza,1,0,369,20,32,785,2,0,2,27/9/2020,18
6997,6997,7005,Fluminense,1,0,409,16,Coritiba,1,1,532,19,35,941,2,1,3,28/9/2020,18
6998,6998,6892,Corinthians,2,0,461,18,Atletico-GO,0,0,397,12,30,858,2,0,2,30/9/2020,18
6999,6999,6893,Botafogo-RJ,2,1,502,18,Bahia,3,0,322,14,32,824,5,1,6,30/9/2020,18
7000,7000,7006,Gremio,0,1,388,15,Internacional,1,1,453,16,31,841,1,2,3,3/10/2020,18
7001,7001,7007,Palmeiras,1,0,560,10,Ceara,4,0,319,20,30,879,5,0,5,3/10/2020,18
7002,7002,7008,Bragantino,1,0,377,18,Corinthians,2,0,555,13,31,932,3,0,3,3/10/2020,18
7003,7003,7009,Botafogo-RJ,0,0,385,20,Fluminense,1,0,365,21,41,750,1,0,1,4/10/2020,18
7004,7004,7010,Coritiba,2,0,234,13,Sao Paulo,3,0,671,12,25,905,5,0,5,4/10/2020,18
7005,7005,7011,Flamengo,3,0,446,18,Athletico-PR,4,0,376,22,40,822,7,0,7,4/10/2020,18
7006,7006,7012,Fortaleza,5,0,517,8,Atletico-GO,5,0,350,14,22,867,10,0,10,4/10/2020,18
7007,7007,7013,Goias,3,1,384,16,Santos,3,1,317,15,31,701,6,2,8,4/10/2020,18
7008,7008,7014,Bahia,2,0,488,15,Sport,3,0,361,13,28,849,5,0,5,4/10/2020,18
7009,7009,7015,Atletico-MG,0,0,0,0,Vasco,0,0,0,0,0,0,0,0,0,4/10/2020,18
7010,7010,7016,Corinthians,2,0,558,19,Santos,2,0,337,16,35,895,4,0,4,7/10/2020,18
7011,7011,7017,Flamengo,0,0,572,14,Sport,3,0,335,16,30,907,3,0,3,7/10/2020,18
7012,7012,7018,Bahia,4,0,454,18,Vasco,2,1,496,15,33,950,6,1,7,7/10/2020,18
7013,7013,7019,Gremio,2,0,466,18,Coritiba,2,0,475,21,39,941,4,0,4,7/10/2020,18
7014,7014,7020,Sao Paulo,3,0,431,17,Atletico-GO,2,0,415,12,29,846,5,0,5,7/10/2020,18
7015,7015,7021,Goias,3,0,347,19,Fluminense,2,0,472,15,34,819,5,0,5,7/10/2020,18
7016,7016,7022,Botafogo-RJ,4,0,298,16,Palmeiras,4,0,534,15,31,832,8,0,8,7/10/2020,18
7017,7017,7023,Fortaleza,2,1,263,9,Atletico-MG,3,0,577,19,28,840,5,1,6,7/10/2020,18
7018,7018,7024,Athletico-PR,3,0,579,11,Ceara,2,0,350,12,23,929,5,0,5,8/10/2020,18
7019,7019,7025,Bragantino,3,1,404,18,Internacional,3,0,460,22,40,864,6,1,7,8/10/2020,18
7020,7020,7026,Vasco,2,0,344,14,Flamengo,5,0,571,25,39,915,7,0,7,10/10/2020,18
7021,7021,7027,Coritiba,1,0,408,20,Fortaleza,0,0,498,12,32,906,1,0,1,10/10/2020,18
7022,7022,7028,Palmeiras,2,0,424,15,Sao Paulo,1,0,483,17,32,907,3,0,3,10/10/2020,18
7023,7023,7029,Atletico-MG,0,0,614,14,Goias,1,0,315,11,25,929,1,0,1,10/10/2020,18
7024,7024,7030,Fluminense,2,0,401,26,Bahia,3,0,429,18,44,830,5,0,5,11/10/2020,18
7025,7025,7031,Santos,2,0,402,17,Gremio,2,1,314,14,31,716,4,1,5,11/10/2020,18
7026,7026,7032,Sport,3,0,528,11,Botafogo-RJ,1,1,314,15,26,842,4,1,5,11/10/2020,18
7027,7027,7033,Atletico-GO,1,0,368,17,Bragantino,1,0,336,18,35,704,2,0,2,11/10/2020,18
7028,7028,7034,Ceara,4,1,304,9,Corinthians,1,1,475,10,19,779,5,2,7,11/10/2020,18
7029,7029,7035,Internacional,2,0,404,19,Athletico-PR,0,0,483,14,33,887,2,0,2,11/10/2020,18
7030,7030,6945,Flamengo,1,0,562,12,Goias,4,0,299,12,24,861,5,0,5,13/10/2020,18
7031,7031,7036,Palmeiras,3,0,431,13,Coritiba,2,0,382,20,33,813,5,0,5,14/10/2020,18
7032,7032,7037,Gremio,3,1,479,11,Botafogo-RJ,2,0,458,13,24,937,5,1,6,14/10/2020,18
7033,7033,7038,Santos,3,0,400,18,Atletico-GO,3,0,288,21,39,688,6,0,6,14/10/2020,18
7034,7034,7039,Athletico-PR,3,0,545,18,Corinthians,3,1,332,14,32,877,6,1,7,14/10/2020,18
7035,7035,7040,Atletico-MG,3,0,571,11,Fluminense,1,0,295,9,20,866,4,0,4,14/10/2020,18
7036,7036,7041,Sport,3,0,438,6,Internacional,2,0,450,19,25,888,5,0,5,14/10/2020,18
7037,7037,7042,Flamengo,2,0,606,16,Bragantino,1,0,314,14,30,920,3,0,3,15/10/2020,18
7038,7038,7043,Goias,5,0,402,16,Bahia,3,2,403,18,34,805,8,2,10,16/10/2020,18
7039,7039,7046,Atletico-GO,3,2,271,10,Athletico-PR,5,0,454,20,30,725,8,2,10,17/10/2020,18
7040,7040,7047,Coritiba,5,0,442,18,Santos,2,0,341,25,43,783,7,0,7,17/10/2020,18
7041,7041,7048,Fluminense,3,0,539,17,Ceara,3,0,389,16,33,928,6,0,6,17/10/2020,18
7042,7042,7049,Sao Paulo,4,0,534,24,Gremio,2,0,316,15,39,850,6,0,6,17/10/2020,18
7043,7043,7050,Corinthians,4,0,314,14,Flamengo,5,0,530,13,27,844,9,0,9,18/10/2020,18
7044,7044,7051,Internacional,1,0,524,17,Vasco,1,0,482,11,28,1006,2,0,2,18/10/2020,18
7045,7045,7052,Bragantino,2,0,449,13,Sport,2,0,464,13,26,913,4,0,4,18/10/2020,18
7046,7046,7053,Fortaleza,2,0,464,14,Palmeiras,3,1,422,19,33,886,5,1,6,18/10/2020,18
7047,7047,7054,Bahia,4,0,294,14,Atletico-MG,1,0,555,14,28,849,5,0,5,19/10/2020,18
7048,7048,7055,Botafogo-RJ,2,0,533,18,Goias,1,0,326,11,29,859,3,0,3,19/10/2020,18
7049,7049,7056,Vasco,1,0,547,12,Corinthians,2,0,313,18,30,860,3,0,3,21/10/2020,18
7050,7050,7057,Bragantino,0,0,408,17,Goias,3,0,361,15,32,769,3,0,3,24/10/2020,18
7051,7051,7058,Ceara,3,0,270,22,Coritiba,1,0,493,12,34,763,4,0,4,24/10/2020,18
7052,7052,7059,Atletico-MG,1,0,699,10,Sport,0,0,224,11,21,923,1,0,1,24/10/2020,18
7053,7053,7060,Atletico-GO,1,0,474,15,Palmeiras,4,0,360,17,32,834,5,0,5,25/10/2020,18
7054,7054,7061,Fluminense,5,0,275,13,Santos,4,0,301,18,31,576,9,0,9,25/10/2020,18
7055,7055,7062,Athletico-PR,3,0,557,15,Gremio,1,0,291,11,26,848,4,0,4,25/10/2020,18
7056,7056,7063,Internacional,6,0,244,16,Flamengo,5,0,616,16,32,860,11,0,11,25/10/2020,18
7057,7057,7066,Botafogo-RJ,3,1,493,17,Ceara,4,1,314,19,36,807,7,2,9,31/10/2020,18
7058,7058,7067,Coritiba,2,0,248,22,Atletico-GO,5,0,557,18,40,805,7,0,7,31/10/2020,18
7059,7059,7068,Corinthians,4,0,314,16,Internacional,3,1,580,13,29,894,7,1,8,31/10/2020,18
7060,7060,7069,Fortaleza,2,1,387,14,Fluminense,1,0,481,18,32,868,3,1,4,31/10/2020,18
7061,7061,7070,Flamengo,4,0,446,18,Sao Paulo,3,0,396,18,36,842,7,0,7,1/11/2020,18
7062,7062,7071,Sport,2,1,340,17,Athletico-PR,1,0,474,15,32,814,3,1,4,1/11/2020,18
7063,7063,7072,Santos,4,0,463,19,Bahia,2,0,345,13,32,808,6,0,6,1/11/2020,18
7064,7064,7073,Goias,5,0,354,16,Vasco,7,0,401,20,36,755,12,0,12,1/11/2020,18
7065,7065,7074,Palmeiras,2,0,300,10,Atletico-MG,1,0,546,12,22,846,3,0,3,2/11/2020,18
7066,7066,7075,Gremio,1,0,579,13,Bragantino,1,0,466,12,25,1045,2,0,2,2/11/2020,18
7067,7067,7076,Athletico-PR,3,0,482,20,Fortaleza,2,0,297,14,34,779,5,0,5,7/11/2020,18
7068,7068,7077,Sao Paulo,2,0,503,9,Goias,0,1,272,19,28,775,2,1,3,7/11/2020,18
7069,7069,7078,Atletico-GO,3,0,339,22,Corinthians,4,0,421,25,47,760,7,0,7,7/11/2020,18
7070,7070,7079,Vasco,1,0,376,17,Palmeiras,3,0,468,19,36,844,4,0,4,8/11/2020,18
7071,7071,7080,Internacional,2,1,526,9,Coritiba,3,0,369,13,22,895,5,1,6,8/11/2020,18
7072,7072,7081,Bragantino,1,0,413,15,Santos,4,0,448,20,35,861,5,0,5,8/11/2020,18
7073,7073,7082,Atletico-MG,5,0,283,21,Flamengo,4,0,635,13,34,918,9,0,9,8/11/2020,18
7074,7074,7083,Bahia,2,0,499,19,Botafogo-RJ,3,0,361,17,36,860,5,0,5,8/11/2020,18
7075,7075,7084,Fluminense,0,0,569,12,Gremio,1,0,396,13,25,965,1,0,1,8/11/2020,18
7076,7076,7085,Ceara,0,0,441,17,Sport,3,0,392,13,30,833,3,0,3,8/11/2020,18
7077,7077,7064,Bahia,3,0,256,14,Fortaleza,3,0,523,11,25,779,6,0,6,11/11/2020,18
7078,7078,7086,Sport,0,0,573,14,Vasco,2,0,328,21,35,901,2,0,2,14/11/2020,18
7079,7079,7087,Santos,1,0,302,24,Internacional,2,0,479,18,42,781,3,0,3,14/11/2020,18
7080,7080,7088,Goias,5,0,347,14,Athletico-PR,1,0,376,12,26,723,6,0,6,14/11/2020,18
7081,7081,7089,Corinthians,3,0,269,29,Atletico-MG,5,0,544,11,40,813,8,0,8,14/11/2020,18
7082,7082,7090,Fortaleza,2,0,395,15,Sao Paulo,4,0,404,18,33,799,6,0,6,14/11/2020,18
7083,7083,7091,Gremio,1,0,749,8,Ceara,2,0,473,14,22,1222,3,0,3,14/11/2020,18
7084,7084,7092,Palmeiras,2,0,455,15,Fluminense,2,0,440,8,23,895,4,0,4,14/11/2020,18
7085,7085,7093,Flamengo,2,0,559,15,Atletico-GO,1,0,293,16,31,852,3,0,3,14/11/2020,18
7086,7086,7094,Coritiba,3,0,451,12,Bahia,4,0,401,12,24,852,7,0,7,16/11/2020,18
7087,7087,7095,Botafogo-RJ,0,0,439,16,Bragantino,3,0,273,18,34,712,3,0,3,16/11/2020,18
7088,7088,6954,Atletico-MG,1,0,550,8,Athletico-PR,2,0,317,24,32,867,3,0,3,18/11/2020,18
7089,7089,7044,Vasco,2,0,358,11,Fortaleza,0,0,394,20,31,752,2,0,2,19/11/2020,18
7090,7090,7096,Bragantino,2,0,444,16,Bahia,4,0,383,13,29,827,6,0,6,20/11/2020,18
7091,7091,7097,Athletico-PR,0,0,525,22,Santos,2,0,344,13,35,869,2,0,2,21/11/2020,18
7092,7092,7098,Flamengo,1,0,656,16,Coritiba,3,0,402,18,34,1058,4,0,4,21/11/2020,18
7093,7093,7099,Goias,2,0,487,20,Palmeiras,2,1,334,15,35,821,4,1,5,21/11/2020,18
7094,7094,7100,Sao Paulo,2,0,685,7,Vasco,4,0,298,19,26,983,6,0,6,22/11/2020,18
7095,7095,7101,Ceara,4,0,400,11,Atletico-MG,1,1,455,12,23,855,5,1,6,22/11/2020,18
7096,7096,7102,Internacional,2,0,454,20,Fluminense,4,0,455,20,40,909,6,0,6,22/11/2020,18
7097,7097,7103,Botafogo-RJ,1,0,481,18,Fortaleza,1,0,355,15,33,836,2,0,2,22/11/2020,18
7098,7098,7104,Corinthians,1,2,300,12,Gremio,1,0,618,14,26,918,2,2,4,22/11/2020,18
7099,7099,7105,Sport,1,0,431,17,Atletico-GO,3,0,260,16,33,691,4,0,4,23/11/2020,18
7100,7100,7045,Ceara,5,0,303,20,Sao Paulo,3,0,659,13,33,962,8,0,8,25/11/2020,18
7101,7101,7106,Atletico-MG,2,0,463,25,Botafogo-RJ,4,0,397,19,44,860,6,0,6,25/11/2020,18
7102,7102,7107,Coritiba,2,0,462,13,Corinthians,2,0,418,25,38,880,4,0,4,25/11/2020,18
7103,7103,7108,Fortaleza,2,0,619,17,Goias,0,0,266,19,36,885,2,0,2,26/11/2020,18
7104,7104,7109,Palmeiras,2,0,470,16,Athletico-PR,1,0,354,15,31,824,3,0,3,28/11/2020,18
7105,7105,7110,Santos,3,0,421,17,Sport,3,0,293,24,41,714,6,0,6,28/11/2020,18
7106,7106,7111,Bahia,0,0,351,12,Sao Paulo,2,0,597,15,27,948,2,0,2,28/11/2020,18
7107,7107,7112,Atletico-GO,1,0,283,19,Internacional,2,1,400,18,37,683,3,1,4,28/11/2020,18
7108,7108,6955,Gremio,2,0,680,15,Goias,2,0,353,17,32,1033,4,0,4,30/11/2020,18
7109,7109,7113,Vasco,3,0,486,15,Ceara,2,0,230,18,33,716,5,0,5,30/11/2020,18
7110,7110,7114,Fluminense,2,0,361,15,Bragantino,3,0,434,21,36,795,5,0,5,30/11/2020,18
7111,7111,7116,Fortaleza,2,1,343,12,Corinthians,2,1,412,15,27,755,4,2,6,2/12/2020,18
7112,7112,6894,Goias,3,0,324,16,Sao Paulo,0,0,466,19,35,790,3,0,3,3/12/2020,18
7113,7113,7117,Santos,3,0,386,14,Palmeiras,3,1,263,16,30,649,6,1,7,5/12/2020,18
7114,7114,7118,Botafogo-RJ,1,1,293,16,Flamengo,1,1,569,26,42,862,2,2,4,5/12/2020,18
7115,7115,7119,Fluminense,4,0,578,16,Athletico-PR,2,1,254,18,34,832,6,1,7,5/12/2020,18
7116,7116,7120,Bahia,2,0,450,12,Ceara,2,0,412,17,29,862,4,0,4,5/12/2020,18
7117,7117,7121,Coritiba,4,0,334,17,Bragantino,3,0,423,26,43,757,7,0,7,5/12/2020,18
7118,7118,7122,Sao Paulo,4,0,647,17,Sport,4,0,381,17,34,1028,8,0,8,6/12/2020,18
7119,7119,7123,Gremio,2,0,604,9,Vasco,1,0,408,8,17,1012,3,0,3,6/12/2020,18
7120,7120,7124,Atletico-MG,2,0,584,18,Internacional,6,0,315,14,32,899,8,0,8,6/12/2020,18
7121,7121,7125,Atletico-GO,3,0,421,17,Goias,3,0,207,21,38,628,6,0,6,7/12/2020,18
7122,7122,7065,Sao Paulo,0,0,646,12,Botafogo-RJ,2,1,353,8,20,999,2,1,3,9/12/2020,18
7123,7123,7126,Athletico-PR,2,0,353,20,Atletico-MG,2,0,488,13,33,841,4,0,4,12/12/2020,18
7124,7124,7127,Bragantino,3,0,420,17,Fortaleza,2,0,388,18,35,808,5,0,5,12/12/2020,18
7125,7125,7128,Internacional,4,0,416,23,Botafogo-RJ,5,0,445,19,42,861,9,0,9,12/12/2020,18
7126,7126,7129,Palmeiras,2,0,511,11,Bahia,3,0,343,20,31,854,5,0,5,12/12/2020,18
7127,7127,7130,Goias,4,0,298,12,Gremio,1,0,446,10,22,744,5,0,5,12/12/2020,18
7128,7128,7131,Ceara,0,0,344,13,Atletico-GO,3,0,500,15,28,844,3,0,3,12/12/2020,18
7129,7129,7132,Flamengo,2,0,457,12,Santos,1,0,366,11,23,823,3,0,3,13/12/2020,18
7130,7130,7133,Corinthians,0,0,313,12,Sao Paulo,1,0,501,8,20,814,1,0,1,13/12/2020,18
7131,7131,7134,Sport,0,0,447,20,Coritiba,1,0,373,14,34,820,1,0,1,13/12/2020,18
7132,7132,7135,Vasco,6,0,404,21,Fluminense,2,0,516,14,35,920,8,0,8,13/12/2020,18
7133,7133,7136,Sao Paulo,2,0,485,9,Atletico-MG,2,1,533,10,19,1018,4,1,5,16/12/2020,18
7134,7134,7137,Atletico-GO,3,0,278,17,Fluminense,4,0,453,18,35,731,7,0,7,16/12/2020,18
7135,7135,7138,Sport,2,0,402,21,Gremio,1,1,518,9,30,920,3,1,4,19/12/2020,18
7136,7136,7139,Internacional,4,0,327,13,Palmeiras,2,0,440,23,36,767,6,0,6,19/12/2020,18
7137,7137,7140,Coritiba,3,0,344,14,Botafogo-RJ,1,0,409,18,32,753,4,0,4,19/12/2020,18
7138,7138,7141,Bragantino,2,0,506,8,Athletico-PR,5,0,223,17,25,729,7,0,7,20/12/2020,18
7139,7139,7142,Vasco,2,0,255,26,Santos,0,0,453,15,41,708,2,0,2,20/12/2020,18
7140,7140,7143,Flamengo,1,1,379,17,Bahia,3,1,396,22,39,775,4,2,6,20/12/2020,18
7141,7141,7144,Fortaleza,1,1,402,18,Ceara,1,0,266,17,35,668,2,1,3,20/12/2020,18
7142,7142,7145,Corinthians,1,0,537,11,Goias,0,0,304,15,26,841,1,0,1,21/12/2020,18
7143,7143,7146,Atletico-MG,0,0,664,15,Coritiba,0,0,277,13,28,941,0,0,0,26/12/2020,18
7144,7144,7147,Goias,4,0,315,22,Sport,1,0,500,18,40,815,5,0,5,26/12/2020,18
7145,7145,7148,Fortaleza,3,0,293,22,Flamengo,3,0,519,14,36,812,6,0,6,26/12/2020,18
7146,7146,7149,Fluminense,3,0,401,17,Sao Paulo,1,0,579,22,39,980,4,0,4,26/12/2020,18
7147,7147,7150,Botafogo-RJ,1,0,451,19,Corinthians,1,0,508,20,39,959,2,0,2,27/12/2020,18
7148,7148,7151,Bahia,3,0,377,18,Internacional,1,0,357,12,30,734,4,0,4,27/12/2020,18
7149,7149,7152,Athletico-PR,0,0,480,14,Vasco,1,0,373,11,25,853,1,0,1,27/12/2020,18
7150,7150,7153,Palmeiras,3,0,343,10,Bragantino,0,0,486,6,16,829,3,0,3,27/12/2020,18
7151,7151,7154,Santos,2,0,473,15,Ceara,3,0,263,24,39,736,5,0,5,27/12/2020,18
7152,7152,7155,Gremio,2,0,404,11,Atletico-GO,3,0,480,15,26,884,5,0,5,27/12/2020,18
7153,7153,7156,Gremio,2,0,407,11,Bahia,4,0,419,17,28,826,6,0,6,6/1/2021,18
7154,7154,7157,Botafogo-RJ,3,0,506,14,Athletico-PR,2,0,329,21,35,835,5,0,5,6/1/2021,18
7155,7155,7158,Coritiba,4,0,467,13,Goias,3,0,359,17,30,826,7,0,7,6/1/2021,18
7156,7156,7159,Sport,3,0,269,14,Fortaleza,1,0,491,12,26,760,4,0,4,6/1/2021,18
7157,7157,7160,Flamengo,1,0,672,12,Fluminense,4,0,258,22,34,930,5,0,5,6/1/2021,18
7158,7158,7161,Bragantino,2,0,458,17,Sao Paulo,2,1,493,4,21,951,4,1,5,6/1/2021,18
7159,7159,7162,Ceara,6,0,495,18,Internacional,4,0,328,16,34,823,10,0,10,7/1/2021,18
7160,7160,7163,Atletico-GO,3,0,339,19,Vasco,2,0,423,17,36,762,5,0,5,7/1/2021,18
7161,7161,7166,Sport,5,0,518,15,Palmeiras,3,0,366,21,36,884,8,0,8,9/1/2021,18
7162,7162,7167,Coritiba,2,0,389,11,Athletico-PR,1,0,584,10,21,973,3,0,3,9/1/2021,18
7163,7163,7168,Fortaleza,4,0,447,17,Gremio,2,0,366,12,29,813,6,0,6,9/1/2021,18
7164,7164,7169,Sao Paulo,2,0,531,19,Santos,4,0,249,21,40,780,6,0,6,10/1/2021,18
7165,7165,7170,Flamengo,3,0,675,10,Ceara,1,0,233,12,22,908,4,0,4,10/1/2021,18
7166,7166,7171,Atletico-GO,2,0,301,20,Bahia,0,0,424,18,38,725,2,0,2,10/1/2021,18
7167,7167,7172,Internacional,0,0,332,14,Goias,2,0,479,14,28,811,2,0,2,10/1/2021,18
7168,7168,7173,Vasco,1,0,465,11,Botafogo-RJ,0,0,458,13,24,923,1,0,1,10/1/2021,18
7169,7169,7174,Bragantino,4,0,390,15,Atletico-MG,0,0,490,11,26,880,4,0,4,11/1/2021,18
7170,7170,7175,Corinthians,1,0,522,17,Fluminense,2,0,387,15,32,909,3,0,3,13/1/2021,18
7171,7171,7176,Palmeiras,3,0,431,22,Gremio,1,0,530,10,32,961,4,0,4,15/1/2021,18
7172,7172,7177,Fluminense,1,0,540,23,Sport,1,1,276,18,41,816,2,1,3,16/1/2021,18
7173,7173,7178,Vasco,2,1,507,10,Coritiba,2,0,468,13,23,975,4,1,5,16/1/2021,18
7174,7174,7179,Athletico-PR,2,0,376,10,Sao Paulo,1,0,551,14,24,927,3,0,3,17/1/2021,18
7175,7175,7180,Santos,2,0,410,8,Botafogo-RJ,1,0,285,24,32,695,3,0,3,17/1/2021,18
7176,7176,7181,Atletico-MG,2,0,547,13,Atletico-GO,3,0,356,14,27,903,5,0,5,17/1/2021,18
7177,7177,7182,Ceara,1,0,290,13,Bragantino,2,0,494,16,29,784,3,0,3,17/1/2021,18
7178,7178,7183,Internacional,0,0,352,24,Fortaleza,3,0,443,17,41,795,3,0,3,17/1/2021,18
7179,7179,7164,Palmeiras,2,0,430,14,Corinthians,3,1,327,11,25,757,5,1,6,18/1/2021,18
7180,7180,7184,Goias,5,0,357,24,Flamengo,1,0,526,13,37,883,6,0,6,18/1/2021,18
7181,7181,7186,Botafogo-RJ,2,0,365,17,Atletico-GO,3,0,384,14,31,749,5,0,5,20/1/2021,18
7182,7182,7187,Bahia,2,0,347,15,Athletico-PR,0,0,528,14,29,875,2,0,2,20/1/2021,18
7183,7183,7188,Gremio,1,0,637,11,Atletico-MG,1,0,470,7,18,1107,2,0,2,20/1/2021,18
7184,7184,7189,Coritiba,1,1,340,21,Fluminense,4,1,459,10,31,799,5,2,7,20/1/2021,18
7185,7185,7190,Sao Paulo,2,0,624,15,Internacional,1,0,257,19,34,881,3,0,3,20/1/2021,18
7186,7186,7191,Bragantino,0,0,525,12,Vasco,0,0,455,17,29,980,0,0,0,20/1/2021,18
7187,7187,7192,Flamengo,2,0,460,26,Palmeiras,2,0,444,15,41,904,4,0,4,21/1/2021,18
7188,7188,7193,Fortaleza,3,0,340,20,Santos,0,0,378,14,34,718,3,0,3,21/1/2021,18
7189,7189,7194,Goias,1,0,513,12,Ceara,0,0,385,11,23,898,1,0,1,21/1/2021,18
7190,7190,7195,Corinthians,1,0,545,9,Sport,0,0,348,7,16,893,1,0,1,21/1/2021,18
7191,7191,7196,Sao Paulo,1,0,641,19,Coritiba,2,0,367,16,35,1008,3,0,3,23/1/2021,18
7192,7192,7197,Vasco,4,0,234,15,Atletico-MG,1,0,684,11,26,918,5,0,5,23/1/2021,18
7193,7193,7198,Internacional,2,0,382,19,Gremio,2,0,467,15,34,849,4,0,4,24/1/2021,18
7194,7194,7199,Athletico-PR,2,0,384,20,Flamengo,0,0,556,11,31,940,2,0,2,24/1/2021,18
7195,7195,7200,Ceara,2,1,338,9,Palmeiras,5,0,480,16,25,818,7,1,8,24/1/2021,18
7196,7196,7201,Atletico-GO,2,0,329,12,Fortaleza,1,1,395,13,25,724,3,1,4,24/1/2021,18
7197,7197,7202,Sport,3,0,456,16,Bahia,0,0,335,8,24,791,3,0,3,24/1/2021,18
7198,7198,7203,Santos,4,0,476,11,Goias,4,0,269,19,30,745,8,0,8,24/1/2021,18
7199,7199,7204,Fluminense,2,0,394,20,Botafogo-RJ,1,0,435,20,40,829,3,0,3,24/1/2021,18
7200,7200,7205,Corinthians,5,0,546,16,Bragantino,4,0,378,14,30,924,9,0,9,25/1/2021,18
7201,7201,6895,Palmeiras,1,0,477,19,Vasco,1,0,390,11,30,867,2,0,2,26/1/2021,18
7202,7202,7165,Atletico-MG,1,0,665,10,Santos,1,0,341,14,24,1006,2,0,2,26/1/2021,18
7203,7203,7115,Gremio,5,0,548,15,Flamengo,3,0,531,24,39,1079,8,0,8,28/1/2021,18
7204,7204,7185,Bahia,3,0,291,24,Corinthians,1,0,382,19,43,673,4,0,4,28/1/2021,18
7205,7205,7206,Vasco,1,1,400,15,Bahia,3,0,418,16,31,818,4,1,5,31/1/2021,18
7206,7206,7207,Ceara,0,0,379,15,Athletico-PR,2,0,454,18,33,833,2,0,2,31/1/2021,18
7207,7207,7208,Atletico-GO,3,0,335,13,Sao Paulo,1,0,498,9,22,833,4,0,4,31/1/2021,18
7208,7208,7209,Coritiba,3,0,407,26,Gremio,3,0,469,12,38,876,6,0,6,31/1/2021,18
7209,7209,7210,Atletico-MG,0,0,787,16,Fortaleza,1,0,301,15,31,1088,1,0,1,31/1/2021,18
7210,7210,7211,Internacional,3,0,308,11,Bragantino,0,0,538,12,23,846,3,0,3,31/1/2021,18
7211,7211,7212,Fluminense,1,0,372,9,Goias,2,0,490,15,24,862,3,0,3,31/1/2021,18
7212,7212,7213,Sport,2,0,349,15,Flamengo,2,0,563,20,35,912,4,0,4,1/2/2021,18
7213,7213,7214,Palmeiras,2,0,437,16,Botafogo-RJ,1,0,388,10,26,825,3,0,3,2/2/2021,18
7214,7214,7216,Gremio,5,0,539,12,Santos,1,1,313,20,32,852,6,1,7,3/2/2021,18
7215,7215,7217,Bragantino,3,0,414,15,Atletico-GO,3,0,388,7,22,802,6,0,6,3/2/2021,18
7216,7216,7218,Corinthians,0,0,305,18,Ceara,0,0,561,14,32,866,0,0,0,3/2/2021,18
7217,7217,7219,Goias,3,0,249,13,Atletico-MG,3,0,819,13,26,1068,6,0,6,3/2/2021,18
7218,7218,7220,Bahia,1,0,521,15,Fluminense,1,0,435,11,26,956,2,0,2,3/2/2021,18
7219,7219,7221,Fortaleza,2,0,400,18,Coritiba,3,2,345,15,33,745,5,2,7,4/2/2021,18
7220,7220,7222,Flamengo,1,0,530,19,Vasco,3,0,346,15,34,876,4,0,4,4/2/2021,18
7221,7221,7223,Athletico-PR,3,0,587,15,Internacional,2,0,256,20,35,843,5,0,5,4/2/2021,18
7222,7222,7224,Botafogo-RJ,1,0,542,11,Sport,3,0,284,19,30,826,4,0,4,5/2/2021,18
7223,7223,7226,Bahia,3,1,379,18,Goias,4,0,422,13,31,801,7,1,8,6/2/2021,18
7224,7224,7227,Atletico-GO,2,1,233,18,Santos,2,0,493,13,31,726,4,1,5,6/2/2021,18
7225,7225,7228,Bragantino,4,0,360,20,Flamengo,2,0,433,16,36,793,6,0,6,7/2/2021,18
7226,7226,7229,Botafogo-RJ,0,0,409,14,Gremio,0,0,468,18,32,877,0,0,0,8/2/2021,18
7227,7227,7230,Internacional,2,2,530,12,Sport,3,0,377,11,23,907,5,2,7,10/2/2021,18
7228,7228,7231,Fortaleza,2,0,390,15,Vasco,3,0,487,14,29,877,5,0,5,10/2/2021,18
7229,7229,7232,Sao Paulo,4,0,518,11,Ceara,4,0,338,17,28,856,8,0,8,10/2/2021,18
7230,7230,7233,Fluminense,0,0,308,8,Atletico-MG,1,0,848,13,21,1156,1,0,1,10/2/2021,18
7231,7231,7234,Corinthians,3,0,420,19,Athletico-PR,0,0,530,12,31,950,3,0,3,10/2/2021,18
7232,7232,7236,Goias,4,0,415,22,Botafogo-RJ,3,1,351,26,48,766,7,1,8,13/2/2021,18
7233,7233,7237,Atletico-MG,1,0,745,10,Bahia,1,0,298,9,19,1043,2,0,2,13/2/2021,18
7234,7234,7238,Santos,0,0,472,15,Coritiba,4,0,362,16,31,834,4,0,4,13/2/2021,18
7235,7235,7239,Flamengo,1,0,597,21,Corinthians,5,0,307,16,37,904,6,0,6,14/2/2021,18
7236,7236,7240,Vasco,1,0,460,9,Internacional,6,0,257,20,29,717,7,0,7,14/2/2021,18
7237,7237,7241,Athletico-PR,3,0,453,14,Atletico-GO,1,0,306,9,23,759,4,0,4,14/2/2021,18
7238,7238,7242,Palmeiras,0,0,611,16,Fortaleza,3,0,281,11,27,892,3,0,3,14/2/2021,18
7239,7239,7243,Gremio,4,1,520,19,Sao Paulo,4,0,492,18,37,1012,8,1,9,14/2/2021,18
7240,7240,7244,Ceara,1,0,435,18,Fluminense,1,0,429,8,26,864,2,0,2,15/2/2021,18
7241,7241,7245,Sport,3,0,273,8,Bragantino,0,0,580,10,18,853,3,0,3,15/2/2021,18
7242,7242,7215,Santos,0,0,368,24,Corinthians,0,0,417,25,49,785,0,0,0,17/2/2021,18
7243,7243,7235,Coritiba,2,0,381,16,Palmeiras,3,1,434,20,36,815,5,1,6,17/2/2021,18
7244,7244,7225,Sao Paulo,2,0,314,16,Palmeiras,1,0,431,14,30,745,3,0,3,19/2/2021,18
7245,7245,7246,Coritiba,1,0,573,14,Ceara,0,0,336,9,23,909,1,0,1,20/2/2021,18
7246,7246,7247,Fortaleza,3,1,547,15,Bahia,3,0,353,13,28,900,6,1,7,20/2/2021,18
7247,7247,7248,Sport,4,0,372,16,Atletico-MG,4,0,585,13,29,957,8,0,8,21/2/2021,18
7248,7248,7249,Corinthians,1,0,587,23,Vasco,2,0,279,18,41,866,3,0,3,21/2/2021,18
7249,7249,7250,Flamengo,4,0,456,21,Internacional,0,1,302,14,35,758,4,1,5,21/2/2021,18
7250,7250,7251,Santos,3,0,454,20,Fluminense,4,1,281,19,39,735,7,1,8,21/2/2021,18
7251,7251,7252,Gremio,3,0,463,19,Athletico-PR,1,2,465,17,36,928,4,2,6,21/2/2021,18
7252,7252,7253,Goias,2,0,317,18,Bragantino,0,0,405,20,38,722,2,0,2,21/2/2021,18
7253,7253,7254,Palmeiras,2,0,543,20,Atletico-GO,1,0,307,13,33,850,3,0,3,22/2/2021,18
7254,7254,7255,Botafogo-RJ,3,0,428,12,Sao Paulo,5,1,457,15,27,885,8,1,9,22/2/2021,18
7255,7255,7256,Bragantino,4,0,471,24,Gremio,0,0,370,12,36,841,4,0,4,25/2/2021,18
7256,7256,7257,Bahia,0,0,447,11,Santos,0,0,475,13,24,922,0,0,0,25/2/2021,18
7257,7257,7258,Athletico-PR,0,0,480,15,Sport,1,0,362,10,25,842,1,0,1,25/2/2021,18
7258,7258,7259,Atletico-GO,0,0,556,8,Coritiba,1,0,435,9,17,991,1,0,1,25/2/2021,18
7259,7259,7260,Internacional,0,0,418,13,Corinthians,2,0,393,16,29,811,2,0,2,25/2/2021,18
7260,7260,7261,Ceara,2,1,469,7,Botafogo-RJ,0,0,505,4,11,974,2,1,3,25/2/2021,18
7261,7261,7262,Sao Paulo,6,0,305,27,Flamengo,3,0,510,24,51,815,9,0,9,25/2/2021,18
7262,7262,7263,Atletico-MG,3,0,451,22,Palmeiras,0,0,424,17,39,875,3,0,3,25/2/2021,18
7263,7263,7264,Vasco,1,0,390,12,Goias,2,0,405,18,30,795,3,0,3,25/2/2021,18
7264,7264,7265,Fluminense,0,0,401,10,Fortaleza,0,0,422,12,22,823,0,0,0,25/2/2021,18
7265,7265,7266,Cuiaba,1,0,490,14,Juventude,3,0,342,14,28,832,4,0,4,29/5/2021,19
7266,7266,7267,Bahia,3,0,304,18,Santos,3,0,563,9,27,867,6,0,6,29/5/2021,19
7267,7267,7268,Sao Paulo,1,0,636,10,Fluminense,2,0,251,12,22,887,3,0,3,29/5/2021,19
7268,7268,7269,Atletico-MG,2,0,398,16,Fortaleza,4,0,329,19,35,727,6,0,6,30/5/2021,19
7269,7269,7270,Flamengo,2,0,503,25,Palmeiras,3,0,300,21,46,803,5,0,5,30/5/2021,19
7270,7270,7271,Ceara,3,0,277,17,Gremio,3,0,520,18,35,797,6,0,6,30/5/2021,19
7271,7271,7272,Corinthians,5,0,518,18,Atletico-GO,3,0,351,14,32,869,8,0,8,30/5/2021,19
7272,7272,7273,Chapecoense,1,0,428,9,Bragantino,0,0,552,12,21,980,1,0,1,30/5/2021,19
7273,7273,7274,Athletico-PR,1,0,557,18,America-MG,2,0,429,9,27,986,3,0,3,30/5/2021,19
7274,7274,7275,Internacional,4,0,485,24,Sport,2,0,362,15,39,847,6,0,6,30/5/2021,19
7275,7275,7276,Atletico-GO,4,0,291,16,Sao Paulo,5,0,459,14,30,750,9,0,9,5/6/2021,19
7276,7276,7277,Santos,3,0,548,18,Ceara,1,0,419,19,37,967,4,0,4,5/6/2021,19
7277,7277,7278,Bragantino,2,0,442,12,Bahia,4,0,295,13,25,737,6,0,6,5/6/2021,19
7278,7278,7279,Fluminense,2,0,394,22,Cuiaba,1,0,489,15,37,883,3,0,3,6/6/2021,19
7279,7279,7280,America-MG,2,0,483,12,Corinthians,3,0,386,19,31,869,5,0,5,6/6/2021,19
7280,7280,7281,Fortaleza,1,0,378,19,Internacional,4,2,353,21,40,731,5,2,7,6/6/2021,19
7281,7281,7282,Juventude,0,0,519,14,Athletico-PR,2,0,366,27,41,885,2,0,2,6/6/2021,19
7282,7282,7283,Palmeiras,2,0,550,10,Chapecoense,0,0,279,11,21,829,2,0,2,6/6/2021,19
7283,7283,7284,Sport,3,0,448,18,Atletico-MG,2,0,474,15,33,922,5,0,5,6/6/2021,19
7284,7284,7286,Santos,2,0,703,14,Juventude,3,0,236,20,34,939,5,0,5,12/6/2021,19
7285,7285,7287,Palmeiras,3,0,491,14,Corinthians,0,0,458,14,28,949,3,0,3,12/6/2021,19
7286,7286,7288,Atletico-MG,0,0,382,14,Sao Paulo,1,0,514,22,36,896,1,0,1,13/6/2021,19
7287,7287,7289,Gremio,5,0,610,21,Athletico-PR,4,0,350,12,33,960,9,0,9,13/6/2021,19
7288,7288,7290,Flamengo,0,0,672,17,America-MG,0,0,366,18,35,1038,0,0,0,13/6/2021,19
7289,7289,7291,Bahia,4,0,490,14,Internacional,4,1,244,16,30,734,8,1,9,13/6/2021,19
7290,7290,7292,Fortaleza,3,0,480,22,Sport,3,1,337,16,38,817,6,1,7,13/6/2021,19
7291,7291,7293,Bragantino,3,0,390,11,Fluminense,1,0,437,8,19,827,4,0,4,13/6/2021,19
7292,7292,7294,Chapecoense,2,0,308,16,Ceara,2,0,511,14,30,819,4,0,4,13/6/2021,19
7293,7293,7296,Internacional,3,0,561,13,Atletico-MG,1,0,437,13,26,998,4,0,4,16/6/2021,19
7294,7294,7297,Sao Paulo,3,1,423,9,Chapecoense,2,0,419,13,22,842,5,1,6,16/6/2021,19
7295,7295,7298,Corinthians,2,0,367,13,Bragantino,0,0,494,15,28,861,2,0,2,16/6/2021,19
7296,7296,7299,Juventude,0,0,379,11,Palmeiras,3,0,527,24,35,906,3,0,3,16/6/2021,19
7297,7297,7300,America-MG,1,0,413,16,Cuiaba,1,0,322,16,32,735,2,0,2,17/6/2021,19
7298,7298,7301,Ceara,3,0,428,19,Bahia,5,0,271,16,35,699,8,0,8,17/6/2021,19
7299,7299,7302,Sport,5,0,301,16,Gremio,4,0,600,11,27,901,9,0,9,17/6/2021,19
7300,7300,7303,Atletico-GO,3,0,378,18,Fortaleza,1,0,298,13,31,676,4,0,4,17/6/2021,19
7301,7301,7304,Fluminense,4,0,249,14,Santos,3,0,616,9,23,865,7,0,7,17/6/2021,19
7302,7302,7306,Flamengo,2,0,561,15,Bragantino,3,0,272,13,28,833,5,0,5,19/6/2021,19
7303,7303,7307,Palmeiras,3,0,422,15,America-MG,4,0,316,10,25,738,7,0,7,20/6/2021,19
7304,7304,7308,Bahia,1,0,535,10,Corinthians,3,0,505,18,28,1040,4,0,4,20/6/2021,19
7305,7305,7309,Internacional,2,0,407,16,Ceara,3,0,252,23,39,659,5,0,5,20/6/2021,19
7306,7306,7310,Fortaleza,3,0,534,14,Fluminense,0,0,321,17,31,855,3,0,3,20/6/2021,19
7307,7307,7311,Athletico-PR,2,0,440,17,Atletico-GO,2,0,477,15,32,917,4,0,4,20/6/2021,19
7308,7308,7312,Santos,2,0,271,22,Sao Paulo,4,0,413,20,42,684,6,0,6,20/6/2021,19
7309,7309,7313,Juventude,4,0,508,16,Sport,0,0,484,9,25,992,4,0,4,20/6/2021,19
7310,7310,7314,Atletico-MG,1,0,593,9,Chapecoense,1,0,281,10,19,874,2,0,2,21/6/2021,19
7311,7311,7316,Atletico-GO,3,0,390,22,Fluminense,3,0,394,17,39,784,6,0,6,23/6/2021,19
7312,7312,7317,Sao Paulo,1,0,614,18,Cuiaba,1,0,323,14,32,937,2,0,2,23/6/2021,19
7313,7313,7318,Flamengo,1,0,470,18,Fortaleza,1,0,286,15,33,756,2,0,2,23/6/2021,19
7314,7314,7319,Bragantino,3,0,428,13,Palmeiras,3,0,446,13,26,874,6,0,6,23/6/2021,19
7315,7315,7320,America-MG,1,1,459,17,Juventude,2,0,408,16,33,867,3,1,4,24/6/2021,19
7316,7316,7321,Chapecoense,2,1,366,12,Internacional,3,2,345,19,31,711,5,3,8,24/6/2021,19
7317,7317,7322,Corinthians,0,0,502,8,Sport,3,0,475,17,25,977,3,0,3,24/6/2021,19
7318,7318,7323,Ceara,3,0,262,16,Atletico-MG,4,0,541,16,32,803,7,0,7,24/6/2021,19
7319,7319,7324,Bahia,2,0,577,12,Athletico-PR,1,2,256,8,20,833,3,2,5,24/6/2021,19
7320,7320,7325,Gremio,2,0,415,21,Santos,3,0,483,14,35,898,5,0,5,24/6/2021,19
7321,7321,7326,Juventude,2,0,284,17,Flamengo,1,0,510,12,29,794,3,0,3,27/6/2021,19
7322,7322,7327,Fluminense,3,1,449,14,Corinthians,1,0,535,11,25,984,4,1,5,27/6/2021,19
7323,7323,7328,Palmeiras,3,0,437,10,Bahia,4,0,331,16,26,768,7,0,7,27/6/2021,19
7324,7324,7329,Athletico-PR,1,0,519,12,Chapecoense,1,0,313,15,27,832,2,0,2,27/6/2021,19
7325,7325,7330,Gremio,2,1,398,13,Fortaleza,4,0,301,12,25,699,6,1,7,27/6/2021,19
7326,7326,7331,Santos,4,0,406,20,Atletico-MG,2,1,408,16,36,814,6,1,7,27/6/2021,19
7327,7327,7332,America-MG,2,0,309,16,Internacional,3,0,474,20,36,783,5,0,5,27/6/2021,19
7328,7328,7333,Sport,0,0,445,11,Cuiaba,1,0,537,17,28,982,1,0,1,27/6/2021,19
7329,7329,7334,Ceara,4,0,268,20,Sao Paulo,6,0,461,12,32,729,10,0,10,27/6/2021,19
7330,7330,7335,Atletico-GO,2,0,336,24,Bragantino,2,0,468,16,40,804,4,0,4,28/6/2021,19
7331,7331,7336,Fluminense,1,0,517,16,Athletico-PR,2,0,430,15,31,947,3,0,3,30/6/2021,19
7332,7332,7337,Fortaleza,2,1,458,17,Chapecoense,3,0,259,24,41,717,5,1,6,30/6/2021,19
7333,7333,7338,Internacional,3,0,544,14,Palmeiras,2,1,269,13,27,813,5,1,6,30/6/2021,19
7334,7334,7339,Bahia,4,0,605,6,America-MG,0,0,238,9,15,843,4,0,4,30/6/2021,19
7335,7335,7340,Santos,1,0,592,11,Sport,4,0,286,19,30,878,5,0,5,30/6/2021,19
7336,7336,7341,Corinthians,1,0,388,15,Sao Paulo,1,0,559,26,41,947,2,0,2,30/6/2021,19
7337,7337,7342,Juventude,3,0,295,15,Gremio,0,0,689,12,27,984,3,0,3,30/6/2021,19
7338,7338,7343,Bragantino,1,0,532,11,Ceara,2,1,307,17,28,839,3,1,4,1/7/2021,19
7339,7339,7344,Atletico-MG,0,0,480,13,Atletico-GO,2,0,561,12,25,1041,2,0,2,1/7/2021,19
7340,7340,7345,Cuiaba,3,0,418,18,Flamengo,5,0,528,26,44,946,8,0,8,1/7/2021,19
7341,7341,7346,Athletico-PR,3,0,364,18,Fortaleza,3,0,513,14,32,877,6,0,6,3/7/2021,19
7342,7342,7347,America-MG,4,0,245,13,Santos,3,0,636,6,19,881,7,0,7,3/7/2021,19
7343,7343,7348,Corinthians,2,0,540,11,Internacional,2,0,407,17,28,947,4,0,4,3/7/2021,19
7344,7344,7349,Chapecoense,2,0,389,14,Bahia,1,0,452,13,27,841,3,0,3,4/7/2021,19
7345,7345,7350,Flamengo,2,0,579,11,Fluminense,1,0,282,15,26,861,3,0,3,4/7/2021,19
7346,7346,7351,Sport,2,0,414,23,Palmeiras,1,0,436,13,36,850,3,0,3,4/7/2021,19
7347,7347,7352,Ceara,2,0,530,23,Juventude,1,1,302,15,38,832,3,1,4,4/7/2021,19
7348,7348,7353,Sao Paulo,1,0,452,25,Bragantino,2,0,483,14,39,935,3,0,3,4/7/2021,19
7349,7349,7354,Cuiaba,5,0,564,14,Atletico-MG,2,0,387,15,29,951,7,0,7,4/7/2021,19
7350,7350,7355,Gremio,3,0,662,16,Atletico-GO,0,0,405,9,25,1067,3,0,3,4/7/2021,19
7351,7351,7356,Santos,2,0,503,17,Athletico-PR,2,0,428,13,30,931,4,0,4,6/7/2021,19
7352,7352,7357,Bahia,2,0,508,19,Juventude,3,0,468,19,38,976,5,0,5,7/7/2021,19
7353,7353,7358,Bragantino,3,0,436,15,Cuiaba,2,0,388,21,36,824,5,0,5,7/7/2021,19
7354,7354,7359,Fortaleza,2,0,466,18,America-MG,1,0,378,16,34,844,3,0,3,7/7/2021,19
7355,7355,7360,Palmeiras,2,0,429,15,Gremio,2,0,465,16,31,894,4,0,4,7/7/2021,19
7356,7356,7361,Atletico-MG,1,0,501,19,Flamengo,1,0,497,10,29,998,2,0,2,7/7/2021,19
7357,7357,7362,Atletico-GO,4,0,513,16,Sport,1,0,372,9,25,885,5,0,5,7/7/2021,19
7358,7358,7363,Internacional,2,0,416,21,Sao Paulo,3,0,396,24,45,812,5,0,5,7/7/2021,19
7359,7359,7364,Fluminense,2,0,488,24,Ceara,3,0,282,21,45,770,5,0,5,7/7/2021,19
7360,7360,7365,Chapecoense,3,0,397,17,Corinthians,0,0,549,10,27,946,3,0,3,8/7/2021,19
7361,7361,7366,Palmeiras,1,0,280,19,Santos,6,0,498,21,40,778,7,0,7,10/7/2021,19
7362,7362,7367,Gremio,1,0,409,12,Internacional,2,0,401,19,31,810,3,0,3,10/7/2021,19
7363,7363,7368,Athletico-PR,0,0,490,18,Bragantino,4,0,409,16,34,899,4,0,4,10/7/2021,19
7364,7364,7369,Sport,1,0,446,16,Fluminense,3,0,455,13,29,901,4,0,4,10/7/2021,19
7365,7365,7370,Sao Paulo,0,0,566,16,Bahia,1,0,341,15,31,907,1,0,1,10/7/2021,19
7366,7366,7371,America-MG,1,0,386,15,Atletico-MG,1,0,403,17,32,789,2,0,2,10/7/2021,19
7367,7367,7372,Juventude,2,0,454,17,Atletico-GO,2,0,459,23,40,913,4,0,4,11/7/2021,19
7368,7368,7373,Cuiaba,0,1,338,9,Ceara,2,0,479,13,22,817,2,1,3,11/7/2021,19
7369,7369,7374,Flamengo,3,0,661,19,Chapecoense,3,0,262,16,35,923,6,0,6,11/7/2021,19
7370,7370,7375,Fortaleza,4,0,411,13,Corinthians,3,0,529,14,27,940,7,0,7,11/7/2021,19
7371,7371,7376,Ceara,4,0,436,11,Athletico-PR,3,0,386,15,26,822,7,0,7,17/7/2021,19
7372,7372,7377,Sao Paulo,3,0,358,18,Fortaleza,2,0,267,20,38,625,5,0,5,17/7/2021,19
7373,7373,7378,Corinthians,0,0,363,9,Atletico-MG,2,0,602,22,31,965,2,0,2,17/7/2021,19
7374,7374,7379,Fluminense,1,0,549,13,Gremio,4,0,416,12,25,965,5,0,5,17/7/2021,19
7375,7375,7380,Chapecoense,2,0,372,15,Cuiaba,2,0,543,13,28,915,4,0,4,18/7/2021,19
7376,7376,7381,Atletico-GO,2,0,476,8,Palmeiras,1,0,337,16,24,813,3,0,3,18/7/2021,19
7377,7377,7382,Bahia,5,0,332,18,Flamengo,1,0,633,8,26,965,6,0,6,18/7/2021,19
7378,7378,7383,Internacional,4,0,428,19,Juventude,4,1,433,14,33,861,8,1,9,18/7/2021,19
7379,7379,7384,Bragantino,3,0,316,17,Santos,6,0,485,15,32,801,9,0,9,18/7/2021,19
7380,7380,7385,America-MG,1,0,468,19,Sport,3,0,274,22,41,742,4,0,4,19/7/2021,19
7381,7381,7295,Cuiaba,5,0,444,17,Atletico-GO,4,1,346,14,31,790,9,1,10,21/7/2021,19
7382,7382,7386,Gremio,3,0,471,20,America-MG,3,0,432,16,36,903,6,0,6,24/7/2021,19
7383,7383,7387,Palmeiras,1,0,484,13,Fluminense,2,0,476,9,22,960,3,0,3,24/7/2021,19
7384,7384,7388,Atletico-MG,2,0,511,17,Bahia,1,0,331,14,31,842,3,0,3,25/7/2021,19
7385,7385,7389,Fortaleza,4,0,279,21,Bragantino,2,0,513,14,35,792,6,0,6,25/7/2021,19
7386,7386,7390,Flamengo,3,0,428,23,Sao Paulo,6,0,316,16,39,744,9,0,9,25/7/2021,19
7387,7387,7391,Santos,2,0,659,14,Atletico-GO,2,0,242,7,21,901,4,0,4,25/7/2021,19
7388,7388,7392,Athletico-PR,4,0,413,14,Internacional,3,0,373,13,27,786,7,0,7,25/7/2021,19
7389,7389,7393,Sport,4,0,415,12,Ceara,1,0,345,13,25,760,5,0,5,25/7/2021,19
7390,7390,7394,Juventude,5,0,266,16,Chapecoense,1,0,545,15,31,811,6,0,6,26/7/2021,19
7391,7391,7395,Cuiaba,2,1,501,16,Corinthians,1,0,467,12,28,968,3,1,4,26/7/2021,19
7392,7392,7396,Sao Paulo,3,1,403,20,Palmeiras,3,0,350,15,35,753,6,1,7,31/7/2021,19
7393,7393,7397,Internacional,1,1,510,20,Cuiaba,3,0,379,18,38,889,4,1,5,31/7/2021,19
7394,7394,7398,Bragantino,1,0,531,13,Gremio,2,0,473,19,32,1004,3,0,3,31/7/2021,19
7395,7395,7399,Corinthians,1,0,389,7,Flamengo,1,0,742,13,20,1131,2,0,2,1/8/2021,19
7396,7396,7400,Atletico-MG,2,1,616,14,Athletico-PR,3,0,400,12,26,1016,5,1,6,1/8/2021,19
7397,7397,7401,Chapecoense,0,0,361,17,Santos,0,0,458,13,30,819,0,0,0,1/8/2021,19
7398,7398,7402,Bahia,2,0,512,16,Sport,3,0,354,18,34,866,5,0,5,1/8/2021,19
7399,7399,7403,Atletico-GO,4,0,388,21,America-MG,0,0,338,14,35,726,4,0,4,1/8/2021,19
7400,7400,7404,Ceara,2,0,313,13,Fortaleza,3,0,331,12,25,644,5,0,5,1/8/2021,19
7401,7401,7406,Sport,3,0,274,17,Bragantino,1,0,451,14,31,725,4,0,4,6/8/2021,19
7402,7402,7407,Athletico-PR,2,0,427,12,Sao Paulo,4,1,419,16,28,846,6,1,7,7/8/2021,19
7403,7403,7408,Palmeiras,4,1,507,22,Fortaleza,1,1,324,13,35,831,5,2,7,7/8/2021,19
7404,7404,7409,Cuiaba,1,1,315,15,Bahia,2,0,455,17,32,770,3,1,4,7/8/2021,19
7405,7405,7410,Juventude,1,0,310,17,Atletico-MG,3,0,586,14,31,896,4,0,4,8/8/2021,19
7406,7406,7411,America-MG,2,0,365,17,Fluminense,2,0,462,13,30,827,4,0,4,8/8/2021,19
7407,7407,7412,Santos,1,0,561,17,Corinthians,1,0,426,9,26,987,2,0,2,8/8/2021,19
7408,7408,7413,Ceara,2,0,350,18,Atletico-GO,2,0,516,15,33,866,4,0,4,8/8/2021,19
7409,7409,7414,Flamengo,1,1,559,9,Internacional,2,0,331,15,24,890,3,1,4,8/8/2021,19
7410,7410,7415,Gremio,1,0,547,14,Chapecoense,3,0,474,10,24,1021,4,0,4,9/8/2021,19
7411,7411,7416,Bragantino,4,0,456,14,Juventude,4,0,379,14,28,835,8,0,8,14/8/2021,19
7412,7412,7417,Atletico-MG,2,0,658,14,Palmeiras,0,1,322,14,28,980,2,1,3,14/8/2021,19
7413,7413,7418,Sao Paulo,3,0,553,14,Gremio,1,0,312,16,30,865,4,0,4,14/8/2021,19
7414,7414,7419,Flamengo,4,0,637,14,Sport,1,0,348,11,25,985,5,0,5,15/8/2021,19
7415,7415,7420,Corinthians,1,0,631,7,Ceara,1,0,399,16,23,1030,2,0,2,15/8/2021,19
7416,7416,7421,Bahia,2,0,489,18,Atletico-GO,0,0,433,11,29,922,2,0,2,15/8/2021,19
7417,7417,7422,Cuiaba,1,0,331,15,Athletico-PR,1,0,499,20,35,830,2,0,2,15/8/2021,19
7418,7418,7423,Fortaleza,2,0,390,17,Santos,1,0,471,13,30,861,3,0,3,15/8/2021,19
7419,7419,7424,Internacional,2,0,347,14,Fluminense,0,0,622,8,22,969,2,0,2,15/8/2021,19
7420,7420,7425,Chapecoense,1,1,300,10,America-MG,1,0,402,11,21,702,2,1,3,16/8/2021,19
7421,7421,7315,Cuiaba,1,0,415,12,Gremio,5,0,370,10,22,785,6,0,6,18/8/2021,19
7422,7422,7426,Atletico-GO,2,1,559,13,Chapecoense,5,0,234,24,37,793,7,1,8,21/8/2021,19
7423,7423,7427,Gremio,1,0,489,12,Bahia,1,0,425,15,27,914,2,0,2,21/8/2021,19
7424,7424,7428,Juventude,1,0,495,8,Fortaleza,1,0,395,9,17,890,2,0,2,21/8/2021,19
7425,7425,7429,Palmeiras,1,0,544,8,Cuiaba,1,0,306,14,22,850,2,0,2,22/8/2021,19
7426,7426,7430,Ceara,0,0,338,13,Flamengo,2,0,582,12,25,920,2,0,2,22/8/2021,19
7427,7427,7431,Athletico-PR,1,1,479,12,Corinthians,0,0,599,7,19,1078,1,1,2,22/8/2021,19
7428,7428,7432,Santos,2,0,434,19,Internacional,2,0,406,14,33,840,4,0,4,22/8/2021,19
7429,7429,7433,Sport,2,0,382,15,Sao Paulo,2,0,422,17,32,804,4,0,4,22/8/2021,19
7430,7430,7434,America-MG,2,0,440,14,Bragantino,0,0,449,15,29,889,2,0,2,23/8/2021,19
7431,7431,7435,Fluminense,3,0,306,16,Atletico-MG,3,0,602,16,32,908,6,0,6,23/8/2021,19
7432,7432,7436,Sport,0,1,415,17,Chapecoense,1,0,354,17,34,769,1,1,2,28/8/2021,19
7433,7433,7437,Santos,4,0,445,14,Flamengo,4,0,456,14,28,901,8,0,8,28/8/2021,19
7434,7434,7438,Gremio,1,1,462,17,Corinthians,2,0,593,7,24,1055,3,1,4,28/8/2021,19
7435,7435,7439,Palmeiras,3,0,459,10,Athletico-PR,0,0,489,16,26,948,3,0,3,28/8/2021,19
7436,7436,7440,America-MG,1,0,285,19,Ceara,2,0,481,13,32,766,3,0,3,29/8/2021,19
7437,7437,7441,Juventude,2,0,298,15,Sao Paulo,5,0,460,21,36,758,7,0,7,29/8/2021,19
7438,7438,7442,Atletico-GO,1,0,429,13,Internacional,2,0,397,15,28,826,3,0,3,29/8/2021,19
7439,7439,7443,Bragantino,3,0,333,16,Atletico-MG,4,0,653,18,34,986,7,0,7,29/8/2021,19
7440,7440,7444,Fluminense,2,0,391,19,Bahia,4,0,398,21,40,789,6,0,6,30/8/2021,19
7441,7441,7445,Fortaleza,2,0,539,15,Cuiaba,5,0,307,17,32,846,7,0,7,30/8/2021,19
7442,7442,7405,Fluminense,2,0,579,23,Juventude,1,0,330,18,41,909,3,0,3,2/9/2021,19
7443,7443,7446,Bahia,3,0,315,25,Fortaleza,1,0,467,7,32,782,4,0,4,4/9/2021,19
7444,7444,7447,Cuiaba,3,0,330,11,Santos,1,0,551,11,22,881,4,0,4,4/9/2021,19
7445,7445,7448,Athletico-PR,1,0,481,10,Sport,1,1,346,9,19,827,2,1,3,5/9/2021,19
7446,7446,7449,Corinthians,3,0,628,15,Juventude,4,0,437,20,35,1065,7,0,7,7/9/2021,19
7447,7447,7450,Chapecoense,0,0,519,18,Fluminense,0,0,439,4,22,958,0,0,0,7/9/2021,19
7448,7448,7456,America-MG,1,0,426,14,Athletico-PR,1,0,350,17,31,776,2,0,2,11/9/2021,19
7449,7449,7457,Juventude,3,0,560,12,Cuiaba,4,1,349,13,25,909,7,1,8,11/9/2021,19
7450,7450,7458,Bragantino,4,1,501,17,Chapecoense,2,0,387,13,30,888,6,1,7,11/9/2021,19
7451,7451,7459,Santos,1,0,566,16,Bahia,4,0,312,20,36,878,5,0,5,11/9/2021,19
7452,7452,7460,Gremio,0,0,359,22,Ceara,0,0,508,9,31,867,0,0,0,12/9/2021,19
7453,7453,7461,Fortaleza,1,0,451,13,Atletico-MG,2,0,488,18,31,939,3,0,3,12/9/2021,19
7454,7454,7462,Palmeiras,0,1,509,14,Flamengo,2,0,379,15,29,888,2,1,3,12/9/2021,19
7455,7455,7463,Atletico-GO,4,0,481,10,Corinthians,2,0,444,10,20,925,6,0,6,12/9/2021,19
7456,7456,7464,Fluminense,5,0,309,16,Sao Paulo,4,0,417,16,32,726,9,0,9,12/9/2021,19
7457,7457,7465,Sport,4,0,434,21,Internacional,1,0,449,20,41,883,5,0,5,13/9/2021,19
7458,7458,7466,Chapecoense,2,0,461,16,Palmeiras,2,0,419,14,30,880,4,0,4,18/9/2021,19
7459,7459,7467,Athletico-PR,5,0,479,18,Juventude,1,1,341,7,25,820,6,1,7,18/9/2021,19
7460,7460,7468,Atletico-MG,2,0,560,18,Sport,3,0,367,13,31,927,5,0,5,18/9/2021,19
7461,7461,7469,Bahia,1,0,372,16,Bragantino,4,0,528,13,29,900,5,0,5,18/9/2021,19
7462,7462,7470,Ceara,3,0,390,17,Santos,2,0,390,13,30,780,5,0,5,18/9/2021,19
7463,7463,7471,Internacional,3,1,497,12,Fortaleza,1,1,358,15,27,855,4,2,6,19/9/2021,19
7464,7464,7472,Sao Paulo,1,0,443,18,Atletico-GO,2,0,410,11,29,853,3,0,3,19/9/2021,19
7465,7465,7473,Corinthians,1,1,656,8,America-MG,0,0,350,13,21,1006,1,1,2,19/9/2021,19
7466,7466,7474,Flamengo,3,0,534,16,Gremio,4,0,330,17,33,864,7,0,7,19/9/2021,19
7467,7467,7475,Cuiaba,2,1,476,15,Fluminense,2,0,334,16,31,810,4,1,5,20/9/2021,19
7468,7468,7451,Sao Paulo,3,0,452,17,America-MG,1,0,322,18,35,774,4,0,4,22/9/2021,19
7469,7469,7476,Ceara,0,0,485,8,Chapecoense,2,1,339,18,26,824,2,1,3,25/9/2021,19
7470,7470,7477,Corinthians,1,0,423,8,Palmeiras,1,0,430,11,19,853,2,0,2,25/9/2021,19
7471,7471,7478,Sao Paulo,1,0,495,14,Atletico-MG,1,0,501,12,26,996,2,0,2,25/9/2021,19
7472,7472,7479,America-MG,1,0,369,9,Flamengo,1,0,505,12,21,874,2,0,2,26/9/2021,19
7473,7473,7480,Internacional,2,0,503,19,Bahia,2,0,347,15,34,850,4,0,4,26/9/2021,19
7474,7474,7481,Fluminense,2,0,404,11,Bragantino,2,0,521,19,30,925,4,0,4,26/9/2021,19
7475,7475,7482,Juventude,3,0,325,15,Santos,0,0,534,16,31,859,3,0,3,26/9/2021,19
7476,7476,7483,Sport,5,0,452,19,Fortaleza,2,0,363,14,33,815,7,0,7,26/9/2021,19
7477,7477,7484,Athletico-PR,1,0,514,17,Gremio,5,0,437,18,35,951,6,0,6,26/9/2021,19
7478,7478,7485,Atletico-GO,1,0,395,10,Cuiaba,4,0,312,16,26,707,5,0,5,26/9/2021,19
7479,7479,7486,Cuiaba,1,0,368,13,America-MG,2,0,322,20,33,690,3,0,3,2/10/2021,19
7480,7480,7487,Fortaleza,1,0,466,14,Atletico-GO,4,0,219,20,34,685,5,0,5,2/10/2021,19
7481,7481,7488,Bragantino,0,0,349,10,Corinthians,0,0,595,6,16,944,0,0,0,2/10/2021,19
7482,7482,7489,Atletico-MG,4,0,490,16,Internacional,2,0,371,15,31,861,6,0,6,2/10/2021,19
7483,7483,7490,Flamengo,2,0,777,13,Athletico-PR,2,0,295,14,27,1072,4,0,4,3/10/2021,19
7484,7484,7491,Chapecoense,1,0,345,11,Sao Paulo,1,0,571,11,22,916,2,0,2,3/10/2021,19
7485,7485,7492,Palmeiras,1,0,602,19,Juventude,1,0,215,13,32,817,2,0,2,3/10/2021,19
7486,7486,7493,Gremio,2,0,520,21,Sport,1,0,293,18,39,813,3,0,3,3/10/2021,19
7487,7487,7496,Corinthians,0,0,731,14,Bahia,0,1,288,18,32,1019,0,1,1,5/10/2021,19
7488,7488,7497,Chapecoense,2,0,282,12,Atletico-MG,1,0,551,17,29,833,3,0,3,6/10/2021,19
7489,7489,7498,Atletico-GO,3,0,487,12,Athletico-PR,3,0,324,16,28,811,6,0,6,6/10/2021,19
7490,7490,7499,Sport,2,0,468,11,Juventude,2,0,572,11,22,1040,4,0,4,6/10/2021,19
7491,7491,7500,Ceara,5,0,337,22,Internacional,2,0,373,16,38,710,7,0,7,6/10/2021,19
7492,7492,7501,Bragantino,1,0,324,13,Flamengo,3,0,441,20,33,765,4,0,4,6/10/2021,19
7493,7493,7502,Fluminense,2,0,461,13,Fortaleza,2,0,403,16,29,864,4,0,4,6/10/2021,19
7494,7494,7503,America-MG,2,0,436,14,Palmeiras,3,0,301,17,31,737,5,0,5,6/10/2021,19
7495,7495,7504,Gremio,2,0,571,15,Cuiaba,2,0,360,10,25,931,4,0,4,6/10/2021,19
7496,7496,7505,Sao Paulo,2,0,431,19,Santos,4,0,300,13,32,731,6,0,6,7/10/2021,19
7497,7497,7506,Fluminense,2,0,419,15,Atletico-GO,2,0,389,17,32,808,4,0,4,9/10/2021,19
7498,7498,7507,Atletico-MG,1,0,428,12,Ceara,3,0,352,10,22,780,4,0,4,9/10/2021,19
7499,7499,7508,Sport,3,0,340,14,Corinthians,0,0,707,7,21,1047,3,0,3,9/10/2021,19
7500,7500,7509,Fortaleza,0,1,343,10,Flamengo,2,0,522,17,27,865,2,1,3,9/10/2021,19
7501,7501,7510,Athletico-PR,1,0,482,14,Bahia,2,0,347,9,23,829,3,0,3,9/10/2021,19
7502,7502,7511,Palmeiras,1,0,457,14,Bragantino,2,0,379,15,29,836,3,0,3,9/10/2021,19
7503,7503,7512,Juventude,6,0,428,24,America-MG,3,0,303,26,50,731,9,0,9,9/10/2021,19
7504,7504,7513,Internacional,3,0,434,16,Chapecoense,1,0,422,14,30,856,4,0,4,10/10/2021,19
7505,7505,7514,Santos,4,0,446,14,Gremio,5,1,319,25,39,765,9,1,10,10/10/2021,19
7506,7506,7515,Cuiaba,2,0,299,14,Sao Paulo,2,0,568,16,30,867,4,0,4,11/10/2021,19
7507,7507,7516,Bragantino,1,1,308,12,Atletico-GO,4,0,483,13,25,791,5,1,6,12/10/2021,19
7508,7508,7517,Bahia,4,0,375,22,Palmeiras,2,1,374,13,35,749,6,1,7,12/10/2021,19
7509,7509,7518,Atletico-MG,2,0,500,10,Santos,7,0,336,13,23,836,9,0,9,13/10/2021,19
7510,7510,7519,Chapecoense,4,0,313,17,Athletico-PR,5,0,512,13,30,825,9,0,9,13/10/2021,19
7511,7511,7520,Flamengo,2,0,553,17,Juventude,3,0,311,14,31,864,5,0,5,13/10/2021,19
7512,7512,7521,Fortaleza,2,0,393,13,Gremio,2,0,439,17,30,832,4,0,4,13/10/2021,19
7513,7513,7522,Corinthians,1,0,568,4,Fluminense,1,0,503,9,13,1071,2,0,2,13/10/2021,19
7514,7514,7523,Internacional,1,0,355,21,America-MG,2,0,370,23,44,725,3,0,3,13/10/2021,19
7515,7515,7524,Sao Paulo,3,0,422,18,Ceara,3,0,236,14,32,658,6,0,6,14/10/2021,19
7516,7516,7525,Cuiaba,4,0,491,14,Sport,0,0,394,8,22,885,4,0,4,14/10/2021,19
7517,7517,7526,Chapecoense,3,0,291,20,Fortaleza,1,0,498,12,32,789,4,0,4,16/10/2021,19
7518,7518,7527,America-MG,1,0,382,12,Bahia,2,0,320,22,34,702,3,0,3,16/10/2021,19
7519,7519,7528,Athletico-PR,2,0,439,22,Fluminense,1,0,420,15,37,859,3,0,3,17/10/2021,19
7520,7520,7529,Palmeiras,3,0,449,13,Internacional,4,1,423,21,34,872,7,1,8,17/10/2021,19
7521,7521,7530,Ceara,2,0,458,13,Bragantino,7,0,326,14,27,784,9,0,9,17/10/2021,19
7522,7522,7531,Gremio,1,0,492,24,Juventude,3,0,408,15,39,900,4,0,4,17/10/2021,19
7523,7523,7532,Atletico-GO,1,0,335,8,Atletico-MG,0,0,593,7,15,928,1,0,1,17/10/2021,19
7524,7524,7533,Sport,1,0,385,14,Santos,3,0,461,11,25,846,4,0,4,17/10/2021,19
7525,7525,7534,Flamengo,1,0,691,12,Cuiaba,1,0,303,7,19,994,2,0,2,17/10/2021,19
7526,7526,7535,Sao Paulo,3,0,420,21,Corinthians,2,0,500,8,29,920,5,0,5,18/10/2021,19
7527,7527,7452,Ceara,4,0,368,19,Palmeiras,2,0,427,11,30,795,6,0,6,20/10/2021,19
7528,7528,7453,Internacional,5,0,353,18,Bragantino,2,0,473,13,31,826,7,0,7,21/10/2021,19
7529,7529,7536,Santos,1,1,431,10,America-MG,2,0,441,12,22,872,3,1,4,23/10/2021,19
7530,7530,7537,Juventude,1,0,496,15,Ceara,2,0,294,20,35,790,3,0,3,23/10/2021,19
7531,7531,7538,Fluminense,6,0,206,22,Flamengo,3,0,543,16,38,749,9,0,9,23/10/2021,19
7532,7532,7539,Fortaleza,2,0,442,13,Athletico-PR,2,0,365,12,25,807,4,0,4,23/10/2021,19
7533,7533,7540,Internacional,3,1,482,23,Corinthians,3,1,514,11,34,996,6,2,8,24/10/2021,19
7534,7534,7541,Atletico-MG,0,0,487,12,Cuiaba,0,0,428,13,25,915,0,0,0,24/10/2021,19
7535,7535,7542,Bragantino,3,0,357,14,Sao Paulo,0,0,441,19,33,798,3,0,3,24/10/2021,19
7536,7536,7543,Bahia,1,0,519,6,Chapecoense,1,0,450,11,17,969,2,0,2,24/10/2021,19
7537,7537,7544,Atletico-GO,2,0,360,11,Gremio,7,1,404,17,28,764,9,1,10,25/10/2021,19
7538,7538,7545,Palmeiras,1,0,472,10,Sport,3,0,284,20,30,756,4,0,4,25/10/2021,19
7539,7539,7494,Santos,2,0,385,18,Fluminense,2,0,468,10,28,853,4,0,4,27/10/2021,19
7540,7540,7495,Bahia,3,0,410,19,Ceara,1,1,352,13,32,762,4,1,5,27/10/2021,19
7541,7541,7546,Bragantino,3,0,387,17,Sport,6,0,472,14,31,859,9,0,9,28/10/2021,19
7542,7542,7556,Athletico-PR,1,0,584,11,Santos,2,0,305,9,20,889,3,0,3,30/10/2021,19
7543,7543,7557,Flamengo,4,0,269,22,Atletico-MG,2,0,453,19,41,722,6,0,6,30/10/2021,19
7544,7544,7558,Juventude,2,0,475,13,Bahia,1,0,326,17,30,801,3,0,3,30/10/2021,19
7545,7545,7559,America-MG,0,0,335,13,Fortaleza,5,0,401,19,32,736,5,0,5,30/10/2021,19
7546,7546,7560,Gremio,5,0,397,26,Palmeiras,2,0,410,12,38,807,7,0,7,31/10/2021,19
7547,7547,7561,Ceara,4,1,217,8,Fluminense,2,0,546,7,15,763,6,1,7,31/10/2021,19
7548,7548,7562,Sao Paulo,0,0,494,17,Internacional,2,0,457,13,30,951,2,0,2,31/10/2021,19
7549,7549,7563,Sport,4,0,403,15,Atletico-GO,3,0,429,13,28,832,7,0,7,31/10/2021,19
7550,7550,7564,Cuiaba,2,0,484,8,Bragantino,3,0,363,16,24,847,5,0,5,1/11/2021,19
7551,7551,7565,Corinthians,1,0,746,12,Chapecoense,4,0,200,19,31,946,5,0,5,1/11/2021,19
7552,7552,7305,Athletico-PR,4,0,407,8,Flamengo,2,0,311,15,23,718,6,0,6,2/11/2021,19
7553,7553,7454,Atletico-MG,5,0,445,10,Gremio,6,0,388,14,24,833,11,0,11,3/11/2021,19
7554,7554,7566,Cuiaba,1,0,480,13,Chapecoense,1,0,385,15,28,865,2,0,2,4/11/2021,19
7555,7555,7455,Flamengo,2,0,480,10,Atletico-GO,1,0,443,15,25,923,3,0,3,5/11/2021,19
7556,7556,7576,Corinthians,3,0,501,18,Fortaleza,3,0,367,26,44,868,6,0,6,6/11/2021,19
7557,7557,7577,Internacional,1,1,296,19,Gremio,3,1,451,17,36,747,4,2,6,6/11/2021,19
7558,7558,7578,Fluminense,1,0,534,11,Sport,1,0,325,12,23,859,2,0,2,6/11/2021,19
7559,7559,7579,Bragantino,2,0,452,16,Athletico-PR,3,0,337,25,41,789,5,0,5,7/11/2021,19
7560,7560,7580,Atletico-MG,3,0,479,21,America-MG,2,0,372,10,31,851,5,0,5,7/11/2021,19
7561,7561,7581,Santos,3,0,426,14,Palmeiras,2,0,453,17,31,879,5,0,5,7/11/2021,19
7562,7562,7582,Bahia,1,0,378,11,Sao Paulo,2,0,521,18,29,899,3,0,3,7/11/2021,19
7563,7563,7583,Ceara,3,0,333,15,Cuiaba,1,0,347,13,28,680,4,0,4,7/11/2021,19
7564,7564,7584,Chapecoense,2,1,302,14,Flamengo,3,1,452,11,25,754,5,2,7,8/11/2021,19
7565,7565,7567,Gremio,3,0,445,18,Fluminense,1,0,513,9,27,958,4,0,4,9/11/2021,19
7566,7566,7568,Athletico-PR,4,0,429,9,Ceara,3,1,407,10,19,836,7,1,8,10/11/2021,19
7567,7567,7569,Atletico-MG,2,0,434,20,Corinthians,2,0,493,4,24,927,4,0,4,10/11/2021,19
7568,7568,7570,Santos,2,0,361,11,Bragantino,1,0,478,10,21,839,3,0,3,10/11/2021,19
7569,7569,7571,Palmeiras,1,0,443,10,Atletico-GO,3,0,442,13,23,885,4,0,4,10/11/2021,19
7570,7570,7572,Fortaleza,4,0,333,15,Sao Paulo,5,0,471,11,26,804,9,0,9,10/11/2021,19
7571,7571,7573,Sport,2,1,346,11,America-MG,3,0,497,14,25,843,5,1,6,10/11/2021,19
7572,7572,7574,Juventude,2,0,416,19,Internacional,4,0,483,15,34,899,6,0,6,10/11/2021,19
7573,7573,7575,Flamengo,0,1,557,14,Bahia,1,2,268,9,23,825,1,3,4,11/11/2021,19
7574,7574,7586,Atletico-GO,2,0,423,13,Santos,3,0,233,13,26,656,5,0,5,13/11/2021,19
7575,7575,7587,America-MG,3,0,362,14,Gremio,1,0,515,16,30,877,4,0,4,13/11/2021,19
7576,7576,7588,Bragantino,3,0,356,25,Fortaleza,4,0,437,12,37,793,7,0,7,13/11/2021,19
7577,7577,7589,Internacional,7,0,380,17,Athletico-PR,3,0,423,13,30,803,10,0,10,13/11/2021,19
7578,7578,7590,Corinthians,1,0,536,15,Cuiaba,1,0,444,9,24,980,2,0,2,13/11/2021,19
7579,7579,7591,Sao Paulo,1,1,375,6,Flamengo,1,0,549,9,15,924,2,1,3,14/11/2021,19
7580,7580,7592,Fluminense,3,1,480,12,Palmeiras,4,2,443,20,32,923,7,3,10,14/11/2021,19
7581,7581,7593,Ceara,1,0,291,12,Sport,2,0,472,17,29,763,3,0,3,14/11/2021,19
7582,7582,7594,Chapecoense,3,0,473,15,Juventude,3,0,408,17,32,881,6,0,6,14/11/2021,19
7583,7583,7596,Athletico-PR,1,0,408,15,Atletico-MG,2,0,520,14,29,928,3,0,3,16/11/2021,19
7584,7584,7597,Gremio,0,0,451,15,Bragantino,2,0,417,17,32,868,2,0,2,16/11/2021,19
7585,7585,7598,America-MG,1,0,498,7,Atletico-GO,1,0,353,14,21,851,2,0,2,17/11/2021,19
7586,7586,7599,Santos,1,0,395,14,Chapecoense,2,0,523,14,28,918,3,0,3,17/11/2021,19
7587,7587,7600,Cuiaba,4,0,408,14,Internacional,1,0,429,17,31,837,5,0,5,17/11/2021,19
7588,7588,7601,Fortaleza,1,0,402,14,Ceara,4,0,239,14,28,641,5,0,5,17/11/2021,19
7589,7589,7602,Palmeiras,1,0,422,12,Sao Paulo,2,0,342,19,31,764,3,0,3,17/11/2021,19
7590,7590,7603,Juventude,2,0,309,20,Fluminense,1,0,619,19,39,928,3,0,3,17/11/2021,19
7591,7591,7604,Flamengo,1,0,493,15,Corinthians,2,0,390,8,23,883,3,0,3,17/11/2021,19
7592,7592,7605,Sport,1,0,369,19,Bahia,3,0,498,14,33,867,4,0,4,18/11/2021,19
7593,7593,7547,Atletico-MG,1,0,588,20,Juventude,2,0,387,13,33,975,3,0,3,20/11/2021,19
7594,7594,7548,Fortaleza,3,0,267,22,Palmeiras,2,0,528,12,34,795,5,0,5,20/11/2021,19
7595,7595,7549,Chapecoense,1,0,308,19,Gremio,1,0,518,18,37,826,2,0,2,20/11/2021,19
7596,7596,7550,Atletico-GO,0,0,459,10,Ceara,3,0,320,21,31,779,3,0,3,20/11/2021,19
7597,7597,7551,Internacional,2,0,452,14,Flamengo,1,0,439,13,27,891,3,0,3,20/11/2021,19
7598,7598,7552,Corinthians,1,0,640,6,Santos,0,0,344,8,14,984,1,0,1,21/11/2021,19
7599,7599,7553,Fluminense,1,0,384,21,America-MG,2,0,415,17,38,799,3,0,3,21/11/2021,19
7600,7600,7554,Bahia,1,0,470,12,Cuiaba,0,0,391,9,21,861,1,0,1,21/11/2021,19
7601,7601,7285,Gremio,2,2,427,14,Flamengo,2,0,433,14,28,860,4,2,6,23/11/2021,19
7602,7602,7585,Atletico-GO,1,0,434,19,Juventude,2,0,431,16,35,865,3,0,3,23/11/2021,19
7603,7603,7606,Palmeiras,4,0,314,16,Atletico-MG,3,0,410,22,38,724,7,0,7,23/11/2021,19
7604,7604,7555,Sao Paulo,3,0,597,14,Athletico-PR,2,0,252,15,29,849,5,0,5,24/11/2021,19
7605,7605,7607,Fluminense,5,0,262,20,Internacional,5,1,583,18,38,845,10,1,11,24/11/2021,19
7606,7606,7608,Santos,3,0,424,15,Fortaleza,2,0,331,15,30,755,5,0,5,25/11/2021,19
7607,7607,7609,Ceara,3,0,337,16,Corinthians,4,0,565,13,29,902,7,0,7,25/11/2021,19
7608,7608,7616,Bahia,3,0,236,15,Gremio,3,0,442,15,30,678,6,0,6,26/11/2021,19
7609,7609,7617,Bragantino,3,0,357,21,America-MG,2,0,353,14,35,710,5,0,5,27/11/2021,19
7610,7610,7618,Sao Paulo,0,0,395,16,Sport,1,0,402,14,30,797,1,0,1,27/11/2021,19
7611,7611,7619,Corinthians,5,0,660,14,Athletico-PR,3,0,334,19,33,994,8,0,8,28/11/2021,19
7612,7612,7620,Atletico-MG,6,0,305,22,Fluminense,3,0,334,18,40,639,9,0,9,28/11/2021,19
7613,7613,7621,Internacional,1,0,478,16,Santos,2,0,412,17,33,890,3,0,3,28/11/2021,19
7614,7614,7610,Atletico-GO,5,0,358,16,Bahia,2,1,364,20,36,722,7,1,8,29/11/2021,19
7615,7615,7611,Juventude,3,0,334,15,Bragantino,3,0,376,25,40,710,6,0,6,30/11/2021,19
7616,7616,7612,America-MG,2,0,409,10,Chapecoense,2,0,369,11,21,778,4,0,4,30/11/2021,19
7617,7617,7622,Flamengo,6,0,427,20,Ceara,1,0,410,19,39,837,7,0,7,30/11/2021,19
7618,7618,7623,Cuiaba,4,0,455,15,Palmeiras,1,1,337,10,25,792,5,1,6,30/11/2021,19
7619,7619,7595,Bahia,2,0,387,13,Atletico-MG,3,0,425,12,25,812,5,0,5,2/12/2021,19
7620,7620,7613,Gremio,3,0,398,17,Sao Paulo,2,0,488,13,30,886,5,0,5,2/12/2021,19
7621,7621,7614,Athletico-PR,4,0,502,15,Cuiaba,5,1,273,14,29,775,9,1,10,3/12/2021,19
7622,7622,7615,Sport,2,0,397,13,Flamengo,3,0,426,11,24,823,5,0,5,3/12/2021,19
7623,7623,7624,Chapecoense,2,0,354,17,Atletico-GO,3,0,477,17,34,831,5,0,5,3/12/2021,19
7624,7624,7625,Fortaleza,2,0,411,20,Juventude,0,0,363,14,34,774,2,0,2,3/12/2021,19
7625,7625,7626,Bahia,2,1,285,14,Fluminense,5,1,512,20,34,797,7,2,9,5/12/2021,19
7626,7626,7627,Corinthians,1,0,633,7,Gremio,3,0,249,22,29,882,4,0,4,5/12/2021,19
7627,7627,7628,Atletico-MG,1,0,580,5,Bragantino,2,0,361,10,15,941,3,0,3,5/12/2021,19
7628,7628,7629,Ceara,0,0,357,14,America-MG,2,0,329,13,27,686,2,0,2,5/12/2021,19
7629,7629,7630,Sao Paulo,5,0,356,25,Juventude,3,0,291,13,38,647,8,0,8,6/12/2021,19
7630,7630,7631,Athletico-PR,1,0,600,11,Palmeiras,1,0,249,10,21,849,2,0,2,6/12/2021,19
7631,7631,7632,Cuiaba,1,0,279,22,Fortaleza,3,0,489,23,45,768,4,0,4,6/12/2021,19
7632,7632,7633,Internacional,3,0,535,14,Atletico-GO,2,0,365,9,23,900,5,0,5,6/12/2021,19
7633,7633,7634,Flamengo,3,0,482,23,Santos,3,0,280,14,37,762,6,0,6,6/12/2021,19
7634,7634,7635,Chapecoense,3,1,213,16,Sport,4,0,526,27,43,739,7,1,8,6/12/2021,19
7635,7635,7636,Fortaleza,4,0,338,15,Bahia,2,0,312,17,32,650,6,0,6,9/12/2021,19
7636,7636,7637,Atletico-GO,4,0,466,15,Flamengo,2,0,439,7,22,905,6,0,6,9/12/2021,19
7637,7637,7638,Palmeiras,2,0,289,18,Ceara,0,0,620,4,22,909,2,0,2,9/12/2021,19
7638,7638,7639,Fluminense,3,0,541,12,Chapecoense,2,0,260,10,22,801,5,0,5,9/12/2021,19
7639,7639,7640,America-MG,2,0,383,18,Sao Paulo,2,0,463,18,36,846,4,0,4,9/12/2021,19
7640,7640,7641,Bragantino,4,0,370,23,Internacional,5,0,474,26,49,844,9,0,9,9/12/2021,19
7641,7641,7642,Sport,1,0,569,17,Athletico-PR,1,0,338,14,31,907,2,0,2,9/12/2021,19
7642,7642,7643,Juventude,1,0,404,10,Corinthians,2,1,519,22,32,923,3,1,4,9/12/2021,19
7643,7643,7644,Gremio,3,0,328,15,Atletico-MG,1,0,548,11,26,876,4,0,4,9/12/2021,19
7644,7644,7645,Santos,1,0,513,17,Cuiaba,2,0,321,15,32,834,3,0,3,9/12/2021,19
7645,7645,7646,Fluminense,1,0,545,14,Santos,0,0,286,18,32,831,1,0,1,9/4/2022,20
7646,7646,7647,Atletico-GO,3,0,403,7,Flamengo,2,0,502,11,18,905,5,0,5,9/4/2022,20
7647,7647,7648,Palmeiras,4,0,377,17,Ceara,8,1,309,14,31,686,12,1,13,9/4/2022,20
7648,7648,7649,Coritiba,2,0,449,10,Goias,4,0,421,12,22,870,6,0,6,10/4/2022,20
7649,7649,7650,Botafogo-RJ,1,0,474,6,Corinthians,4,0,382,18,24,856,5,0,5,10/4/2022,20
7650,7650,7651,Atletico-MG,2,0,534,12,Internacional,4,0,491,18,30,1025,6,0,6,10/4/2022,20
7651,7651,7652,Fortaleza,2,0,444,22,Cuiaba,3,0,245,23,45,689,5,0,5,10/4/2022,20
7652,7652,7653,Avai,3,0,541,20,America-MG,3,2,395,18,38,936,6,2,8,10/4/2022,20
7653,7653,7654,Sao Paulo,1,0,517,17,Athletico-PR,3,0,435,14,31,952,4,0,4,10/4/2022,20
7654,7654,7655,Juventude,4,0,420,16,Bragantino,5,0,418,17,33,838,9,0,9,11/4/2022,20
7655,7655,7656,Goias,4,0,198,16,Palmeiras,0,0,607,7,23,805,4,0,4,16/4/2022,20
7656,7656,7657,America-MG,3,0,378,19,Juventude,0,1,444,11,30,822,3,1,4,16/4/2022,20
7657,7657,7658,Corinthians,1,0,597,22,Avai,1,0,506,12,34,1103,2,0,2,16/4/2022,20
7658,7658,7659,Cuiaba,2,0,333,18,Fluminense,1,0,525,14,32,858,3,0,3,16/4/2022,20
7659,7659,7660,Santos,2,0,287,22,Coritiba,4,0,519,10,32,806,6,0,6,17/4/2022,20
7660,7660,7661,Flamengo,2,0,420,17,Sao Paulo,6,0,372,25,42,792,8,0,8,17/4/2022,20
7661,7661,7662,Athletico-PR,2,0,408,9,Atletico-MG,3,0,521,14,23,929,5,0,5,17/4/2022,20
7662,7662,7663,Internacional,5,0,476,15,Fortaleza,5,0,453,13,28,929,10,0,10,17/4/2022,20
7663,7663,7664,Bragantino,1,0,485,12,Atletico-GO,4,0,366,9,21,851,5,0,5,17/4/2022,20
7664,7664,7665,Ceara,1,1,469,16,Botafogo-RJ,4,0,257,15,31,726,5,1,6,17/4/2022,20
7665,7665,7666,Flamengo,3,0,444,15,Palmeiras,4,0,347,21,36,791,7,0,7,20/4/2022,20
7666,7666,7676,Bragantino,5,0,242,13,Sao Paulo,2,0,495,12,25,737,7,0,7,23/4/2022,20
7667,7667,7677,Athletico-PR,4,0,354,15,Flamengo,2,0,500,10,25,854,6,0,6,23/4/2022,20
7668,7668,7678,Palmeiras,1,0,339,13,Corinthians,2,0,426,14,27,765,3,0,3,23/4/2022,20
7669,7669,7679,Fluminense,5,0,503,15,Internacional,3,0,383,12,27,886,8,0,8,23/4/2022,20
7670,7670,7680,Atletico-MG,2,0,659,10,Coritiba,1,0,415,8,18,1074,3,0,3,23/4/2022,20
7671,7671,7681,Santos,2,0,324,16,America-MG,0,0,490,8,24,814,2,0,2,24/4/2022,20
7672,7672,7682,Juventude,1,1,428,18,Cuiaba,4,0,314,19,37,742,5,1,6,24/4/2022,20
7673,7673,7683,Atletico-GO,2,0,320,11,Botafogo-RJ,1,0,526,5,16,846,3,0,3,24/4/2022,20
7674,7674,7684,Avai,5,1,255,20,Goias,5,0,376,20,40,631,10,1,11,25/4/2022,20
7675,7675,7667,Ceara,1,0,447,11,Bragantino,5,1,357,20,31,804,6,1,7,30/4/2022,20
7676,7676,7668,America-MG,1,0,364,19,Athletico-PR,0,0,417,12,31,781,1,0,1,30/4/2022,20
7677,7677,7669,Goias,5,0,253,20,Atletico-MG,4,0,582,15,35,835,9,0,9,30/4/2022,20
7678,7678,7670,Cuiaba,2,0,475,12,Atletico-GO,0,0,473,14,26,948,2,0,2,30/4/2022,20
7679,7679,7671,Botafogo-RJ,2,0,402,14,Juventude,5,0,256,18,32,658,7,0,7,1/5/2022,20
7680,7680,7672,Corinthians,1,0,422,14,Fortaleza,3,0,335,14,28,757,4,0,4,1/5/2022,20
7681,7681,7673,Coritiba,0,0,438,13,Fluminense,2,1,386,16,29,824,2,1,3,1/5/2022,20
7682,7682,7674,Internacional,2,0,537,15,Avai,4,0,378,16,31,915,6,0,6,1/5/2022,20
7683,7683,7675,Sao Paulo,2,0,459,15,Santos,4,0,353,8,23,812,6,0,6,2/5/2022,20
7684,7684,7686,Atletico-MG,4,0,539,7,America-MG,3,1,261,22,29,800,7,1,8,7/5/2022,20
7685,7685,7687,Athletico-PR,5,0,285,19,Ceara,4,0,408,8,27,693,9,0,9,7/5/2022,20
7686,7686,7688,Flamengo,1,0,408,13,Botafogo-RJ,3,0,387,18,31,795,4,0,4,8/5/2022,20
7687,7687,7689,Palmeiras,1,0,357,10,Fluminense,2,0,403,13,23,760,3,0,3,8/5/2022,20
7688,7688,7690,Atletico-GO,4,0,531,12,Goias,2,1,173,11,23,704,6,1,7,8/5/2022,20
7689,7689,7691,Bragantino,1,0,537,11,Corinthians,2,0,416,9,20,953,3,0,3,8/5/2022,20
7690,7690,7692,Santos,1,0,417,14,Cuiaba,2,0,454,12,26,871,3,0,3,8/5/2022,20
7691,7691,7693,Juventude,5,0,454,22,Internacional,5,0,359,13,35,813,10,0,10,8/5/2022,20
7692,7692,7694,Fortaleza,2,0,383,16,Sao Paulo,3,0,339,14,30,722,5,0,5,8/5/2022,20
7693,7693,7695,Avai,3,0,546,14,Coritiba,3,0,385,13,27,931,6,0,6,9/5/2022,20
7694,7694,7696,Bragantino,3,1,384,13,Atletico-MG,2,0,648,5,18,1032,5,1,6,11/5/2022,20
7695,7695,7706,Palmeiras,2,0,388,11,Bragantino,2,0,410,14,25,798,4,0,4,14/5/2022,20
7696,7696,7707,Ceara,5,0,333,18,Flamengo,5,0,486,22,40,819,10,0,10,14/5/2022,20
7697,7697,7708,Internacional,2,0,385,8,Corinthians,2,0,426,7,15,811,4,0,4,14/5/2022,20
7698,7698,7709,Atletico-MG,1,0,526,16,Atletico-GO,2,0,400,14,30,926,3,0,3,14/5/2022,20
7699,7699,7710,Fluminense,3,0,525,12,Athletico-PR,2,0,290,12,24,815,5,0,5,14/5/2022,20
7700,7700,7711,Sao Paulo,2,0,593,5,Cuiaba,1,1,215,15,20,808,3,1,4,15/5/2022,20
7701,7701,7712,Coritiba,1,0,410,11,America-MG,4,1,294,23,34,704,5,1,6,15/5/2022,20
7702,7702,7713,Botafogo-RJ,3,0,512,14,Fortaleza,0,1,302,15,29,814,3,1,4,15/5/2022,20
7703,7703,7714,Avai,2,0,545,18,Juventude,5,2,302,16,34,847,7,2,9,15/5/2022,20
7704,7704,7715,Goias,0,0,243,14,Santos,0,0,507,11,25,750,0,0,0,15/5/2022,20
7705,7705,7697,Atletico-GO,4,0,498,14,Coritiba,1,2,358,13,27,856,5,2,7,21/5/2022,20
7706,7706,7698,Flamengo,1,0,580,14,Goias,3,0,316,19,33,896,4,0,4,21/5/2022,20
7707,7707,7699,Santos,1,0,382,9,Ceara,5,1,394,13,22,776,6,1,7,21/5/2022,20
7708,7708,7700,Juventude,3,0,380,20,Palmeiras,0,0,465,6,26,845,3,0,3,21/5/2022,20
7709,7709,7701,Cuiaba,1,2,319,9,Internacional,7,0,426,12,21,745,8,2,10,21/5/2022,20
7710,7710,7702,America-MG,2,0,377,19,Botafogo-RJ,1,0,516,9,28,893,3,0,3,21/5/2022,20
7711,7711,7703,Corinthians,2,0,513,11,Sao Paulo,3,0,414,12,23,927,5,0,5,22/5/2022,20
7712,7712,7704,Fortaleza,1,0,486,13,Fluminense,1,0,290,14,27,776,2,0,2,22/5/2022,20
7713,7713,7705,Athletico-PR,2,0,345,23,Avai,6,0,464,17,40,809,8,0,8,22/5/2022,20
7714,7714,7716,Goias,2,0,358,18,Bragantino,3,1,357,22,40,715,5,1,6,28/5/2022,20
7715,7715,7717,Sao Paulo,2,1,372,19,Ceara,5,0,356,10,29,728,7,1,8,28/5/2022,20
7716,7716,7718,Fortaleza,2,0,553,10,Juventude,3,0,334,16,26,887,5,0,5,28/5/2022,20
7717,7717,7719,Coritiba,5,0,188,10,Botafogo-RJ,3,0,485,12,22,673,8,0,8,29/5/2022,20
7718,7718,7720,Santos,5,0,384,19,Palmeiras,1,0,477,15,34,861,6,0,6,29/5/2022,20
7719,7719,7721,Cuiaba,5,0,460,9,Athletico-PR,0,0,333,17,26,793,5,0,5,29/5/2022,20
7720,7720,7722,Corinthians,2,0,541,13,America-MG,1,0,316,19,32,857,3,0,3,29/5/2022,20
7721,7721,7723,Fluminense,3,1,505,9,Flamengo,5,1,302,16,25,807,8,2,10,29/5/2022,20
7722,7722,7724,Atletico-MG,3,0,496,14,Avai,2,1,321,10,24,817,5,1,6,29/5/2022,20
7723,7723,7725,Internacional,1,0,433,7,Atletico-GO,2,0,524,16,23,957,3,0,3,30/5/2022,20
7724,7724,7685,Fortaleza,5,1,299,18,Ceara,4,0,451,18,36,750,9,1,10,1/6/2022,20
7725,7725,7726,America-MG,0,0,448,11,Cuiaba,1,0,421,11,22,869,1,0,1,4/6/2022,20
7726,7726,7727,Athletico-PR,5,0,296,21,Santos,3,0,421,11,32,717,8,0,8,4/6/2022,20
7727,7727,7728,Ceara,1,0,424,14,Coritiba,4,0,419,9,23,843,5,0,5,4/6/2022,20
7728,7728,7729,Avai,2,0,445,11,Sao Paulo,2,0,387,23,34,832,4,0,4,4/6/2022,20
7729,7729,7730,Atletico-GO,3,0,528,9,Corinthians,3,0,435,11,20,963,6,0,6,4/6/2022,20
7730,7730,7731,Juventude,3,0,251,21,Fluminense,4,1,259,10,31,510,7,1,8,5/6/2022,20
7731,7731,7732,Flamengo,3,0,526,9,Fortaleza,4,0,280,21,30,806,7,0,7,5/6/2022,20
7732,7732,7733,Palmeiras,1,0,367,8,Atletico-MG,3,0,378,19,27,745,4,0,4,5/6/2022,20
7733,7733,7734,Bragantino,3,0,434,20,Internacional,3,0,479,12,32,913,6,0,6,5/6/2022,20
7734,7734,7735,Botafogo-RJ,2,0,464,11,Goias,2,0,282,22,33,746,4,0,4,6/6/2022,20
7735,7735,7736,Cuiaba,1,1,354,10,Corinthians,2,0,552,11,21,906,3,1,4,7/6/2022,20
7736,7736,7737,America-MG,2,0,452,18,Ceara,3,0,348,20,38,800,5,0,5,8/6/2022,20
7737,7737,7738,Juventude,2,0,385,9,Athletico-PR,4,0,340,10,19,725,6,0,6,8/6/2022,20
7738,7738,7739,Atletico-GO,1,0,429,12,Avai,3,1,394,12,24,823,4,1,5,8/6/2022,20
7739,7739,7740,Bragantino,1,1,253,11,Flamengo,4,0,551,16,27,804,5,1,6,8/6/2022,20
7740,7740,7741,Fluminense,3,0,332,13,Atletico-MG,3,0,425,15,28,757,6,0,6,8/6/2022,20
7741,7741,7742,Santos,2,0,414,11,Internacional,1,0,411,16,27,825,3,0,3,8/6/2022,20
7742,7742,7743,Palmeiras,1,0,391,16,Botafogo-RJ,1,0,440,14,30,831,2,0,2,9/6/2022,20
7743,7743,7744,Coritiba,3,0,318,12,Sao Paulo,3,0,467,13,25,785,6,0,6,9/6/2022,20
7744,7744,7745,Fortaleza,1,0,391,12,Goias,2,0,379,18,30,770,3,0,3,9/6/2022,20
7745,7745,7746,Corinthians,1,0,573,15,Juventude,4,0,427,12,27,1000,5,0,5,11/6/2022,20
7746,7746,7747,Atletico-MG,4,0,601,11,Santos,4,1,277,16,27,878,8,1,9,11/6/2022,20
7747,7747,7748,Fluminense,3,1,404,10,Atletico-GO,2,0,484,13,23,888,5,1,6,11/6/2022,20
7748,7748,7749,Cuiaba,1,0,334,14,Bragantino,3,0,450,15,29,784,4,0,4,11/6/2022,20
7749,7749,7750,Internacional,3,0,290,15,Flamengo,3,0,599,14,29,889,6,0,6,11/6/2022,20
7750,7750,7751,Goias,6,0,360,20,Ceara,2,1,369,14,34,729,8,1,9,12/6/2022,20
7751,7751,7752,Sao Paulo,2,0,406,14,America-MG,2,0,438,16,30,844,4,0,4,12/6/2022,20
7752,7752,7753,Coritiba,1,1,410,11,Palmeiras,2,0,466,13,24,876,3,1,4,12/6/2022,20
7753,7753,7754,Fortaleza,1,0,500,13,Athletico-PR,3,0,293,12,25,793,4,0,4,12/6/2022,20
7754,7754,7755,Botafogo-RJ,4,0,415,19,Avai,4,1,409,22,41,824,8,1,9,13/6/2022,20
7755,7755,7756,Juventude,1,1,326,19,Santos,2,0,630,14,33,956,3,1,4,14/6/2022,20
7756,7756,7757,Ceara,2,0,482,14,Atletico-MG,3,0,456,17,31,938,5,0,5,15/6/2022,20
7757,7757,7758,Bragantino,2,0,449,13,Coritiba,1,0,413,12,25,862,3,0,3,15/6/2022,20
7758,7758,7759,Goias,4,0,425,11,Internacional,3,0,407,14,25,832,7,0,7,15/6/2022,20
7759,7759,7760,Flamengo,1,0,622,17,Cuiaba,2,0,352,14,31,974,3,0,3,15/6/2022,20
7760,7760,7761,Athletico-PR,2,1,384,12,Corinthians,2,1,522,9,21,906,4,2,6,15/6/2022,20
7761,7761,7762,America-MG,3,1,183,12,Fluminense,1,0,685,9,21,868,4,1,5,15/6/2022,20
7762,7762,7763,Botafogo-RJ,6,0,276,17,Sao Paulo,3,0,573,17,34,849,9,0,9,16/6/2022,20
7763,7763,7764,Palmeiras,2,0,361,12,Atletico-GO,1,1,392,16,28,753,3,1,4,16/6/2022,20
7764,7764,7765,Avai,1,0,435,16,Fortaleza,3,0,424,17,33,859,4,0,4,16/6/2022,20
7765,7765,7766,Cuiaba,0,0,368,15,Ceara,2,0,454,10,25,822,2,0,2,18/6/2022,20
7766,7766,7767,Santos,4,0,341,13,Bragantino,3,0,441,18,31,782,7,0,7,18/6/2022,20
7767,7767,7768,Atletico-MG,4,0,373,18,Flamengo,1,0,406,13,31,779,5,0,5,19/6/2022,20
7768,7768,7769,Coritiba,4,2,372,12,Athletico-PR,6,0,251,11,23,623,10,2,12,19/6/2022,20
7769,7769,7770,Corinthians,1,0,603,7,Goias,4,0,300,13,20,903,5,0,5,19/6/2022,20
7770,7770,7771,Internacional,4,2,597,13,Botafogo-RJ,6,2,178,13,26,775,10,4,14,19/6/2022,20
7771,7771,7772,Fortaleza,1,0,355,8,America-MG,0,0,325,5,13,680,1,0,1,19/6/2022,20
7772,7772,7773,Atletico-GO,3,0,513,15,Juventude,4,1,276,11,26,789,7,1,8,19/6/2022,20
7773,7773,7774,Fluminense,0,0,479,8,Avai,3,0,486,15,23,965,3,0,3,19/6/2022,20
7774,7774,7775,Sao Paulo,3,0,287,17,Palmeiras,1,0,446,9,26,733,4,0,4,20/6/2022,20
7775,7775,7776,Internacional,2,0,550,9,Coritiba,4,0,427,16,25,977,6,0,6,24/6/2022,20
7776,7776,7777,Athletico-PR,4,0,247,14,Bragantino,1,0,560,11,25,807,5,0,5,25/6/2022,20
7777,7777,7778,Flamengo,1,0,430,17,America-MG,2,0,387,13,30,817,3,0,3,25/6/2022,20
7778,7778,7779,Corinthians,3,0,527,20,Santos,3,0,335,10,30,862,6,0,6,25/6/2022,20
7779,7779,7780,Atletico-MG,0,0,663,14,Fortaleza,5,0,328,15,29,991,5,0,5,25/6/2022,20
7780,7780,7781,Avai,4,0,395,18,Palmeiras,1,0,392,17,35,787,5,0,5,26/6/2022,20
7781,7781,7782,Botafogo-RJ,3,0,182,18,Fluminense,2,0,730,14,32,912,5,0,5,26/6/2022,20
7782,7782,7783,Goias,3,0,311,14,Cuiaba,3,1,356,16,30,667,6,1,7,26/6/2022,20
7783,7783,7784,Ceara,2,0,352,16,Atletico-GO,2,0,369,18,34,721,4,0,4,26/6/2022,20
7784,7784,7785,Sao Paulo,3,0,527,15,Juventude,4,0,400,7,22,927,7,0,7,26/6/2022,20
7785,7785,7786,Juventude,2,0,574,11,Atletico-MG,1,0,475,11,22,1049,3,0,3,2/7/2022,20
7786,7786,7787,Fluminense,0,0,519,11,Corinthians,3,0,374,12,23,893,3,0,3,2/7/2022,20
7787,7787,7788,Santos,4,0,418,15,Flamengo,2,0,489,13,28,907,6,0,6,2/7/2022,20
7788,7788,7789,Ceara,4,0,391,24,Internacional,3,1,257,20,44,648,7,1,8,2/7/2022,20
7789,7789,7790,Palmeiras,1,1,553,12,Athletico-PR,2,0,231,15,27,784,3,1,4,2/7/2022,20
7790,7790,7791,Avai,0,0,562,10,Cuiaba,0,0,374,12,22,936,0,0,0,3/7/2022,20
7791,7791,7792,Atletico-GO,5,0,376,9,Sao Paulo,7,0,346,20,29,722,12,0,12,3/7/2022,20
7792,7792,7793,America-MG,2,0,412,14,Goias,2,0,377,8,22,789,4,0,4,3/7/2022,20
7793,7793,7794,Coritiba,2,1,288,11,Fortaleza,3,0,479,22,33,767,5,1,6,3/7/2022,20
7794,7794,7795,Bragantino,1,1,434,11,Botafogo-RJ,4,0,248,19,30,682,5,1,6,4/7/2022,20
7795,7795,7796,Bragantino,1,0,355,5,Avai,3,0,434,6,11,789,4,0,4,9/7/2022,20
7796,7796,7797,Fluminense,2,0,501,16,Ceara,3,0,344,17,33,845,5,0,5,9/7/2022,20
7797,7797,7798,Goias,2,0,256,15,Athletico-PR,1,0,481,10,25,737,3,0,3,9/7/2022,20
7798,7798,7799,Coritiba,1,0,350,19,Juventude,2,0,426,11,30,776,3,0,3,10/7/2022,20
7799,7799,7800,Corinthians,2,0,433,7,Flamengo,4,0,457,12,19,890,6,0,6,10/7/2022,20
7800,7800,7801,Santos,5,0,349,13,Atletico-GO,4,0,370,18,31,719,9,0,9,10/7/2022,20
7801,7801,7802,Fortaleza,0,0,295,9,Palmeiras,1,0,454,15,24,749,1,0,1,10/7/2022,20
7802,7802,7803,Atletico-MG,1,0,496,12,Sao Paulo,1,0,340,16,28,836,2,0,2,10/7/2022,20
7803,7803,7804,Cuiaba,1,0,404,7,Botafogo-RJ,1,2,473,11,18,877,2,2,4,10/7/2022,20
7804,7804,7805,Internacional,0,0,647,5,America-MG,5,0,309,8,13,956,5,0,5,11/7/2022,20
7805,7805,7806,Athletico-PR,1,0,501,7,Internacional,2,0,338,13,20,839,3,0,3,16/7/2022,20
7806,7806,7807,Flamengo,0,0,543,13,Coritiba,1,0,447,11,24,990,1,0,1,16/7/2022,20
7807,7807,7808,Avai,5,0,338,17,Santos,3,0,474,12,29,812,8,0,8,16/7/2022,20
7808,7808,7809,Ceara,1,0,434,18,Corinthians,1,0,542,5,23,976,2,0,2,16/7/2022,20
7809,7809,7810,Juventude,2,0,473,16,Goias,3,0,307,16,32,780,5,0,5,17/7/2022,20
7810,7810,7811,Sao Paulo,4,0,328,17,Fluminense,2,0,583,7,24,911,6,0,6,17/7/2022,20
7811,7811,7812,Botafogo-RJ,4,0,275,21,Atletico-MG,3,0,487,18,39,762,7,0,7,17/7/2022,20
7812,7812,7813,Atletico-GO,1,0,555,7,Fortaleza,0,0,334,9,16,889,1,0,1,17/7/2022,20
7813,7813,7814,America-MG,3,0,490,8,Bragantino,1,0,408,18,26,898,4,0,4,17/7/2022,20
7814,7814,7815,Palmeiras,3,0,494,17,Cuiaba,1,0,310,12,29,804,4,0,4,18/7/2022,20
7815,7815,7816,Ceara,0,0,366,17,Avai,2,0,444,14,31,810,2,0,2,19/7/2022,20
7816,7816,7817,Bragantino,4,0,406,14,Fortaleza,3,0,319,18,32,725,7,0,7,20/7/2022,20
7817,7817,7818,Goias,2,0,211,19,Fluminense,0,0,603,9,28,814,2,0,2,20/7/2022,20
7818,7818,7819,Athletico-PR,3,0,383,15,Atletico-GO,0,0,527,8,23,910,3,0,3,20/7/2022,20
7819,7819,7820,Flamengo,3,0,550,14,Juventude,3,1,317,13,27,867,6,1,7,20/7/2022,20
7820,7820,7821,Internacional,4,0,297,11,Sao Paulo,5,0,586,10,21,883,9,0,9,20/7/2022,20
7821,7821,7822,Santos,2,0,298,15,Botafogo-RJ,2,0,553,18,33,851,4,0,4,20/7/2022,20
7822,7822,7823,Corinthians,1,0,584,16,Coritiba,3,0,372,15,31,956,4,0,4,20/7/2022,20
7823,7823,7824,Cuiaba,1,0,296,7,Atletico-MG,1,0,672,10,17,968,2,0,2,21/7/2022,20
7824,7824,7825,America-MG,5,0,399,16,Palmeiras,3,0,419,6,22,818,8,0,8,21/7/2022,20
7825,7825,7826,Sao Paulo,2,0,541,7,Goias,5,0,308,11,18,849,7,0,7,23/7/2022,20
7826,7826,7827,Botafogo-RJ,0,0,494,16,Athletico-PR,2,0,410,15,31,904,2,0,2,23/7/2022,20
7827,7827,7828,Avai,1,0,333,19,Flamengo,1,0,453,19,38,786,2,0,2,24/7/2022,20
7828,7828,7829,Fluminense,5,1,528,11,Bragantino,2,0,331,20,31,859,7,1,8,24/7/2022,20
7829,7829,7830,Palmeiras,0,0,391,13,Internacional,1,0,374,15,28,765,1,0,1,24/7/2022,20
7830,7830,7831,Juventude,1,0,337,20,Ceara,3,0,429,14,34,766,4,0,4,24/7/2022,20
7831,7831,7832,Atletico-MG,2,0,521,11,Corinthians,1,0,474,12,23,995,3,0,3,24/7/2022,20
7832,7832,7833,Atletico-GO,0,0,554,4,America-MG,1,0,318,12,16,872,1,0,1,24/7/2022,20
7833,7833,7834,Fortaleza,4,0,381,11,Santos,4,0,375,11,22,756,8,0,8,24/7/2022,20
7834,7834,7835,Coritiba,4,1,365,16,Cuiaba,3,0,490,12,28,855,7,1,8,25/7/2022,20
7835,7835,7836,Goias,1,0,356,18,Coritiba,2,1,355,11,29,711,3,1,4,30/7/2022,20
7836,7836,7837,Ceara,3,1,373,14,Palmeiras,3,0,424,11,25,797,6,1,7,30/7/2022,20
7837,7837,7838,Corinthians,0,0,484,6,Botafogo-RJ,0,0,488,6,12,972,0,0,0,30/7/2022,20
7838,7838,7839,Flamengo,0,0,469,12,Atletico-GO,7,1,433,16,28,902,7,1,8,30/7/2022,20
7839,7839,7840,Athletico-PR,3,0,312,15,Sao Paulo,4,0,484,13,28,796,7,0,7,31/7/2022,20
7840,7840,7841,Internacional,1,0,277,13,Atletico-MG,1,0,600,12,25,877,2,0,2,31/7/2022,20
7841,7841,7842,Cuiaba,2,0,429,11,Fortaleza,4,0,344,10,21,773,6,0,6,31/7/2022,20
7842,7842,7843,America-MG,1,0,372,16,Avai,0,0,422,17,33,794,1,0,1,31/7/2022,20
7843,7843,7844,Bragantino,1,0,445,11,Juventude,1,0,421,15,26,866,2,0,2,31/7/2022,20
7844,7844,7845,Santos,2,0,314,14,Fluminense,5,0,660,12,26,974,7,0,7,1/8/2022,20
7845,7845,7846,Juventude,1,0,506,12,America-MG,2,0,278,18,30,784,3,0,3,6/8/2022,20
7846,7846,7847,Botafogo-RJ,3,0,347,23,Ceara,4,0,533,9,32,880,7,0,7,6/8/2022,20
7847,7847,7848,Avai,2,0,367,11,Corinthians,1,0,522,12,23,889,3,0,3,6/8/2022,20
7848,7848,7849,Atletico-GO,2,0,338,10,Bragantino,1,0,449,10,20,787,3,0,3,6/8/2022,20
7849,7849,7850,Sao Paulo,2,0,495,12,Flamengo,2,0,423,7,19,918,4,0,4,6/8/2022,20
7850,7850,7851,Fluminense,2,0,558,11,Cuiaba,1,0,300,14,25,858,3,0,3,7/8/2022,20
7851,7851,7852,Palmeiras,2,0,438,12,Goias,3,0,342,10,22,780,5,0,5,7/8/2022,20
7852,7852,7853,Fortaleza,1,1,266,12,Internacional,5,0,547,15,27,813,6,1,7,7/8/2022,20
7853,7853,7854,Atletico-MG,1,0,504,10,Athletico-PR,2,0,287,14,24,791,3,0,3,7/8/2022,20
7854,7854,7855,Coritiba,3,0,427,23,Santos,3,0,464,10,33,891,6,0,6,8/8/2022,20
7855,7855,7856,Goias,0,1,314,13,Avai,2,0,391,10,23,705,2,1,3,13/8/2022,20
7856,7856,7857,Corinthians,2,0,490,15,Palmeiras,2,0,369,10,25,859,4,0,4,13/8/2022,20
7857,7857,7858,Cuiaba,4,0,341,14,Juventude,4,1,443,14,28,784,8,1,9,13/8/2022,20
7858,7858,7859,Botafogo-RJ,0,1,459,18,Atletico-GO,3,0,396,10,28,855,3,1,4,13/8/2022,20
7859,7859,7860,Coritiba,3,0,370,7,Atletico-MG,0,0,531,20,27,901,3,0,3,14/8/2022,20
7860,7860,7861,Ceara,3,0,483,9,Fortaleza,4,0,266,13,22,749,7,0,7,14/8/2022,20
7861,7861,7862,Flamengo,3,0,571,13,Athletico-PR,2,0,260,14,27,831,5,0,5,14/8/2022,20
7862,7862,7863,Sao Paulo,1,0,381,17,Bragantino,0,0,362,10,27,743,1,0,1,14/8/2022,20
7863,7863,7864,America-MG,1,0,343,16,Santos,0,0,541,9,25,884,1,0,1,14/8/2022,20
7864,7864,7865,Internacional,1,0,295,21,Fluminense,1,0,628,12,33,923,2,0,2,14/8/2022,20
7865,7865,7866,Atletico-MG,0,0,591,10,Goias,0,0,233,13,23,824,0,0,0,20/8/2022,20
7866,7866,7867,Fluminense,1,0,571,13,Coritiba,2,0,334,13,26,905,3,0,3,20/8/2022,20
7867,7867,7868,Juventude,2,0,289,19,Botafogo-RJ,2,0,557,11,30,846,4,0,4,21/8/2022,20
7868,7868,7869,Palmeiras,0,0,487,11,Flamengo,2,0,385,16,27,872,2,0,2,21/8/2022,20
7869,7869,7870,Athletico-PR,0,0,532,10,America-MG,0,0,369,10,20,901,0,0,0,21/8/2022,20
7870,7870,7871,Atletico-GO,2,1,300,14,Cuiaba,2,0,484,8,22,784,4,1,5,21/8/2022,20
7871,7871,7872,Fortaleza,1,0,284,14,Corinthians,2,0,494,7,21,778,3,0,3,21/8/2022,20
7872,7872,7873,Bragantino,3,0,427,23,Ceara,4,0,325,16,39,752,7,0,7,21/8/2022,20
7873,7873,7874,Santos,4,0,269,12,Sao Paulo,2,0,669,9,21,938,6,0,6,21/8/2022,20
7874,7874,7875,Avai,5,0,464,15,Internacional,1,0,476,9,24,940,6,0,6,22/8/2022,20
7875,7875,7876,Goias,2,1,211,14,Atletico-GO,2,1,486,9,23,697,4,2,6,27/8/2022,20
7876,7876,7877,Coritiba,4,0,358,14,Avai,3,0,460,14,28,818,7,0,7,27/8/2022,20
7877,7877,7878,Fluminense,3,0,544,16,Palmeiras,3,0,350,16,32,894,6,0,6,27/8/2022,20
7878,7878,7879,Ceara,0,0,402,9,Athletico-PR,1,0,289,15,24,691,1,0,1,27/8/2022,20
7879,7879,7880,Sao Paulo,2,0,613,10,Fortaleza,2,0,242,10,20,855,4,0,4,28/8/2022,20
7880,7880,7881,America-MG,4,0,313,23,Atletico-MG,4,0,421,14,37,734,8,0,8,28/8/2022,20
7881,7881,7882,Botafogo-RJ,3,0,417,19,Flamengo,2,0,502,14,33,919,5,0,5,28/8/2022,20
7882,7882,7883,Cuiaba,0,0,366,13,Santos,0,0,451,6,19,817,0,0,0,28/8/2022,20
7883,7883,7884,Internacional,0,0,521,4,Juventude,3,0,435,10,14,956,3,0,3,29/8/2022,20
7884,7884,7885,Corinthians,1,0,437,12,Bragantino,1,0,488,8,20,925,2,0,2,29/8/2022,20
7885,7885,7886,Juventude,6,0,283,18,Avai,6,0,468,15,33,751,12,0,12,3/9/2022,20
7886,7886,7887,Bragantino,4,0,323,14,Palmeiras,4,0,445,12,26,768,8,0,8,3/9/2022,20
7887,7887,7888,Athletico-PR,2,0,241,15,Fluminense,0,0,699,7,22,940,2,0,2,3/9/2022,20
7888,7888,7889,America-MG,2,0,429,19,Coritiba,3,0,404,8,27,833,5,0,5,3/9/2022,20
7889,7889,7890,Flamengo,3,1,483,12,Ceara,6,1,296,19,31,779,9,2,11,4/9/2022,20
7890,7890,7891,Corinthians,2,0,493,10,Internacional,2,0,485,14,24,978,4,0,4,4/9/2022,20
7891,7891,7892,Fortaleza,1,0,386,15,Botafogo-RJ,2,0,291,14,29,677,3,0,3,4/9/2022,20
7892,7892,7893,Atletico-GO,1,0,451,12,Atletico-MG,2,0,484,6,18,935,3,0,3,4/9/2022,20
7893,7893,7894,Cuiaba,3,0,277,18,Sao Paulo,1,1,574,9,27,851,4,1,5,4/9/2022,20
7894,7894,7895,Santos,1,0,516,8,Goias,2,0,270,16,24,786,3,0,3,5/9/2022,20
7895,7895,7896,Atletico-MG,1,0,592,8,Bragantino,2,0,363,10,18,955,3,0,3,7/9/2022,20
7896,7896,7897,Internacional,1,0,716,16,Cuiaba,3,0,331,14,30,1047,4,0,4,10/9/2022,20
7897,7897,7898,Ceara,4,0,343,24,Santos,3,0,452,17,41,795,7,0,7,10/9/2022,20
7898,7898,7899,Fluminense,1,0,514,7,Fortaleza,2,0,245,19,26,759,3,0,3,10/9/2022,20
7899,7899,7900,Palmeiras,0,0,498,6,Juventude,3,0,251,15,21,749,3,0,3,10/9/2022,20
7900,7900,7901,Avai,3,0,550,17,Athletico-PR,3,1,250,20,37,800,6,1,7,11/9/2022,20
7901,7901,7902,Botafogo-RJ,1,0,366,11,America-MG,5,0,421,20,31,787,6,0,6,11/9/2022,20
7902,7902,7903,Sao Paulo,3,0,355,11,Corinthians,1,0,473,14,25,828,4,0,4,11/9/2022,20
7903,7903,7904,Coritiba,6,0,322,16,Atletico-GO,3,1,454,11,27,776,9,1,10,11/9/2022,20
7904,7904,7905,Goias,3,0,219,14,Flamengo,1,0,548,14,28,767,4,0,4,11/9/2022,20
7905,7905,7906,Avai,4,0,307,16,Atletico-MG,3,0,458,20,36,765,7,0,7,17/9/2022,20
7906,7906,7907,Botafogo-RJ,2,0,420,12,Coritiba,4,0,347,17,29,767,6,0,6,17/9/2022,20
7907,7907,7908,Bragantino,0,0,431,14,Goias,5,0,295,16,30,726,5,0,5,18/9/2022,20
7908,7908,7909,Flamengo,1,2,415,12,Fluminense,4,3,440,10,22,855,5,5,10,18/9/2022,20
7909,7909,7910,Ceara,5,2,329,15,Sao Paulo,2,0,512,11,26,841,7,2,9,18/9/2022,20
7910,7910,7911,America-MG,1,0,379,14,Corinthians,3,0,462,12,26,841,4,0,4,18/9/2022,20
7911,7911,7912,Juventude,2,0,498,14,Fortaleza,3,0,324,17,31,822,5,0,5,18/9/2022,20
7912,7912,7913,Palmeiras,3,1,432,12,Santos,4,0,374,12,24,806,7,1,8,18/9/2022,20
7913,7913,7914,Athletico-PR,3,0,455,9,Cuiaba,1,1,258,10,19,713,4,1,5,18/9/2022,20
7914,7914,7915,Atletico-GO,3,0,398,19,Internacional,2,0,356,13,32,754,5,0,5,19/9/2022,20
7915,7915,7916,Sao Paulo,2,0,568,13,Avai,4,0,363,8,21,931,6,0,6,25/9/2022,20
7916,7916,7917,Santos,3,0,358,19,Athletico-PR,3,0,389,21,40,747,6,0,6,27/9/2022,20
7917,7917,7918,Coritiba,2,0,256,12,Ceara,4,0,557,9,21,813,6,0,6,28/9/2022,20
7918,7918,7919,Corinthians,0,0,611,5,Atletico-GO,3,0,330,14,19,941,3,0,3,28/9/2022,20
7919,7919,7920,Fluminense,1,0,658,5,Juventude,1,0,409,9,14,1067,2,0,2,28/9/2022,20
7920,7920,7921,Fortaleza,2,0,241,15,Flamengo,5,0,668,15,30,909,7,0,7,28/9/2022,20
7921,7921,7922,Cuiaba,1,0,311,13,America-MG,6,0,426,14,27,737,7,0,7,28/9/2022,20
7922,7922,7923,Internacional,1,0,544,14,Bragantino,2,0,384,15,29,928,3,0,3,28/9/2022,20
7923,7923,7924,Atletico-MG,3,0,516,11,Palmeiras,3,0,245,13,24,761,6,0,6,28/9/2022,20
7924,7924,7925,Goias,4,0,328,16,Botafogo-RJ,4,0,394,14,30,722,8,0,8,28/9/2022,20
7925,7925,7926,Atletico-MG,2,0,250,16,Fluminense,2,1,627,4,20,877,4,1,5,1/10/2022,20
7926,7926,7927,Internacional,1,0,455,7,Santos,4,0,503,13,20,958,5,0,5,1/10/2022,20
7927,7927,7928,Ceara,3,0,407,15,America-MG,4,0,261,23,38,668,7,0,7,1/10/2022,20
7928,7928,7929,Avai,2,0,419,7,Atletico-GO,4,0,312,13,20,731,6,0,6,1/10/2022,20
7929,7929,7930,Athletico-PR,3,0,336,12,Juventude,5,0,333,11,23,669,8,0,8,1/10/2022,20
7930,7930,7931,Flamengo,1,0,671,7,Bragantino,0,1,328,6,13,999,1,1,2,1/10/2022,20
7931,7931,7932,Goias,3,0,421,11,Fortaleza,2,0,357,15,26,778,5,0,5,1/10/2022,20
7932,7932,7933,Corinthians,1,0,650,11,Cuiaba,0,0,422,5,16,1072,1,0,1,1/10/2022,20
7933,7933,7934,Botafogo-RJ,4,0,399,16,Palmeiras,1,1,421,14,30,820,5,1,6,3/10/2022,20
7934,7934,7936,Juventude,1,0,326,9,Corinthians,2,0,650,7,16,976,3,0,3,4/10/2022,20
7935,7935,7937,Atletico-GO,4,0,301,16,Fluminense,0,0,482,13,29,783,4,0,4,5/10/2022,20
7936,7936,7938,Ceara,3,1,339,19,Goias,4,0,316,24,43,655,7,1,8,5/10/2022,20
7937,7937,7939,Bragantino,2,0,412,14,Cuiaba,3,0,461,10,24,873,5,0,5,5/10/2022,20
7938,7938,7940,Athletico-PR,2,0,484,11,Fortaleza,1,0,300,10,21,784,3,0,3,5/10/2022,20
7939,7939,7941,Flamengo,3,0,661,13,Internacional,2,0,338,8,21,999,5,0,5,5/10/2022,20
7940,7940,7942,Santos,2,1,350,18,Atletico-MG,4,0,461,18,36,811,6,1,7,5/10/2022,20
7941,7941,7943,Palmeiras,1,0,501,16,Coritiba,2,0,396,13,29,897,3,0,3,6/10/2022,20
7942,7942,7944,America-MG,2,0,277,13,Sao Paulo,4,0,563,13,26,840,6,0,6,6/10/2022,20
7943,7943,7945,Avai,2,0,441,17,Botafogo-RJ,4,0,346,20,37,787,6,0,6,6/10/2022,20
7944,7944,7946,Cuiaba,2,0,326,14,Flamengo,2,0,405,11,25,731,4,0,4,8/10/2022,20
7945,7945,7947,Corinthians,1,0,412,10,Athletico-PR,0,0,389,16,26,801,1,0,1,8/10/2022,20
7946,7946,7948,Internacional,1,0,463,15,Goias,7,0,290,23,38,753,8,0,8,9/10/2022,20
7947,7947,7949,Sao Paulo,3,1,500,16,Botafogo-RJ,2,0,248,8,24,748,5,1,6,9/10/2022,20
7948,7948,7950,Fortaleza,1,0,327,16,Avai,1,0,624,11,27,951,2,0,2,9/10/2022,20
7949,7949,7951,Coritiba,0,1,269,7,Bragantino,3,0,488,12,19,757,3,1,4,9/10/2022,20
7950,7950,7952,Atletico-MG,3,0,565,12,Ceara,5,0,328,18,30,893,8,0,8,9/10/2022,20
7951,7951,7953,Fluminense,1,0,511,8,America-MG,3,0,303,18,26,814,4,0,4,9/10/2022,20
7952,7952,7954,Atletico-GO,4,0,350,15,Palmeiras,2,0,451,8,23,801,6,0,6,10/10/2022,20
7953,7953,7955,Santos,2,0,437,13,Juventude,0,0,432,10,23,869,2,0,2,10/10/2022,20
7954,7954,7956,Flamengo,4,0,348,12,Atletico-MG,0,0,563,12,24,911,4,0,4,15/10/2022,20
7955,7955,7957,America-MG,1,0,457,10,Fortaleza,2,1,234,24,34,691,3,1,4,15/10/2022,20
7956,7956,7958,Ceara,4,0,377,11,Cuiaba,4,1,211,20,31,588,8,1,9,16/10/2022,20
7957,7957,7959,Palmeiras,3,0,358,9,Sao Paulo,3,2,305,14,23,663,6,2,8,16/10/2022,20
7958,7958,7960,Juventude,2,0,470,10,Atletico-GO,1,0,472,19,29,942,3,0,3,16/10/2022,20
7959,7959,7961,Botafogo-RJ,3,0,488,15,Internacional,5,0,475,13,28,963,8,0,8,16/10/2022,20
7960,7960,7962,Avai,2,0,407,12,Fluminense,0,0,565,15,27,972,2,0,2,16/10/2022,20
7961,7961,7963,Athletico-PR,3,0,387,21,Coritiba,2,0,343,11,32,730,5,0,5,16/10/2022,20
7962,7962,7964,Bragantino,3,1,400,21,Santos,4,0,335,11,32,735,7,1,8,17/10/2022,20
7963,7963,7935,Sao Paulo,2,0,554,12,Coritiba,6,0,347,12,24,901,8,0,8,20/10/2022,20
7964,7964,7966,Bragantino,0,0,376,16,Athletico-PR,3,0,412,13,29,788,3,0,3,22/10/2022,20
7965,7965,7967,America-MG,1,0,348,17,Flamengo,1,0,413,10,27,761,2,0,2,22/10/2022,20
7966,7966,7968,Santos,1,1,486,15,Corinthians,3,1,454,11,26,940,4,2,6,22/10/2022,20
7967,7967,7969,Palmeiras,2,0,384,12,Avai,2,0,401,7,19,785,4,0,4,22/10/2022,20
7968,7968,7970,Fluminense,3,0,623,15,Botafogo-RJ,2,0,341,11,26,964,5,0,5,23/10/2022,20
7969,7969,7971,Juventude,2,0,410,6,Sao Paulo,2,0,599,10,16,1009,4,0,4,23/10/2022,20
7970,7970,7972,Coritiba,3,0,272,16,Internacional,1,0,527,10,26,799,4,0,4,23/10/2022,20
7971,7971,7973,Atletico-GO,3,0,330,20,Ceara,2,0,497,13,33,827,5,0,5,23/10/2022,20
7972,7972,7974,Cuiaba,3,0,558,11,Goias,4,0,227,16,27,785,7,0,7,23/10/2022,20
7973,7973,7975,Fortaleza,4,0,235,22,Atletico-MG,1,0,519,10,32,754,5,0,5,24/10/2022,20
7974,7974,7976,Flamengo,3,0,523,14,Santos,4,0,439,16,30,962,7,0,7,25/10/2022,20
7975,7975,7977,Athletico-PR,3,1,235,7,Palmeiras,5,0,576,10,17,811,8,1,9,25/10/2022,20
7976,7976,7978,Botafogo-RJ,1,0,329,12,Bragantino,4,0,448,12,24,777,5,0,5,26/10/2022,20
7977,7977,7979,Corinthians,2,0,429,16,Fluminense,3,0,480,9,25,909,5,0,5,26/10/2022,20
7978,7978,7980,Internacional,0,0,526,8,Ceara,2,0,316,15,23,842,2,0,2,26/10/2022,20
7979,7979,7981,Goias,2,0,343,14,America-MG,3,0,405,23,37,748,5,0,5,26/10/2022,20
7980,7980,7982,Fortaleza,1,0,441,15,Coritiba,1,1,412,12,27,853,2,1,3,27/10/2022,20
7981,7981,7983,Sao Paulo,2,0,459,10,Atletico-GO,4,1,392,12,22,851,6,1,7,27/10/2022,20
7982,7982,7984,Atletico-MG,2,0,555,13,Juventude,1,0,354,13,26,909,3,0,3,27/10/2022,20
7983,7983,7985,Cuiaba,1,0,420,15,Avai,1,0,459,11,26,879,2,0,2,27/10/2022,20
7984,7984,7965,Goias,2,0,236,11,Corinthians,3,0,613,11,22,849,5,0,5,29/10/2022,20
7985,7985,7986,Ceara,1,1,283,11,Fluminense,2,0,690,8,19,973,3,1,4,31/10/2022,20
7986,7986,7987,Botafogo-RJ,1,0,561,4,Cuiaba,1,0,277,18,22,838,2,0,2,1/11/2022,20
7987,7987,7988,Sao Paulo,3,0,344,10,Atletico-MG,5,0,417,16,26,761,8,0,8,1/11/2022,20
7988,7988,7989,Athletico-PR,2,0,366,10,Goias,1,0,435,11,21,801,3,0,3,2/11/2022,20
7989,7989,7990,America-MG,0,0,435,9,Internacional,0,0,414,12,21,849,0,0,0,2/11/2022,20
7990,7990,7991,Juventude,3,0,280,11,Coritiba,4,0,441,18,29,721,7,0,7,2/11/2022,20
7991,7991,7992,Avai,2,0,419,17,Bragantino,1,0,436,17,34,855,3,0,3,2/11/2022,20
7992,7992,7993,Atletico-GO,3,0,468,15,Santos,2,0,392,10,25,860,5,0,5,2/11/2022,20
7993,7993,7994,Palmeiras,3,0,522,11,Fortaleza,1,0,419,16,27,941,4,0,4,2/11/2022,20
7994,7994,7995,Flamengo,0,0,542,9,Corinthians,1,0,518,14,23,1060,1,0,1,2/11/2022,20
7995,7995,7996,Santos,3,0,477,14,Avai,0,0,377,13,27,854,3,0,3,5/11/2022,20
7996,7996,7997,Fluminense,1,0,633,16,Sao Paulo,0,1,333,16,32,966,1,1,2,5/11/2022,20
7997,7997,7998,Bragantino,6,0,447,17,America-MG,2,0,320,9,26,767,8,0,8,5/11/2022,20
7998,7998,7999,Goias,4,0,309,15,Juventude,6,0,283,22,37,592,10,0,10,5/11/2022,20
7999,7999,8000,Corinthians,4,0,566,10,Ceara,4,0,319,12,22,885,8,0,8,5/11/2022,20
8000,8000,8001,Internacional,0,0,442,5,Athletico-PR,1,1,357,20,25,799,1,1,2,5/11/2022,20
8001,8001,8002,Fortaleza,2,0,415,9,Atletico-GO,4,1,333,12,21,748,6,1,7,6/11/2022,20
8002,8002,8003,Coritiba,5,0,245,13,Flamengo,3,0,515,11,24,760,8,0,8,6/11/2022,20
8003,8003,8004,Cuiaba,2,0,254,13,Palmeiras,0,0,493,8,21,747,2,0,2,6/11/2022,20
8004,8004,8005,Atletico-MG,2,0,530,10,Botafogo-RJ,5,0,270,19,29,800,7,0,7,7/11/2022,20
8005,8005,8006,Sao Paulo,4,0,511,11,Internacional,5,0,374,12,23,885,9,0,9,8/11/2022,20
8006,8006,8007,Coritiba,4,0,384,15,Corinthians,5,1,375,8,23,759,9,1,10,9/11/2022,20
8007,8007,8008,Fluminense,3,0,639,10,Goias,1,2,192,11,21,831,4,2,6,9/11/2022,20
8008,8008,8009,Avai,4,0,300,17,Ceara,5,0,428,21,38,728,9,0,9,9/11/2022,20
8009,8009,8010,Fortaleza,1,0,432,17,Bragantino,4,0,350,12,29,782,5,0,5,9/11/2022,20
8010,8010,8011,Juventude,7,0,294,17,Flamengo,3,0,512,14,31,806,10,0,10,9/11/2022,20
8011,8011,8012,Palmeiras,4,0,401,11,America-MG,2,0,286,11,22,687,6,0,6,9/11/2022,20
8012,8012,8013,Atletico-GO,1,0,497,8,Athletico-PR,0,0,283,12,20,780,1,0,1,9/11/2022,20
8013,8013,8014,Botafogo-RJ,2,0,391,15,Santos,4,1,467,17,32,858,6,1,7,10/11/2022,20
8014,8014,8015,Atletico-MG,1,0,635,12,Cuiaba,4,0,326,11,23,961,5,0,5,10/11/2022,20
8015,8015,8016,Flamengo,0,0,579,14,Avai,1,0,313,11,25,892,1,0,1,12/11/2022,20
8016,8016,8017,Athletico-PR,1,0,271,19,Botafogo-RJ,1,0,415,13,32,686,2,0,2,13/11/2022,20
8017,8017,8018,Ceara,4,0,467,16,Juventude,4,0,297,16,32,764,8,0,8,13/11/2022,20
8018,8018,8019,America-MG,3,0,420,14,Atletico-GO,2,1,319,12,26,739,5,1,6,13/11/2022,20
8019,8019,8020,Santos,1,0,361,17,Fortaleza,3,0,396,14,31,757,4,0,4,13/11/2022,20
8020,8020,8021,Cuiaba,1,0,505,9,Coritiba,3,1,389,8,17,894,4,1,5,13/11/2022,20
8021,8021,8022,Bragantino,3,0,319,16,Fluminense,2,0,463,15,31,782,5,0,5,13/11/2022,20
8022,8022,8023,Corinthians,3,0,494,11,Atletico-MG,6,0,351,19,30,845,9,0,9,13/11/2022,20
8023,8023,8024,Internacional,2,0,287,13,Palmeiras,3,0,306,17,30,593,5,0,5,13/11/2022,20
8024,8024,8025,Goias,2,0,330,12,Sao Paulo,1,0,591,14,26,921,3,0,3,13/11/2022,20
